"","county","X","administered_date","total_doses","cumulative_total_doses","pfizer_doses","cumulative_pfizer_doses","moderna_doses","cumulative_moderna_doses","jj_doses","cumulative_jj_doses","partially_vaccinated","total_partially_vaccinated","fully_vaccinated","cumulative_fully_vaccinated","at_least_one_dose","cumulative_at_least_one_dose","california_flag","population","propvacc","BidenCount","BidenProp","TrumpCount","TrumpProp"
"1","alameda",1,"2020-12-15",36,36,36,36,0,0,0,0,36,36,0,0,36,36,"California",1685886,0,617659,0.802,136309,0.177
"2","alameda",2,"2020-12-16",206,242,206,242,0,0,0,0,206,242,0,0,206,242,"California",1685886,0,617659,0.802,136309,0.177
"3","alameda",3,"2020-12-17",396,638,396,638,0,0,0,0,396,638,0,0,396,638,"California",1685886,0,617659,0.802,136309,0.177
"4","alameda",4,"2020-12-18",1775,2413,1775,2413,0,0,0,0,1775,2413,0,0,1775,2413,"California",1685886,0,617659,0.802,136309,0.177
"5","alameda",5,"2020-12-19",1353,3766,1353,3766,0,0,0,0,1353,3766,0,0,1353,3766,"California",1685886,0,617659,0.802,136309,0.177
"6","alameda",6,"2020-12-20",1162,4928,1161,4927,1,1,0,0,1161,4926,1,1,1161,4927,"California",1685886,5.9315991709997e-07,617659,0.802,136309,0.177
"7","alameda",7,"2020-12-21",1861,6789,1859,6786,2,3,0,0,1860,6786,0,1,1860,6787,"California",1685886,5.9315991709997e-07,617659,0.802,136309,0.177
"8","alameda",8,"2020-12-22",2100,8889,2047,8833,53,56,0,0,2100,8886,0,1,2100,8887,"California",1685886,5.9315991709997e-07,617659,0.802,136309,0.177
"9","alameda",9,"2020-12-23",1943,10832,1685,10518,258,314,0,0,1944,10830,0,1,1944,10831,"California",1685886,5.9315991709997e-07,617659,0.802,136309,0.177
"10","alameda",10,"2020-12-24",1220,12052,760,11278,460,774,0,0,1220,12050,0,1,1220,12051,"California",1685886,5.9315991709997e-07,617659,0.802,136309,0.177
"11","alameda",11,"2020-12-25",166,12218,129,11407,37,811,0,0,166,12216,0,1,166,12217,"California",1685886,5.9315991709997e-07,617659,0.802,136309,0.177
"12","alameda",12,"2020-12-26",870,13088,326,11733,544,1355,0,0,870,13086,0,1,870,13087,"California",1685886,5.9315991709997e-07,617659,0.802,136309,0.177
"13","alameda",13,"2020-12-27",498,13586,256,11989,242,1597,0,0,498,13584,0,1,498,13585,"California",1685886,5.9315991709997e-07,617659,0.802,136309,0.177
"14","alameda",14,"2020-12-28",1885,15471,959,12948,926,2523,0,0,1885,15469,0,1,1885,15470,"California",1685886,5.9315991709997e-07,617659,0.802,136309,0.177
"15","alameda",15,"2020-12-29",2431,17902,1025,13973,1406,3929,0,0,2430,17899,0,1,2430,17900,"California",1685886,5.9315991709997e-07,617659,0.802,136309,0.177
"16","alameda",16,"2020-12-30",3132,21034,1365,15338,1767,5696,0,0,3134,21033,0,1,3134,21034,"California",1685886,5.9315991709997e-07,617659,0.802,136309,0.177
"17","alameda",17,"2020-12-31",1796,22830,443,15781,1353,7049,0,0,1794,22826,1,2,1794,22828,"California",1685886,1.18631983419994e-06,617659,0.802,136309,0.177
"18","alameda",18,"2021-01-01",172,23002,70,15851,102,7151,0,0,171,22996,1,3,171,22999,"California",1685886,1.77947975129991e-06,617659,0.802,136309,0.177
"19","alameda",19,"2021-01-02",727,23729,524,16375,203,7354,0,0,726,23722,0,3,726,23725,"California",1685886,1.77947975129991e-06,617659,0.802,136309,0.177
"20","alameda",20,"2021-01-03",343,24072,222,16597,121,7475,0,0,340,24059,3,6,340,24065,"California",1685886,3.55895950259982e-06,617659,0.802,136309,0.177
"21","alameda",21,"2021-01-04",1648,25720,943,17540,705,8180,0,0,1636,25684,11,17,1636,25701,"California",1685886,1.00837185906995e-05,617659,0.802,136309,0.177
"22","alameda",22,"2021-01-05",2208,27928,1266,18806,942,9122,0,0,1972,27423,233,250,1972,27673,"California",1685886,0.000148289979274992,617659,0.802,136309,0.177
"23","alameda",23,"2021-01-06",3249,31177,1782,20588,1467,10589,0,0,2428,29035,818,1068,2430,30103,"California",1685886,0.000633494791462768,617659,0.802,136309,0.177
"24","alameda",24,"2021-01-07",3777,34954,2113,22701,1664,12253,0,0,2688,30647,1080,2148,2692,32795,"California",1685886,0.00127410750193074,617659,0.802,136309,0.177
"25","alameda",25,"2021-01-08",4739,39693,2706,25407,2033,14286,0,0,3110,32136,1625,3773,3114,35909,"California",1685886,0.00223799236721819,617659,0.802,136309,0.177
"26","alameda",26,"2021-01-09",2034,41727,1388,26795,646,14932,0,0,1173,32448,861,4634,1173,37082,"California",1685886,0.00274870305584126,617659,0.802,136309,0.177
"27","alameda",27,"2021-01-10",1068,42795,846,27641,222,15154,0,0,428,32235,641,5275,428,37510,"California",1685886,0.00312891856270234,617659,0.802,136309,0.177
"28","alameda",28,"2021-01-11",4650,47445,3515,31156,1135,16289,0,0,2856,33305,1793,7068,2863,40373,"California",1685886,0.00419245429406259,617659,0.802,136309,0.177
"29","alameda",29,"2021-01-12",4831,52276,3251,34407,1580,17869,0,0,3439,35356,1391,8459,3442,43815,"California",1685886,0.00501753973874865,617659,0.802,136309,0.177
"30","alameda",30,"2021-01-13",5045,57321,2665,37072,2380,20249,0,0,3856,38028,1185,9644,3857,47672,"California",1685886,0.00572043424051211,617659,0.802,136309,0.177
"31","alameda",31,"2021-01-14",5638,62959,2772,39844,2866,23115,0,0,4752,41905,878,10522,4755,52427,"California",1685886,0.00624122864772588,617659,0.802,136309,0.177
"32","alameda",32,"2021-01-15",5842,68801,2314,42158,3528,26643,0,0,5075,46223,761,11283,5079,57506,"California",1685886,0.00669262334463896,617659,0.802,136309,0.177
"33","alameda",33,"2021-01-16",3007,71808,1409,43567,1598,28241,0,0,2737,48691,270,11553,2738,60244,"California",1685886,0.00685277652225595,617659,0.802,136309,0.177
"34","alameda",34,"2021-01-17",1869,73677,1083,44650,786,29027,0,0,1662,50148,206,11759,1663,61907,"California",1685886,0.00697496746517855,617659,0.802,136309,0.177
"35","alameda",35,"2021-01-18",3200,76877,2055,46705,1145,30172,0,0,2605,52167,591,12350,2610,64517,"California",1685886,0.00732552497618463,617659,0.802,136309,0.177
"36","alameda",36,"2021-01-19",5530,82407,3334,50039,2196,32368,0,0,4337,55315,1191,13541,4339,68856,"California",1685886,0.00803197843745069,617659,0.802,136309,0.177
"37","alameda",37,"2021-01-20",6780,89187,4111,54150,2669,35037,0,0,5483,59518,1284,14825,5487,74343,"California",1685886,0.00879359577100705,617659,0.802,136309,0.177
"38","alameda",38,"2021-01-21",7780,96967,3406,57556,4374,39411,0,0,6942,65633,832,15657,6947,81290,"California",1685886,0.00928710482203423,617659,0.802,136309,0.177
"39","alameda",39,"2021-01-22",6850,103817,2038,59594,4812,44223,0,0,5711,70214,1132,16789,5713,87003,"California",1685886,0.0099585618481914,617659,0.802,136309,0.177
"40","alameda",40,"2021-01-23",3290,107107,947,60541,2343,46566,0,0,2735,72396,555,17344,2737,89740,"California",1685886,0.0102877656021819,617659,0.802,136309,0.177
"41","alameda",41,"2021-01-24",2052,109159,656,61197,1396,47962,0,0,1776,73900,272,17616,1776,91516,"California",1685886,0.0104491050996331,617659,0.802,136309,0.177
"42","alameda",42,"2021-01-25",5221,114380,1984,63181,3237,51199,0,0,3634,75956,1579,19195,3635,95151,"California",1685886,0.0113857046087339,617659,0.802,136309,0.177
"43","alameda",43,"2021-01-26",7253,121633,2291,65472,4962,56161,0,0,5392,79495,1854,21049,5393,100544,"California",1685886,0.0124854230950373,617659,0.802,136309,0.177
"44","alameda",44,"2021-01-27",6669,128302,2076,67548,4593,60754,0,0,4820,82480,1835,22884,4820,105364,"California",1685886,0.0135738715429157,617659,0.802,136309,0.177
"45","alameda",45,"2021-01-28",7898,136200,2549,70097,5349,66103,0,0,5656,85911,2226,25110,5657,111021,"California",1685886,0.0148942455183802,617659,0.802,136309,0.177
"46","alameda",46,"2021-01-29",7928,144128,3184,73281,4744,70847,0,0,6104,90202,1814,26924,6105,117126,"California",1685886,0.0159702376079996,617659,0.802,136309,0.177
"47","alameda",47,"2021-01-30",3423,147551,1675,74956,1748,72595,0,0,2717,92219,700,27624,2717,119843,"California",1685886,0.0163854495499696,617659,0.802,136309,0.177
"48","alameda",48,"2021-01-31",1906,149457,965,75921,941,73536,0,0,1662,93640,241,27865,1662,121505,"California",1685886,0.0165284010899907,617659,0.802,136309,0.177
"49","alameda",49,"2021-02-01",5973,155430,3367,79288,2606,76142,0,0,4331,96336,1636,29501,4332,125837,"California",1685886,0.0174988107143662,617659,0.802,136309,0.177
"50","alameda",50,"2021-02-02",7473,162903,4256,83544,3217,79359,0,0,4675,98223,2788,32289,4675,130512,"California",1685886,0.0191525405632409,617659,0.802,136309,0.177
"51","alameda",51,"2021-02-03",7085,169988,3730,87274,3355,82714,0,0,4405,99959,2674,34963,4410,134922,"California",1685886,0.0207386501815662,617659,0.802,136309,0.177
"52","alameda",52,"2021-02-04",9524,179512,4129,91403,5395,88109,0,0,6433,103325,3072,38035,6438,141360,"California",1685886,0.0225608374468974,617659,0.802,136309,0.177
"53","alameda",53,"2021-02-05",10343,189855,5396,96799,4947,93056,0,0,6469,105932,3868,41903,6475,147835,"California",1685886,0.02485518000624,617659,0.802,136309,0.177
"54","alameda",54,"2021-02-06",6998,196853,4437,101236,2561,95617,0,0,5875,110684,1123,43026,5875,153710,"California",1685886,0.0255212985931433,617659,0.802,136309,0.177
"55","alameda",55,"2021-02-07",3585,200438,2895,104131,690,96307,0,0,2641,112385,941,43967,2642,156352,"California",1685886,0.0260794620751344,617659,0.802,136309,0.177
"56","alameda",56,"2021-02-08",8101,208539,5790,109921,2311,98618,0,0,5544,115385,2546,46513,5546,161898,"California",1685886,0.0275896472240709,617659,0.802,136309,0.177
"57","alameda",57,"2021-02-09",9722,218261,5865,115786,3857,102475,0,0,6071,117813,3645,50158,6073,167971,"California",1685886,0.0297517151219003,617659,0.802,136309,0.177
"58","alameda",58,"2021-02-10",11471,229732,6784,122570,4687,107162,0,0,6572,119512,4881,55039,6580,174551,"California",1685886,0.0326469286772652,617659,0.802,136309,0.177
"59","alameda",59,"2021-02-11",13940,243672,7990,130560,5950,113112,0,0,8376,122345,5546,60585,8379,182930,"California",1685886,0.0359365935775017,617659,0.802,136309,0.177
"60","alameda",60,"2021-02-12",12544,256216,5700,136260,6844,119956,0,0,7762,125342,4768,65353,7765,190695,"California",1685886,0.0387647800622343,617659,0.802,136309,0.177
"61","alameda",61,"2021-02-13",7820,264036,4070,140330,3750,123706,0,0,5854,129237,1961,67314,5856,196551,"California",1685886,0.0399279666596674,617659,0.802,136309,0.177
"62","alameda",62,"2021-02-14",4035,268071,2538,142868,1497,125203,0,0,2872,130953,1159,68473,2875,199426,"California",1685886,0.0406154390035862,617659,0.802,136309,0.177
"63","alameda",63,"2021-02-15",5717,273788,3226,146094,2491,127694,0,0,3702,132648,2010,70483,3705,203131,"California",1685886,0.0418076904369572,617659,0.802,136309,0.177
"64","alameda",64,"2021-02-16",12541,286329,6961,153055,5580,133274,0,0,9322,138766,3209,73692,9327,212458,"California",1685886,0.043711140610931,617659,0.802,136309,0.177
"65","alameda",65,"2021-02-17",14118,300447,8359,161414,5759,139033,0,0,10489,145646,3611,77303,10491,222949,"California",1685886,0.045853041071579,617659,0.802,136309,0.177
"66","alameda",66,"2021-02-18",15879,316326,10069,171483,5810,144843,0,0,11522,152825,4349,81652,11528,234477,"California",1685886,0.0484326935510467,617659,0.802,136309,0.177
"67","alameda",67,"2021-02-19",17662,333988,11453,182936,6209,151052,0,0,11702,158593,5938,87590,11706,246183,"California",1685886,0.0519548771387864,617659,0.802,136309,0.177
"68","alameda",68,"2021-02-20",11870,345858,9616,192552,2254,153306,0,0,9145,165024,2720,90310,9151,255334,"California",1685886,0.0535682721132983,617659,0.802,136309,0.177
"69","alameda",69,"2021-02-21",6253,352111,5321,197873,932,154238,0,0,3773,166328,2469,92779,3773,259107,"California",1685886,0.0550327839486181,617659,0.802,136309,0.177
"70","alameda",70,"2021-02-22",10717,362828,7933,205806,2784,157022,0,0,6752,169138,3951,96730,6761,265868,"California",1685886,0.0573763587810801,617659,0.802,136309,0.177
"71","alameda",71,"2021-02-23",12741,375569,7734,213540,5007,162029,0,0,7924,172262,4807,101537,7931,273799,"California",1685886,0.0602276785025797,617659,0.802,136309,0.177
"72","alameda",72,"2021-02-24",14671,390240,8218,221758,6453,168482,0,0,9512,176681,5098,106635,9517,283316,"California",1685886,0.0632516077599553,617659,0.802,136309,0.177
"73","alameda",73,"2021-02-25",15648,405888,9140,230898,6508,174990,0,0,9967,181006,5649,112284,9974,293290,"California",1685886,0.066602368131653,617659,0.802,136309,0.177
"74","alameda",74,"2021-02-26",18113,424001,10646,241544,7467,182457,0,0,11712,186362,6360,118644,11716,305006,"California",1685886,0.0703748652044088,617659,0.802,136309,0.177
"75","alameda",75,"2021-02-27",14731,438732,10833,252377,3896,186353,2,2,9121,189899,5588,124232,9125,314131,"California",1685886,0.0736894428211635,617659,0.802,136309,0.177
"76","alameda",76,"2021-02-28",9166,447898,7724,260101,1442,187795,0,2,6082,192921,3061,127293,6083,320214,"California",1685886,0.0755051053274065,617659,0.802,136309,0.177
"77","alameda",77,"2021-03-01",13282,461180,9226,269327,4050,191845,6,8,8230,196156,5007,132300,8242,328456,"California",1685886,0.078475057032326,617659,0.802,136309,0.177
"78","alameda",78,"2021-03-02",13854,475034,9628,278955,4225,196070,1,9,8899,200129,4934,137234,8907,337363,"California",1685886,0.0814017080632973,617659,0.802,136309,0.177
"79","alameda",79,"2021-03-03",15424,490458,10016,288971,5407,201477,1,10,10505,205748,4891,142125,10510,347873,"California",1685886,0.0843028532178332,617659,0.802,136309,0.177
"80","alameda",80,"2021-03-04",17333,507791,11082,300053,6249,207726,2,12,10891,210233,6408,148533,10893,358766,"California",1685886,0.0881038219666098,617659,0.802,136309,0.177
"81","alameda",81,"2021-03-05",15879,523670,10250,310303,5620,213346,9,21,10647,215702,5193,153726,10662,369428,"California",1685886,0.09118410141611,617659,0.802,136309,0.177
"82","alameda",82,"2021-03-06",14272,537942,9987,320290,4023,217369,262,283,9371,220479,4858,158584,9635,379063,"California",1685886,0.0940656722933816,617659,0.802,136309,0.177
"83","alameda",83,"2021-03-07",9366,547308,8141,328431,1144,218513,81,364,6587,224398,2751,161335,6670,385733,"California",1685886,0.0956974552253237,617659,0.802,136309,0.177
"84","alameda",84,"2021-03-08",11678,558986,7185,335616,4114,222627,379,743,8669,230487,2959,164294,9048,394781,"California",1685886,0.0974526154200225,617659,0.802,136309,0.177
"85","alameda",85,"2021-03-09",11429,570415,7063,342679,3938,226565,428,1171,6304,232129,5092,169386,6734,401515,"California",1685886,0.100472985717896,617659,0.802,136309,0.177
"86","alameda",86,"2021-03-10",16694,587109,11338,354017,4798,231363,558,1729,7562,231138,9107,178493,8116,409631,"California",1685886,0.105874893082925,617659,0.802,136309,0.177
"87","alameda",87,"2021-03-11",19785,606894,11568,365585,6511,237874,1706,3435,6776,226636,12979,191472,8477,418108,"California",1685886,0.113573515646965,617659,0.802,136309,0.177
"88","alameda",88,"2021-03-12",21170,628064,12325,377910,7191,245065,1654,5089,7476,222087,13671,205143,9122,427230,"California",1685886,0.121682604873639,617659,0.802,136309,0.177
"89","alameda",89,"2021-03-13",15850,643914,10106,388016,4757,249822,987,6076,5110,217477,10705,215848,6095,433325,"California",1685886,0.128032381786194,617659,0.802,136309,0.177
"90","alameda",90,"2021-03-14",10706,654620,7820,395836,2101,251923,785,6861,4644,216853,6045,221893,5421,438746,"California",1685886,0.131618033485064,617659,0.802,136309,0.177
"91","alameda",91,"2021-03-15",14323,668943,9333,405169,4472,256395,518,7379,6373,215820,7920,229813,6887,445633,"California",1685886,0.136315860028495,617659,0.802,136309,0.177
"92","alameda",92,"2021-03-16",17185,686128,11122,416291,5529,261924,534,7913,7573,214367,9561,239374,8108,453741,"California",1685886,0.141987061995888,617659,0.802,136309,0.177
"93","alameda",93,"2021-03-17",17394,703522,9797,426088,6902,268826,695,8608,8180,214064,9177,248551,8874,462615,"California",1685886,0.147430490555115,617659,0.802,136309,0.177
"94","alameda",94,"2021-03-18",19092,722614,10357,436445,7858,276684,877,9485,8787,213457,10275,258826,9668,472283,"California",1685886,0.153525208703317,617659,0.802,136309,0.177
"95","alameda",95,"2021-03-19",19134,741748,10363,446808,6986,283670,1785,11270,7661,211472,11425,270251,9440,481723,"California",1685886,0.160302060756184,617659,0.802,136309,0.177
"96","alameda",96,"2021-03-20",15641,757389,10205,457013,4613,288283,823,12093,6546,209772,9066,279317,7366,489089,"California",1685886,0.165679648564612,617659,0.802,136309,0.177
"97","alameda",97,"2021-03-21",9065,766454,7106,464119,1426,289709,533,12626,3777,208805,5278,284595,4311,493400,"California",1685886,0.168810346607066,617659,0.802,136309,0.177
"98","alameda",98,"2021-03-22",14902,781356,10014,474133,3911,293620,977,13603,7178,209259,7698,292293,8152,501552,"California",1685886,0.173376491648902,617659,0.802,136309,0.177
"99","alameda",99,"2021-03-23",19132,800488,11524,485657,6816,300436,792,14395,10733,212434,8356,300649,11531,513083,"California",1685886,0.178332935916189,617659,0.802,136309,0.177
"100","alameda",100,"2021-03-24",19024,819512,11456,497113,6576,307012,992,15387,8590,211636,10371,311020,9573,522656,"California",1685886,0.184484597416433,617659,0.802,136309,0.177
"101","alameda",101,"2021-03-25",20382,839894,11264,508377,7736,314748,1382,16769,9575,211842,10739,321759,10945,533601,"California",1685886,0.190854541766169,617659,0.802,136309,0.177
"102","alameda",102,"2021-03-26",20695,860589,12391,520768,6768,321516,1536,18305,8875,210468,11775,333534,10401,544002,"California",1685886,0.197838999790021,617659,0.802,136309,0.177
"103","alameda",103,"2021-03-27",18205,878794,12347,533115,4896,326412,962,19267,7854,208961,10304,343838,8797,552799,"California",1685886,0.203950919575819,617659,0.802,136309,0.177
"104","alameda",104,"2021-03-28",10439,889233,8454,541569,1781,328193,204,19471,3832,206411,6594,350432,4044,556843,"California",1685886,0.207862216069177,617659,0.802,136309,0.177
"105","alameda",105,"2021-03-29",14607,903840,9295,550864,4315,332508,997,20468,6285,205404,8288,358720,7281,564124,"California",1685886,0.212778325462101,617659,0.802,136309,0.177
"106","alameda",106,"2021-03-30",18470,922310,9690,560554,7083,339591,1697,22165,10832,210318,7609,366329,12523,576647,"California",1685886,0.217291679271315,617659,0.802,136309,0.177
"107","alameda",107,"2021-03-31",19252,941562,10137,570691,7048,346639,2067,24232,9548,212248,9679,376008,11609,588256,"California",1685886,0.223032874108926,617659,0.802,136309,0.177
"108","alameda",108,"2021-04-01",23079,964641,9995,580686,7587,354226,5497,29729,11034,216755,12011,388019,16518,604774,"California",1685886,0.230157317873213,617659,0.802,136309,0.177
"109","alameda",109,"2021-04-02",23822,988463,9903,590589,8241,362467,5678,35407,11587,221804,12200,400219,17249,622023,"California",1685886,0.237393868861833,617659,0.802,136309,0.177
"110","alameda",110,"2021-04-03",20146,1008609,9749,600338,5694,368161,4703,40110,10327,227033,9801,410020,15030,637053,"California",1685886,0.24320742920933,617659,0.802,136309,0.177
"111","alameda",111,"2021-04-04",9936,1018545,3969,604307,2284,370445,3683,43793,3518,227823,6405,416425,7195,644248,"California",1685886,0.247006618478355,617659,0.802,136309,0.177
"112","alameda",112,"2021-04-05",17791,1036336,7502,611809,5519,375964,4770,48563,7270,229356,10503,426928,12036,656284,"California",1685886,0.253236577087656,617659,0.802,136309,0.177
"113","alameda",113,"2021-04-06",22174,1058510,10705,622514,5647,381611,5822,54385,10110,233245,12031,438959,15920,672204,"California",1685886,0.260372884050286,617659,0.802,136309,0.177
"114","alameda",114,"2021-04-07",22476,1080986,11540,634054,5501,387112,5435,59820,11419,239075,11015,449974,16845,689049,"California",1685886,0.266906540537142,617659,0.802,136309,0.177
"115","alameda",115,"2021-04-08",25402,1106388,11489,645543,5957,393069,7956,67776,10849,243385,14484,464458,18794,707843,"California",1685886,0.275497868776418,617659,0.802,136309,0.177
"116","alameda",116,"2021-04-09",23276,1129664,10610,656153,7461,400530,5205,72981,12013,249369,11234,475692,17218,725061,"California",1685886,0.282161427285119,617659,0.802,136309,0.177
"117","alameda",117,"2021-04-10",18842,1148506,7423,663576,5595,406125,5824,78805,8186,252731,10634,486326,13996,739057,"California",1685886,0.28846908984356,617659,0.802,136309,0.177
"118","alameda",118,"2021-04-11",10992,1159498,4789,668365,2270,408395,3933,82738,4498,254676,6476,492802,8421,747478,"California",1685886,0.292310393466699,617659,0.802,136309,0.177
"119","alameda",119,"2021-04-12",17948,1177446,11717,680082,4298,412693,1933,84671,10121,258933,7793,500595,12050,759528,"California",1685886,0.296932888700659,617659,0.802,136309,0.177
"120","alameda",120,"2021-04-13",23012,1200458,14600,694682,8357,421050,55,84726,16954,269940,6013,506608,17020,776548,"California",1685886,0.300499559282182,617659,0.802,136309,0.177
"121","alameda",121,"2021-04-14",23123,1223581,15299,709981,7823,428873,1,84727,15700,278257,7391,513999,15708,792256,"California",1685886,0.304883604229467,617659,0.802,136309,0.177
"122","alameda",122,"2021-04-15",24113,1247694,15410,725391,8701,437574,2,84729,16023,286254,8035,522034,16032,808288,"California",1685886,0.309649644163366,617659,0.802,136309,0.177
"123","alameda",123,"2021-04-16",24366,1272060,14404,739795,9957,447531,5,84734,15718,293388,8599,530633,15733,824021,"California",1685886,0.314750226290508,617659,0.802,136309,0.177
"124","alameda",124,"2021-04-17",20768,1292828,14322,754117,6446,453977,0,84734,14315,301298,6419,537052,14329,838350,"California",1685886,0.318557719798373,617659,0.802,136309,0.177
"125","alameda",125,"2021-04-18",9904,1302732,7568,761685,2336,456313,0,84734,6858,305141,3020,540072,6863,845213,"California",1685886,0.320349062748015,617659,0.802,136309,0.177
"126","alameda",126,"2021-04-19",15580,1318312,9654,771339,5925,462238,1,84735,8996,307616,6531,546603,9006,854219,"California",1685886,0.324222990166595,617659,0.802,136309,0.177
"127","alameda",127,"2021-04-20",18091,1336403,11050,782389,7040,469278,1,84736,9887,309374,8150,554753,9908,864127,"California",1685886,0.32905724349096,617659,0.802,136309,0.177
"128","alameda",128,"2021-04-21",19112,1355515,11195,793584,7909,477187,8,84744,11113,312592,7922,562675,11140,875267,"California",1685886,0.333756256354226,617659,0.802,136309,0.177
"129","alameda",129,"2021-04-22",21373,1376888,13767,807351,7603,484790,3,84747,11358,314013,9966,572641,11387,886654,"California",1685886,0.339667688088044,617659,0.802,136309,0.177
"130","alameda",130,"2021-04-23",21660,1398548,14047,821398,7611,492401,2,84749,12117,316665,9492,582133,12144,898798,"California",1685886,0.345297962021157,617659,0.802,136309,0.177
"131","alameda",131,"2021-04-24",18960,1417508,14386,835784,4567,496968,7,84756,10020,317798,8904,591037,10037,908835,"California",1685886,0.350579457923015,617659,0.802,136309,0.177
"132","alameda",132,"2021-04-25",8805,1426313,6865,842649,1940,498908,0,84756,5721,320459,3070,594107,5731,914566,"California",1685886,0.352400458868512,617659,0.802,136309,0.177
"133","alameda",133,"2021-04-26",13214,1439527,9158,851807,4034,502942,22,84778,8252,323807,4934,599041,8282,922848,"California",1685886,0.355327109899483,617659,0.802,136309,0.177
"134","alameda",134,"2021-04-27",15117,1454644,8896,860703,5916,508858,305,85083,7123,323310,7949,606990,7452,930300,"California",1685886,0.360042138080511,617659,0.802,136309,0.177
"135","alameda",135,"2021-04-28",15953,1470597,10146,870849,5342,514200,465,85548,6212,320290,9711,616701,6691,936991,"California",1685886,0.365802314035469,617659,0.802,136309,0.177
"136","alameda",136,"2021-04-29",16657,1487254,10020,880869,6314,520514,323,85871,5968,315958,10645,627346,6313,943304,"California",1685886,0.372116501352998,617659,0.802,136309,0.177
"137","alameda",137,"2021-04-30",19431,1506685,12005,892874,7086,527600,340,86211,7864,312702,11495,638841,8239,951543,"California",1685886,0.378934874600062,617659,0.802,136309,0.177
"138","alameda",138,"2021-05-01",13966,1520651,9312,902186,4447,532047,207,86418,5188,309379,8750,647591,5427,956970,"California",1685886,0.384125023874687,617659,0.802,136309,0.177
"139","alameda",139,"2021-05-02",7040,1527691,4898,907084,1971,534018,171,86589,2866,308264,4157,651748,3042,960012,"California",1685886,0.386590789650071,617659,0.802,136309,0.177
"140","alameda",140,"2021-05-03",14395,1542086,10904,917988,3177,537195,314,86903,2816,299884,11541,663289,3161,963173,"California",1685886,0.393436448253322,617659,0.802,136309,0.177
"141","alameda",141,"2021-05-04",18233,1560319,13076,931064,4793,541988,364,87267,3629,289363,14540,677829,4019,967192,"California",1685886,0.402060993447956,617659,0.802,136309,0.177
"142","alameda",142,"2021-05-05",18430,1578749,13412,944476,4509,546497,509,87776,3751,279018,14619,692448,4274,971466,"California",1685886,0.41073239827604,617659,0.802,136309,0.177
"143","alameda",143,"2021-05-06",18395,1597144,13916,958392,3825,550322,654,88430,3613,268584,14715,707163,4281,975747,"California",1685886,0.419460746456166,617659,0.802,136309,0.177
"144","alameda",144,"2021-05-07",19016,1616160,12761,971153,5839,556161,416,88846,4392,258849,14559,721722,4824,980571,"California",1685886,0.428096561689225,617659,0.802,136309,0.177
"145","alameda",145,"2021-05-08",16393,1632553,11208,982361,4966,561127,219,89065,3102,248930,13252,734974,3333,983904,"California",1685886,0.435957116910633,617659,0.802,136309,0.177
"146","alpine",146,"2020-12-18",2,2,2,2,0,0,0,0,2,2,0,0,2,2,"California",1117,0,476,0.642,244,0.329
"147","alpine",147,"2020-12-19",2,4,2,4,0,0,0,0,2,4,0,0,2,4,"California",1117,0,476,0.642,244,0.329
"148","alpine",148,"2020-12-21",2,6,2,6,0,0,0,0,2,6,0,0,2,6,"California",1117,0,476,0.642,244,0.329
"149","alpine",149,"2020-12-30",14,20,0,6,14,14,0,0,14,20,0,0,14,20,"California",1117,0,476,0.642,244,0.329
"150","alpine",150,"2020-12-31",1,21,0,6,1,15,0,0,1,21,0,0,1,21,"California",1117,0,476,0.642,244,0.329
"151","alpine",151,"2021-01-01",1,22,0,6,1,16,0,0,1,22,0,0,1,22,"California",1117,0,476,0.642,244,0.329
"152","alpine",152,"2021-01-02",1,23,1,7,0,16,0,0,1,23,0,0,1,23,"California",1117,0,476,0.642,244,0.329
"153","alpine",153,"2021-01-04",10,33,0,7,10,26,0,0,10,33,0,0,10,33,"California",1117,0,476,0.642,244,0.329
"154","alpine",154,"2021-01-05",9,42,1,8,8,34,0,0,9,42,0,0,9,42,"California",1117,0,476,0.642,244,0.329
"155","alpine",155,"2021-01-06",31,73,0,8,31,65,0,0,31,73,0,0,31,73,"California",1117,0,476,0.642,244,0.329
"156","alpine",156,"2021-01-07",8,81,0,8,8,73,0,0,8,81,0,0,8,81,"California",1117,0,476,0.642,244,0.329
"157","alpine",157,"2021-01-08",4,85,2,10,2,75,0,0,2,81,2,2,2,83,"California",1117,0.0017905102954342,476,0.642,244,0.329
"158","alpine",158,"2021-01-09",2,87,2,12,0,75,0,0,0,79,2,4,0,83,"California",1117,0.0035810205908684,476,0.642,244,0.329
"159","alpine",159,"2021-01-11",32,119,1,13,31,106,0,0,31,109,1,5,31,114,"California",1117,0.0044762757385855,476,0.642,244,0.329
"160","alpine",160,"2021-01-13",35,154,0,13,35,141,0,0,35,144,0,5,35,149,"California",1117,0.0044762757385855,476,0.642,244,0.329
"161","alpine",161,"2021-01-14",1,155,0,13,1,142,0,0,1,145,0,5,1,150,"California",1117,0.0044762757385855,476,0.642,244,0.329
"162","alpine",162,"2021-01-15",1,156,0,13,1,143,0,0,1,146,0,5,1,151,"California",1117,0.0044762757385855,476,0.642,244,0.329
"163","alpine",163,"2021-01-20",21,177,0,13,21,164,0,0,21,167,0,5,21,172,"California",1117,0.0044762757385855,476,0.642,244,0.329
"164","alpine",164,"2021-01-21",1,178,0,13,1,165,0,0,1,168,0,5,1,173,"California",1117,0.0044762757385855,476,0.642,244,0.329
"165","alpine",165,"2021-01-22",32,210,0,13,32,197,0,0,32,200,0,5,32,205,"California",1117,0.0044762757385855,476,0.642,244,0.329
"166","alpine",166,"2021-01-23",1,211,1,14,0,197,0,0,0,199,1,6,0,205,"California",1117,0.0053715308863026,476,0.642,244,0.329
"167","alpine",167,"2021-01-25",16,227,0,14,16,213,0,0,16,215,0,6,16,221,"California",1117,0.0053715308863026,476,0.642,244,0.329
"168","alpine",168,"2021-01-27",1,228,1,15,0,213,0,0,0,214,1,7,0,221,"California",1117,0.0062667860340197,476,0.642,244,0.329
"169","alpine",169,"2021-01-28",1,229,0,15,1,214,0,0,0,213,1,8,0,221,"California",1117,0.00716204118173679,476,0.642,244,0.329
"170","alpine",170,"2021-01-29",1,230,0,15,1,215,0,0,1,214,0,8,1,222,"California",1117,0.00716204118173679,476,0.642,244,0.329
"171","alpine",171,"2021-02-01",25,255,0,15,25,240,0,0,7,203,18,26,7,229,"California",1117,0.0232766338406446,476,0.642,244,0.329
"172","alpine",172,"2021-02-03",34,289,0,15,34,274,0,0,10,189,24,50,10,239,"California",1117,0.044762757385855,476,0.642,244,0.329
"173","alpine",173,"2021-02-04",8,297,0,15,8,282,0,0,3,187,5,55,3,242,"California",1117,0.0492390331244405,476,0.642,244,0.329
"174","alpine",174,"2021-02-05",31,328,0,15,31,313,0,0,12,180,19,74,12,254,"California",1117,0.0662488809310654,476,0.642,244,0.329
"175","alpine",175,"2021-02-06",1,329,1,16,0,313,0,0,1,181,0,74,1,255,"California",1117,0.0662488809310654,476,0.642,244,0.329
"176","alpine",176,"2021-02-07",1,330,1,17,0,313,0,0,1,182,0,74,1,256,"California",1117,0.0662488809310654,476,0.642,244,0.329
"177","alpine",177,"2021-02-08",32,362,0,17,32,345,0,0,4,158,28,102,4,260,"California",1117,0.0913160250671441,476,0.642,244,0.329
"178","alpine",178,"2021-02-10",34,396,0,17,34,379,0,0,0,124,34,136,0,260,"California",1117,0.121754700089526,476,0.642,244,0.329
"179","alpine",179,"2021-02-11",6,402,0,17,6,385,0,0,3,124,3,139,3,263,"California",1117,0.124440465532677,476,0.642,244,0.329
"180","alpine",180,"2021-02-12",1,403,0,17,1,386,0,0,0,123,1,140,0,263,"California",1117,0.125335720680394,476,0.642,244,0.329
"181","alpine",181,"2021-02-17",23,426,0,17,23,409,0,0,3,106,20,160,3,266,"California",1117,0.143240823634736,476,0.642,244,0.329
"182","alpine",182,"2021-02-18",2,428,0,17,2,411,0,0,1,106,1,161,1,267,"California",1117,0.144136078782453,476,0.642,244,0.329
"183","alpine",183,"2021-02-19",34,462,1,18,33,444,0,0,2,76,32,193,2,269,"California",1117,0.1727842435094,476,0.642,244,0.329
"184","alpine",184,"2021-02-22",27,489,0,18,27,471,0,0,8,65,19,212,8,277,"California",1117,0.189794091316025,476,0.642,244,0.329
"185","alpine",185,"2021-02-24",1,490,1,19,0,471,0,0,1,66,0,212,1,278,"California",1117,0.189794091316025,476,0.642,244,0.329
"186","alpine",186,"2021-02-25",6,496,1,20,5,476,0,0,6,72,0,212,6,284,"California",1117,0.189794091316025,476,0.642,244,0.329
"187","alpine",187,"2021-02-26",30,526,1,21,29,505,0,0,29,100,1,213,29,313,"California",1117,0.190689346463742,476,0.642,244,0.329
"188","alpine",188,"2021-02-27",1,527,0,21,1,506,0,0,1,101,0,213,1,314,"California",1117,0.190689346463742,476,0.642,244,0.329
"189","alpine",189,"2021-03-01",36,563,0,21,36,542,0,0,26,117,10,223,26,340,"California",1117,0.199641897940913,476,0.642,244,0.329
"190","alpine",190,"2021-03-02",1,564,1,22,0,542,0,0,0,116,1,224,0,340,"California",1117,0.20053715308863,476,0.642,244,0.329
"191","alpine",191,"2021-03-03",30,594,1,23,29,571,0,0,18,122,12,236,18,358,"California",1117,0.211280214861235,476,0.642,244,0.329
"192","alpine",192,"2021-03-04",11,605,1,24,10,581,0,0,11,133,0,236,11,369,"California",1117,0.211280214861235,476,0.642,244,0.329
"193","alpine",193,"2021-03-05",30,635,0,24,30,611,0,0,22,147,8,244,22,391,"California",1117,0.218442256042972,476,0.642,244,0.329
"194","alpine",194,"2021-03-08",31,666,0,24,31,642,0,0,29,174,2,246,29,420,"California",1117,0.220232766338406,476,0.642,244,0.329
"195","alpine",195,"2021-03-10",73,739,0,24,73,715,0,0,73,247,0,246,73,493,"California",1117,0.220232766338406,476,0.642,244,0.329
"196","alpine",196,"2021-03-11",35,774,0,24,35,750,0,0,31,274,4,250,31,524,"California",1117,0.223813786929275,476,0.642,244,0.329
"197","alpine",197,"2021-03-12",19,793,0,24,19,769,0,0,17,289,2,252,17,541,"California",1117,0.225604297224709,476,0.642,244,0.329
"198","alpine",198,"2021-03-15",21,814,1,25,20,789,0,0,20,308,1,253,20,561,"California",1117,0.226499552372426,476,0.642,244,0.329
"199","alpine",199,"2021-03-17",23,837,0,25,22,811,1,1,19,324,4,257,20,581,"California",1117,0.230080572963295,476,0.642,244,0.329
"200","alpine",200,"2021-03-18",38,875,3,28,35,846,0,1,35,356,3,260,35,616,"California",1117,0.232766338406446,476,0.642,244,0.329
"201","alpine",201,"2021-03-19",2,877,1,29,1,847,0,1,1,356,1,261,1,617,"California",1117,0.233661593554163,476,0.642,244,0.329
"202","alpine",202,"2021-03-22",24,901,0,29,24,871,0,1,15,362,9,270,15,632,"California",1117,0.241718889883617,476,0.642,244,0.329
"203","alpine",203,"2021-03-24",19,920,0,29,19,890,0,1,8,359,11,281,8,640,"California",1117,0.251566696508505,476,0.642,244,0.329
"204","alpine",204,"2021-03-25",35,955,1,30,33,923,1,2,28,381,7,288,29,669,"California",1117,0.257833482542525,476,0.642,244,0.329
"205","alpine",205,"2021-03-27",1,956,0,30,1,924,0,2,0,380,1,289,0,669,"California",1117,0.258728737690242,476,0.642,244,0.329
"206","alpine",206,"2021-03-28",1,957,1,31,0,924,0,2,1,381,0,289,1,670,"California",1117,0.258728737690242,476,0.642,244,0.329
"207","alpine",207,"2021-03-29",19,976,0,31,18,942,1,3,2,367,17,306,3,673,"California",1117,0.273948075201432,476,0.642,244,0.329
"208","alpine",208,"2021-04-01",18,994,0,31,18,960,0,3,8,365,10,316,8,681,"California",1117,0.282900626678603,476,0.642,244,0.329
"209","alpine",209,"2021-04-02",101,1095,1,32,100,1060,0,3,46,357,54,370,46,727,"California",1117,0.331244404655327,476,0.642,244,0.329
"210","alpine",210,"2021-04-05",4,1099,1,33,3,1063,0,3,0,353,4,374,0,727,"California",1117,0.334825425246195,476,0.642,244,0.329
"211","alpine",211,"2021-04-06",3,1102,2,35,1,1064,0,3,2,354,1,375,2,729,"California",1117,0.335720680393912,476,0.642,244,0.329
"212","alpine",212,"2021-04-07",117,1219,0,35,116,1180,1,4,30,299,86,461,31,760,"California",1117,0.412712623097583,476,0.642,244,0.329
"213","alpine",213,"2021-04-08",37,1256,0,35,35,1215,2,6,10,284,27,488,12,772,"California",1117,0.436884512085944,476,0.642,244,0.329
"214","alpine",214,"2021-04-09",1,1257,0,35,1,1216,0,6,1,285,0,488,1,773,"California",1117,0.436884512085944,476,0.642,244,0.329
"215","alpine",215,"2021-04-14",47,1304,0,35,47,1263,0,6,10,258,37,525,10,783,"California",1117,0.470008952551477,476,0.642,244,0.329
"216","alpine",216,"2021-04-15",35,1339,0,35,35,1298,0,6,3,229,32,557,3,786,"California",1117,0.498657117278424,476,0.642,244,0.329
"217","alpine",217,"2021-04-16",1,1340,0,35,1,1299,0,6,1,230,0,557,1,787,"California",1117,0.498657117278424,476,0.642,244,0.329
"218","alpine",218,"2021-04-19",1,1341,0,35,1,1300,0,6,1,231,0,557,1,788,"California",1117,0.498657117278424,476,0.642,244,0.329
"219","alpine",219,"2021-04-21",31,1372,0,35,31,1331,0,6,15,230,16,573,15,803,"California",1117,0.512981199641898,476,0.642,244,0.329
"220","alpine",220,"2021-04-22",24,1396,0,35,24,1355,0,6,1,208,23,596,1,804,"California",1117,0.533572068039391,476,0.642,244,0.329
"221","alpine",221,"2021-04-24",2,1398,2,37,0,1355,0,6,0,207,2,598,1,805,"California",1117,0.535362578334825,476,0.642,244,0.329
"222","alpine",222,"2021-04-25",1,1399,1,38,0,1355,0,6,0,206,1,599,0,805,"California",1117,0.536257833482543,476,0.642,244,0.329
"223","alpine",223,"2021-04-27",2,1401,1,39,1,1356,0,6,1,206,1,600,1,806,"California",1117,0.53715308863026,476,0.642,244,0.329
"224","alpine",224,"2021-04-28",36,1437,0,39,36,1392,0,6,6,182,30,630,6,812,"California",1117,0.564010743061773,476,0.642,244,0.329
"225","alpine",225,"2021-04-29",7,1444,1,40,6,1398,0,6,1,177,6,636,1,813,"California",1117,0.569382273948075,476,0.642,244,0.329
"226","alpine",226,"2021-04-30",2,1446,1,41,0,1398,1,7,1,178,1,637,2,815,"California",1117,0.570277529095792,476,0.642,244,0.329
"227","alpine",227,"2021-05-02",1,1447,0,41,0,1398,1,8,0,178,1,638,1,816,"California",1117,0.571172784243509,476,0.642,244,0.329
"228","alpine",228,"2021-05-05",17,1464,0,41,17,1415,0,8,4,169,13,651,4,820,"California",1117,0.582811101163832,476,0.642,244,0.329
"229","alpine",229,"2021-05-06",7,1471,0,41,7,1422,0,8,0,162,7,658,0,820,"California",1117,0.589077887197851,476,0.642,244,0.329
"230","alpine",230,"2021-05-07",1,1472,0,41,1,1423,0,8,0,161,1,659,0,820,"California",1117,0.589973142345569,476,0.642,244,0.329
"231","amador",231,"2020-12-16",2,2,2,2,0,0,0,0,2,2,0,0,2,2,"California",38531,0,8153,0.366,13585,0.609
"232","amador",232,"2020-12-17",5,7,5,7,0,0,0,0,5,7,0,0,5,7,"California",38531,0,8153,0.366,13585,0.609
"233","amador",233,"2020-12-18",45,52,45,52,0,0,0,0,45,52,0,0,45,52,"California",38531,0,8153,0.366,13585,0.609
"234","amador",234,"2020-12-19",17,69,17,69,0,0,0,0,17,69,0,0,17,69,"California",38531,0,8153,0.366,13585,0.609
"235","amador",235,"2020-12-20",4,73,4,73,0,0,0,0,4,73,0,0,4,73,"California",38531,0,8153,0.366,13585,0.609
"236","amador",236,"2020-12-21",31,104,31,104,0,0,0,0,31,104,0,0,31,104,"California",38531,0,8153,0.366,13585,0.609
"237","amador",237,"2020-12-22",35,139,34,138,1,1,0,0,35,139,0,0,35,139,"California",38531,0,8153,0.366,13585,0.609
"238","amador",238,"2020-12-23",39,178,38,176,1,2,0,0,39,178,0,0,39,178,"California",38531,0,8153,0.366,13585,0.609
"239","amador",239,"2020-12-24",5,183,3,179,2,4,0,0,5,183,0,0,5,183,"California",38531,0,8153,0.366,13585,0.609
"240","amador",240,"2020-12-26",5,188,4,183,1,5,0,0,5,188,0,0,5,188,"California",38531,0,8153,0.366,13585,0.609
"241","amador",241,"2020-12-27",1,189,0,183,1,6,0,0,1,189,0,0,1,189,"California",38531,0,8153,0.366,13585,0.609
"242","amador",242,"2020-12-28",31,220,27,210,4,10,0,0,31,220,0,0,31,220,"California",38531,0,8153,0.366,13585,0.609
"243","amador",243,"2020-12-29",26,246,19,229,7,17,0,0,26,246,0,0,26,246,"California",38531,0,8153,0.366,13585,0.609
"244","amador",244,"2020-12-30",124,370,78,307,46,63,0,0,124,370,0,0,124,370,"California",38531,0,8153,0.366,13585,0.609
"245","amador",245,"2020-12-31",191,561,166,473,25,88,0,0,191,561,0,0,191,561,"California",38531,0,8153,0.366,13585,0.609
"246","amador",246,"2021-01-01",2,563,0,473,2,90,0,0,2,563,0,0,2,563,"California",38531,0,8153,0.366,13585,0.609
"247","amador",247,"2021-01-02",56,619,56,529,0,90,0,0,56,619,0,0,56,619,"California",38531,0,8153,0.366,13585,0.609
"248","amador",248,"2021-01-03",65,684,17,546,48,138,0,0,65,684,0,0,65,684,"California",38531,0,8153,0.366,13585,0.609
"249","amador",249,"2021-01-04",124,808,1,547,123,261,0,0,124,808,0,0,124,808,"California",38531,0,8153,0.366,13585,0.609
"250","amador",250,"2021-01-05",33,841,3,550,30,291,0,0,31,838,2,2,32,840,"California",38531,5.19062572993174e-05,8153,0.366,13585,0.609
"251","amador",251,"2021-01-06",40,881,10,560,30,321,0,0,36,870,4,6,36,876,"California",38531,0.000155718771897952,8153,0.366,13585,0.609
"252","amador",252,"2021-01-07",230,1111,69,629,161,482,0,0,218,1076,12,18,218,1094,"California",38531,0.000467156315693857,8153,0.366,13585,0.609
"253","amador",253,"2021-01-08",84,1195,70,699,14,496,0,0,40,1073,44,62,41,1135,"California",38531,0.00160909397627884,8153,0.366,13585,0.609
"254","amador",254,"2021-01-09",11,1206,11,710,0,496,0,0,2,1066,9,71,2,1137,"California",38531,0.00184267213412577,8153,0.366,13585,0.609
"255","amador",255,"2021-01-10",6,1212,4,714,2,498,0,0,2,1064,4,75,2,1139,"California",38531,0.0019464846487244,8153,0.366,13585,0.609
"256","amador",256,"2021-01-11",124,1336,44,758,80,578,0,0,87,1115,37,112,88,1227,"California",38531,0.00290675040876178,8153,0.366,13585,0.609
"257","amador",257,"2021-01-12",64,1400,49,807,15,593,0,0,40,1131,24,136,40,1267,"California",38531,0.00352962549635359,8153,0.366,13585,0.609
"258","amador",258,"2021-01-13",38,1438,23,830,15,608,0,0,26,1145,12,148,26,1293,"California",38531,0.00384106304014949,8153,0.366,13585,0.609
"259","amador",259,"2021-01-14",146,1584,20,850,126,734,0,0,136,1272,10,158,137,1430,"California",38531,0.00410059432664608,8153,0.366,13585,0.609
"260","amador",260,"2021-01-15",56,1640,25,875,31,765,0,0,48,1312,8,166,48,1478,"California",38531,0.00430821935584335,8153,0.366,13585,0.609
"261","amador",261,"2021-01-16",19,1659,12,887,7,772,0,0,13,1320,6,172,14,1492,"California",38531,0.0044639381277413,8153,0.366,13585,0.609
"262","amador",262,"2021-01-17",26,1685,6,893,20,792,0,0,26,1346,0,172,26,1518,"California",38531,0.0044639381277413,8153,0.366,13585,0.609
"263","amador",263,"2021-01-18",32,1717,28,921,4,796,0,0,10,1334,22,194,10,1528,"California",38531,0.00503490695803379,8153,0.366,13585,0.609
"264","amador",264,"2021-01-19",121,1838,96,1017,25,821,0,0,77,1367,44,238,77,1605,"California",38531,0.00617684461861877,8153,0.366,13585,0.609
"265","amador",265,"2021-01-20",184,2022,34,1051,150,971,0,0,168,1520,15,253,168,1773,"California",38531,0.00656614154836365,8153,0.366,13585,0.609
"266","amador",266,"2021-01-21",255,2277,224,1275,31,1002,0,0,145,1556,110,363,146,1919,"California",38531,0.00942098569982611,8153,0.366,13585,0.609
"267","amador",267,"2021-01-22",135,2412,73,1348,62,1064,0,0,128,1677,7,370,128,2047,"California",38531,0.00960265760037373,8153,0.366,13585,0.609
"268","amador",268,"2021-01-23",52,2464,32,1380,20,1084,0,0,50,1725,2,372,50,2097,"California",38531,0.00965456385767304,8153,0.366,13585,0.609
"269","amador",269,"2021-01-24",28,2492,12,1392,16,1100,0,0,25,1747,3,375,25,2122,"California",38531,0.00973242324362202,8153,0.366,13585,0.609
"270","amador",270,"2021-01-25",59,2551,28,1420,31,1131,0,0,42,1772,17,392,42,2164,"California",38531,0.0101736264306662,8153,0.366,13585,0.609
"271","amador",271,"2021-01-26",245,2796,17,1437,228,1359,0,0,235,1997,10,402,235,2399,"California",38531,0.0104331577171628,8153,0.366,13585,0.609
"272","amador",272,"2021-01-27",298,3094,31,1468,267,1626,0,0,251,2204,45,447,252,2651,"California",38531,0.0116010485063974,8153,0.366,13585,0.609
"273","amador",273,"2021-01-28",347,3441,77,1545,270,1896,0,0,286,2430,61,508,287,2938,"California",38531,0.0131841893540266,8153,0.366,13585,0.609
"274","amador",274,"2021-01-29",96,3537,31,1576,65,1961,0,0,81,2496,15,523,81,3019,"California",38531,0.0135734862837715,8153,0.366,13585,0.609
"275","amador",275,"2021-01-30",169,3706,36,1612,133,2094,0,0,164,2655,5,528,164,3183,"California",38531,0.0137032519270198,8153,0.366,13585,0.609
"276","amador",276,"2021-01-31",32,3738,28,1640,4,2098,0,0,31,2685,1,529,31,3214,"California",38531,0.0137292050556695,8153,0.366,13585,0.609
"277","amador",277,"2021-02-01",63,3801,23,1663,40,2138,0,0,36,2694,27,556,36,3250,"California",38531,0.0144299395292102,8153,0.366,13585,0.609
"278","amador",278,"2021-02-02",212,4013,63,1726,149,2287,0,0,126,2737,83,639,126,3376,"California",38531,0.0165840492071319,8153,0.366,13585,0.609
"279","amador",279,"2021-02-03",141,4154,38,1764,103,2390,0,0,90,2777,50,689,90,3466,"California",38531,0.0178817056396149,8153,0.366,13585,0.609
"280","amador",280,"2021-02-04",250,4404,74,1838,176,2566,0,0,164,2857,86,775,166,3632,"California",38531,0.0201136747034855,8153,0.366,13585,0.609
"281","amador",281,"2021-02-05",331,4735,63,1901,268,2834,0,0,315,3156,16,791,315,3947,"California",38531,0.02052892476188,8153,0.366,13585,0.609
"282","amador",282,"2021-02-06",99,4834,80,1981,19,2853,0,0,95,3247,4,795,95,4042,"California",38531,0.0206327372764787,8153,0.366,13585,0.609
"283","amador",283,"2021-02-07",39,4873,35,2016,4,2857,0,0,35,3279,4,799,36,4078,"California",38531,0.0207365497910773,8153,0.366,13585,0.609
"284","amador",284,"2021-02-08",90,4963,62,2078,28,2885,0,0,73,3335,17,816,73,4151,"California",38531,0.0211777529781215,8153,0.366,13585,0.609
"285","amador",285,"2021-02-09",175,5138,83,2161,92,2977,0,0,110,3380,65,881,110,4261,"California",38531,0.0228647063403493,8153,0.366,13585,0.609
"286","amador",286,"2021-02-10",978,6116,80,2241,898,3875,0,0,945,4292,33,914,945,5206,"California",38531,0.0237211595857881,8153,0.366,13585,0.609
"287","amador",287,"2021-02-11",307,6423,119,2360,188,4063,0,0,201,4389,104,1018,201,5407,"California",38531,0.0264202849653526,8153,0.366,13585,0.609
"288","amador",288,"2021-02-12",328,6751,120,2480,208,4271,0,0,255,4571,73,1091,255,5662,"California",38531,0.0283148633567777,8153,0.366,13585,0.609
"289","amador",289,"2021-02-13",166,6917,82,2562,84,4355,0,0,140,4685,26,1117,140,5802,"California",38531,0.0289896447016688,8153,0.366,13585,0.609
"290","amador",290,"2021-02-14",123,7040,54,2616,69,4424,0,0,106,4774,17,1134,106,5908,"California",38531,0.029430847888713,8153,0.366,13585,0.609
"291","amador",291,"2021-02-15",185,7225,60,2676,125,4549,0,0,168,4926,16,1150,168,6076,"California",38531,0.0298460979471075,8153,0.366,13585,0.609
"292","amador",292,"2021-02-16",464,7689,53,2729,411,4960,0,0,425,5313,39,1189,426,6502,"California",38531,0.0308582699644442,8153,0.366,13585,0.609
"293","amador",293,"2021-02-17",261,7950,82,2811,179,5139,0,0,165,5382,96,1285,165,6667,"California",38531,0.0333497703148114,8153,0.366,13585,0.609
"294","amador",294,"2021-02-18",398,8348,99,2910,299,5438,0,0,336,5657,62,1347,337,7004,"California",38531,0.0349588642910903,8153,0.366,13585,0.609
"295","amador",295,"2021-02-19",195,8543,77,2987,118,5556,0,0,112,5686,83,1430,112,7116,"California",38531,0.037112973969012,8153,0.366,13585,0.609
"296","amador",296,"2021-02-20",95,8638,33,3020,62,5618,0,0,67,5725,28,1458,67,7183,"California",38531,0.0378396615712024,8153,0.366,13585,0.609
"297","amador",297,"2021-02-21",45,8683,34,3054,11,5629,0,0,15,5710,30,1488,15,7198,"California",38531,0.0386182554306922,8153,0.366,13585,0.609
"298","amador",298,"2021-02-22",65,8748,26,3080,39,5668,0,0,32,5710,32,1520,32,7230,"California",38531,0.0394487555474812,8153,0.366,13585,0.609
"299","amador",299,"2021-02-23",320,9068,54,3134,266,5934,0,0,140,5671,180,1700,141,7371,"California",38531,0.0441203187044198,8153,0.366,13585,0.609
"300","amador",300,"2021-02-24",394,9462,57,3191,337,6271,0,0,263,5807,127,1827,263,7634,"California",38531,0.0474163660429265,8153,0.366,13585,0.609
"301","amador",301,"2021-02-25",522,9984,117,3308,405,6676,0,0,280,5846,241,2068,280,7914,"California",38531,0.0536710700474942,8153,0.366,13585,0.609
"302","amador",302,"2021-02-26",612,10596,75,3383,537,7213,0,0,505,6245,107,2175,506,8420,"California",38531,0.0564480548130077,8153,0.366,13585,0.609
"303","amador",303,"2021-02-27",293,10889,93,3476,200,7413,0,0,103,6161,189,2364,105,8525,"California",38531,0.0613531961277932,8153,0.366,13585,0.609
"304","amador",304,"2021-02-28",103,10992,52,3528,51,7464,0,0,57,6174,46,2410,59,8584,"California",38531,0.0625470400456775,8153,0.366,13585,0.609
"305","amador",305,"2021-03-01",189,11181,66,3594,123,7587,0,0,120,6226,69,2479,121,8705,"California",38531,0.064337805922504,8153,0.366,13585,0.609
"306","amador",306,"2021-03-02",380,11561,64,3658,316,7903,0,0,330,6507,50,2529,331,9036,"California",38531,0.0656354623549869,8153,0.366,13585,0.609
"307","amador",307,"2021-03-03",244,11805,79,3737,165,8068,0,0,168,6601,75,2604,169,9205,"California",38531,0.0675819470037113,8153,0.366,13585,0.609
"308","amador",308,"2021-03-04",497,12302,116,3853,381,8449,0,0,394,6893,102,2706,394,9599,"California",38531,0.0702291661259765,8153,0.366,13585,0.609
"309","amador",309,"2021-03-05",511,12813,77,3930,434,8883,0,0,293,6971,217,2923,295,9894,"California",38531,0.0758609950429524,8153,0.366,13585,0.609
"310","amador",310,"2021-03-06",99,12912,45,3975,53,8936,1,1,54,6981,45,2968,55,9949,"California",38531,0.0770288858321871,8153,0.366,13585,0.609
"311","amador",311,"2021-03-07",63,12975,42,4017,21,8957,0,1,20,6958,43,3011,20,9969,"California",38531,0.0781448703641224,8153,0.366,13585,0.609
"312","amador",312,"2021-03-08",152,13127,71,4088,80,9037,1,2,91,6989,61,3072,92,10061,"California",38531,0.0797280112117516,8153,0.366,13585,0.609
"313","amador",313,"2021-03-09",370,13497,50,4138,320,9357,0,2,292,7206,75,3147,292,10353,"California",38531,0.081674495860476,8153,0.366,13585,0.609
"314","amador",314,"2021-03-10",511,14008,76,4214,433,9790,2,4,111,6920,400,3547,114,10467,"California",38531,0.0920557473203395,8153,0.366,13585,0.609
"315","amador",315,"2021-03-11",474,14482,118,4332,345,10135,11,15,299,7059,174,3721,313,10780,"California",38531,0.0965715917053801,8153,0.366,13585,0.609
"316","amador",316,"2021-03-12",570,15052,66,4398,496,10631,8,23,338,7179,231,3952,351,11131,"California",38531,0.102566764423451,8153,0.366,13585,0.609
"317","amador",317,"2021-03-13",114,15166,18,4416,89,10720,7,30,74,7224,40,3992,85,11216,"California",38531,0.103604889569438,8153,0.366,13585,0.609
"318","amador",318,"2021-03-14",89,15255,19,4435,67,10787,3,33,21,7180,68,4060,24,11240,"California",38531,0.105369702317614,8153,0.366,13585,0.609
"319","amador",319,"2021-03-15",176,15431,25,4460,144,10931,7,40,53,7119,123,4183,62,11302,"California",38531,0.108561937141522,8153,0.366,13585,0.609
"320","amador",320,"2021-03-16",448,15879,54,4514,384,11315,10,50,138,6959,308,4491,148,11450,"California",38531,0.116555500765617,8153,0.366,13585,0.609
"321","amador",321,"2021-03-17",193,16072,43,4557,147,11462,3,53,116,7002,77,4568,120,11570,"California",38531,0.118553891671641,8153,0.366,13585,0.609
"322","amador",322,"2021-03-18",476,16548,98,4655,374,11836,4,57,249,7032,227,4795,257,11827,"California",38531,0.124445251875114,8153,0.366,13585,0.609
"323","amador",323,"2021-03-19",540,17088,56,4711,467,12303,17,74,391,7296,147,4942,411,12238,"California",38531,0.128260361786613,8153,0.366,13585,0.609
"324","amador",324,"2021-03-20",110,17198,45,4756,64,12367,1,75,46,7282,63,5005,49,12287,"California",38531,0.129895408891542,8153,0.366,13585,0.609
"325","amador",325,"2021-03-21",48,17246,36,4792,11,12378,1,76,31,7300,16,5021,34,12321,"California",38531,0.130310658949936,8153,0.366,13585,0.609
"326","amador",326,"2021-03-22",114,17360,32,4824,53,12431,29,105,50,7315,64,5085,79,12400,"California",38531,0.131971659183515,8153,0.366,13585,0.609
"327","amador",327,"2021-03-23",433,17793,47,4871,378,12809,8,113,276,7443,156,5241,284,12684,"California",38531,0.136020347252861,8153,0.366,13585,0.609
"328","amador",328,"2021-03-24",342,18135,35,4906,54,12863,253,366,34,7423,307,5548,287,12971,"California",38531,0.143987957748307,8153,0.366,13585,0.609
"329","amador",329,"2021-03-25",606,18741,84,4990,516,13379,6,372,394,7612,211,5759,400,13371,"California",38531,0.149464067893385,8153,0.366,13585,0.609
"330","amador",330,"2021-03-26",741,19482,45,5035,690,14069,6,378,282,7446,457,6216,291,13662,"California",38531,0.161324647686279,8153,0.366,13585,0.609
"331","amador",331,"2021-03-27",91,19573,15,5050,74,14143,2,380,27,7413,64,6280,31,13693,"California",38531,0.162985647919857,8153,0.366,13585,0.609
"332","amador",332,"2021-03-28",69,19642,15,5065,52,14195,2,382,13,7374,55,6335,16,13709,"California",38531,0.164413069995588,8153,0.366,13585,0.609
"333","amador",333,"2021-03-29",180,19822,26,5091,153,14348,1,383,80,7362,98,6433,86,13795,"California",38531,0.166956476603255,8153,0.366,13585,0.609
"334","amador",334,"2021-03-30",532,20354,28,5119,503,14851,1,384,294,7420,237,6670,295,14090,"California",38531,0.173107368093224,8153,0.366,13585,0.609
"335","amador",335,"2021-03-31",199,20553,57,5176,137,14988,5,389,43,7312,156,6826,48,14138,"California",38531,0.17715605616257,8153,0.366,13585,0.609
"336","amador",336,"2021-04-01",615,21168,88,5264,527,15515,0,389,264,7229,349,7175,266,14404,"California",38531,0.186213698061301,8153,0.366,13585,0.609
"337","amador",337,"2021-04-02",605,21773,37,5301,556,16071,12,401,383,7404,221,7396,396,14800,"California",38531,0.191949339492876,8153,0.366,13585,0.609
"338","amador",338,"2021-04-03",84,21857,20,5321,44,16115,20,421,21,7384,63,7459,43,14843,"California",38531,0.193584386597804,8153,0.366,13585,0.609
"339","amador",339,"2021-04-04",38,21895,3,5324,29,16144,6,427,15,7382,23,7482,21,14864,"California",38531,0.194181308556747,8153,0.366,13585,0.609
"340","amador",340,"2021-04-05",143,22038,52,5376,74,16218,17,444,48,7355,94,7576,67,14931,"California",38531,0.196620902649814,8153,0.366,13585,0.609
"341","amador",341,"2021-04-06",501,22539,37,5413,445,16663,19,463,221,7317,278,7854,240,15171,"California",38531,0.20383587241442,8153,0.366,13585,0.609
"342","amador",342,"2021-04-07",99,22638,34,5447,46,16709,19,482,43,7325,54,7908,62,15233,"California",38531,0.205237341361501,8153,0.366,13585,0.609
"343","amador",343,"2021-04-08",494,23132,84,5531,389,17098,21,503,221,7295,272,8180,242,15475,"California",38531,0.212296592354208,8153,0.366,13585,0.609
"344","amador",344,"2021-04-09",481,23613,21,5552,441,17539,19,522,212,7256,268,8448,229,15704,"California",38531,0.219252030832317,8153,0.366,13585,0.609
"345","amador",345,"2021-04-10",50,23663,14,5566,27,17566,9,531,22,7259,28,8476,31,15735,"California",38531,0.219978718434507,8153,0.366,13585,0.609
"346","amador",346,"2021-04-11",50,23713,25,5591,21,17587,4,535,23,7260,26,8502,27,15762,"California",38531,0.220653499779398,8153,0.366,13585,0.609
"347","amador",347,"2021-04-12",96,23809,24,5615,62,17649,10,545,40,7254,56,8558,50,15812,"California",38531,0.222106874983779,8153,0.366,13585,0.609
"348","amador",348,"2021-04-13",344,24153,50,5665,294,17943,0,545,68,7047,275,8833,68,15880,"California",38531,0.229243985362435,8153,0.366,13585,0.609
"349","amador",349,"2021-04-14",277,24430,26,5691,251,18194,0,545,176,7123,100,8933,176,16056,"California",38531,0.231839298227401,8153,0.366,13585,0.609
"350","amador",350,"2021-04-15",329,24759,72,5763,257,18451,0,545,73,6945,251,9184,73,16129,"California",38531,0.238353533518466,8153,0.366,13585,0.609
"351","amador",351,"2021-04-16",482,25241,29,5792,453,18904,0,545,384,7233,96,9280,384,16513,"California",38531,0.240845033868833,8153,0.366,13585,0.609
"352","amador",352,"2021-04-17",61,25302,35,5827,26,18930,0,545,27,7226,34,9314,27,16540,"California",38531,0.241727440242921,8153,0.366,13585,0.609
"353","amador",353,"2021-04-18",25,25327,5,5832,20,18950,0,545,11,7223,14,9328,11,16551,"California",38531,0.242090784044017,8153,0.366,13585,0.609
"354","amador",354,"2021-04-19",69,25396,27,5859,42,18992,0,545,31,7219,37,9365,33,16584,"California",38531,0.243051049804054,8153,0.366,13585,0.609
"355","amador",355,"2021-04-20",436,25832,54,5913,382,19374,0,545,111,7014,318,9683,113,16697,"California",38531,0.251304144714645,8153,0.366,13585,0.609
"356","amador",356,"2021-04-21",86,25918,34,5947,52,19426,0,545,44,7017,41,9724,44,16741,"California",38531,0.252368222989281,8153,0.366,13585,0.609
"357","amador",357,"2021-04-22",495,26413,76,6023,418,19844,1,546,104,6738,384,10108,105,16846,"California",38531,0.26233422439075,8153,0.366,13585,0.609
"358","amador",358,"2021-04-23",357,26770,45,6068,312,20156,0,546,286,6956,70,10178,288,17134,"California",38531,0.264150943396226,8153,0.366,13585,0.609
"359","amador",359,"2021-04-24",45,26815,23,6091,22,20178,0,546,25,6961,20,10198,25,17159,"California",38531,0.26467000596922,8153,0.366,13585,0.609
"360","amador",360,"2021-04-25",37,26852,19,6110,18,20196,0,546,25,6974,12,10210,25,17184,"California",38531,0.264981443513016,8153,0.366,13585,0.609
"361","amador",361,"2021-04-26",80,26932,25,6135,54,20250,1,547,39,6974,40,10250,40,17224,"California",38531,0.266019568659002,8153,0.366,13585,0.609
"362","amador",362,"2021-04-27",482,27414,36,6171,446,20696,0,547,81,6657,399,10649,82,17306,"California",38531,0.276374866990216,8153,0.366,13585,0.609
"363","amador",363,"2021-04-28",67,27481,29,6200,34,20730,4,551,39,6672,28,10677,43,17349,"California",38531,0.277101554592406,8153,0.366,13585,0.609
"364","amador",364,"2021-04-29",221,27702,69,6269,44,20774,108,659,64,6686,157,10834,171,17520,"California",38531,0.281176195790403,8153,0.366,13585,0.609
"365","amador",365,"2021-04-30",337,28039,26,6295,307,21081,4,663,96,6545,241,11075,100,17620,"California",38531,0.28743089979497,8153,0.366,13585,0.609
"366","amador",366,"2021-05-01",43,28082,17,6312,22,21103,4,667,23,6554,18,11093,27,17647,"California",38531,0.287898056110664,8153,0.366,13585,0.609
"367","amador",367,"2021-05-02",26,28108,14,6326,9,21112,3,670,9,6550,17,11110,13,17660,"California",38531,0.288339259297708,8153,0.366,13585,0.609
"368","amador",368,"2021-05-03",66,28174,32,6358,24,21136,10,680,27,6548,39,11149,37,17697,"California",38531,0.289351431315045,8153,0.366,13585,0.609
"369","amador",369,"2021-05-04",462,28636,23,6381,434,21570,5,685,68,6227,394,11543,73,17770,"California",38531,0.299576964003011,8153,0.366,13585,0.609
"370","amador",370,"2021-05-05",199,28835,154,6535,37,21607,8,693,162,6360,37,11580,170,17940,"California",38531,0.300537229763048,8153,0.366,13585,0.609
"371","amador",371,"2021-05-06",112,28947,54,6589,53,21660,5,698,67,6389,43,11623,72,18012,"California",38531,0.301653214294983,8153,0.366,13585,0.609
"372","amador",372,"2021-05-07",126,29073,29,6618,90,21750,7,705,67,6404,59,11682,74,18086,"California",38531,0.303184448885313,8153,0.366,13585,0.609
"373","amador",373,"2021-05-08",42,29115,8,6626,30,21780,4,709,19,6404,23,11705,23,18109,"California",38531,0.303781370844255,8153,0.366,13585,0.609
"374","butte",374,"2020-12-16",3,3,3,3,0,0,0,0,3,3,0,0,3,3,"California",217769,0,50426,0.494,48730,0.478
"375","butte",375,"2020-12-17",21,24,21,24,0,0,0,0,21,24,0,0,21,24,"California",217769,0,50426,0.494,48730,0.478
"376","butte",376,"2020-12-18",50,74,50,74,0,0,0,0,50,74,0,0,50,74,"California",217769,0,50426,0.494,48730,0.478
"377","butte",377,"2020-12-19",7,81,7,81,0,0,0,0,7,81,0,0,7,81,"California",217769,0,50426,0.494,48730,0.478
"378","butte",378,"2020-12-20",10,91,10,91,0,0,0,0,10,91,0,0,10,91,"California",217769,0,50426,0.494,48730,0.478
"379","butte",379,"2020-12-21",634,725,634,725,0,0,0,0,634,725,0,0,634,725,"California",217769,0,50426,0.494,48730,0.478
"380","butte",380,"2020-12-22",618,1343,616,1341,2,2,0,0,618,1343,0,0,618,1343,"California",217769,0,50426,0.494,48730,0.478
"381","butte",381,"2020-12-23",869,2212,853,2194,16,18,0,0,869,2212,0,0,869,2212,"California",217769,0,50426,0.494,48730,0.478
"382","butte",382,"2020-12-24",159,2371,155,2349,4,22,0,0,159,2371,0,0,159,2371,"California",217769,0,50426,0.494,48730,0.478
"383","butte",383,"2020-12-26",93,2464,91,2440,2,24,0,0,93,2464,0,0,93,2464,"California",217769,0,50426,0.494,48730,0.478
"384","butte",384,"2020-12-27",35,2499,34,2474,1,25,0,0,35,2499,0,0,35,2499,"California",217769,0,50426,0.494,48730,0.478
"385","butte",385,"2020-12-28",279,2778,273,2747,6,31,0,0,279,2778,0,0,279,2778,"California",217769,0,50426,0.494,48730,0.478
"386","butte",386,"2020-12-29",203,2981,179,2926,24,55,0,0,203,2981,0,0,203,2981,"California",217769,0,50426,0.494,48730,0.478
"387","butte",387,"2020-12-30",513,3494,291,3217,222,277,0,0,513,3494,0,0,513,3494,"California",217769,0,50426,0.494,48730,0.478
"388","butte",388,"2020-12-31",211,3705,18,3235,193,470,0,0,211,3705,0,0,211,3705,"California",217769,0,50426,0.494,48730,0.478
"389","butte",389,"2021-01-01",8,3713,1,3236,7,477,0,0,8,3713,0,0,8,3713,"California",217769,0,50426,0.494,48730,0.478
"390","butte",390,"2021-01-02",41,3754,38,3274,3,480,0,0,41,3754,0,0,41,3754,"California",217769,0,50426,0.494,48730,0.478
"391","butte",391,"2021-01-03",4,3758,1,3275,3,483,0,0,4,3758,0,0,4,3758,"California",217769,0,50426,0.494,48730,0.478
"392","butte",392,"2021-01-04",208,3966,175,3450,33,516,0,0,208,3966,0,0,208,3966,"California",217769,0,50426,0.494,48730,0.478
"393","butte",393,"2021-01-05",196,4162,151,3601,45,561,0,0,195,4160,1,1,195,4161,"California",217769,4.59202182128769e-06,50426,0.494,48730,0.478
"394","butte",394,"2021-01-06",623,4785,397,3998,226,787,0,0,618,4774,5,6,619,4780,"California",217769,2.75521309277262e-05,50426,0.494,48730,0.478
"395","butte",395,"2021-01-07",761,5546,369,4367,392,1179,0,0,741,5495,20,26,741,5521,"California",217769,0.00011939256735348,50426,0.494,48730,0.478
"396","butte",396,"2021-01-08",668,6214,529,4896,139,1318,0,0,622,6071,46,72,622,6143,"California",217769,0.000330625571132714,50426,0.494,48730,0.478
"397","butte",397,"2021-01-09",12,6226,7,4903,5,1323,0,0,7,6073,5,77,7,6150,"California",217769,0.000353585680239153,50426,0.494,48730,0.478
"398","butte",398,"2021-01-10",19,6245,5,4908,14,1337,0,0,14,6082,5,82,14,6164,"California",217769,0.000376545789345591,50426,0.494,48730,0.478
"399","butte",399,"2021-01-11",985,7230,949,5857,36,1373,0,0,357,5814,628,710,360,6524,"California",217769,0.00326033549311426,50426,0.494,48730,0.478
"400","butte",400,"2021-01-12",698,7928,653,6510,45,1418,0,0,274,5664,424,1134,274,6798,"California",217769,0.00520735274534025,50426,0.494,48730,0.478
"401","butte",401,"2021-01-13",1449,9377,955,7465,494,1912,0,0,615,5447,834,1968,617,7415,"California",217769,0.00903709894429418,50426,0.494,48730,0.478
"402","butte",402,"2021-01-14",1635,11012,894,8359,741,2653,0,0,1439,6691,195,2163,1439,8854,"California",217769,0.00993254319944528,50426,0.494,48730,0.478
"403","butte",403,"2021-01-15",1167,12179,925,9284,242,2895,0,0,1058,7639,110,2273,1058,9912,"California",217769,0.0104376655997869,50426,0.494,48730,0.478
"404","butte",404,"2021-01-16",586,12765,300,9584,286,3181,0,0,541,8135,45,2318,541,10453,"California",217769,0.0106443065817449,50426,0.494,48730,0.478
"405","butte",405,"2021-01-17",239,13004,64,9648,175,3356,0,0,202,8300,37,2355,202,10655,"California",217769,0.0108142113891325,50426,0.494,48730,0.478
"406","butte",406,"2021-01-18",344,13348,302,9950,42,3398,0,0,276,8509,67,2422,276,10931,"California",217769,0.0111218768511588,50426,0.494,48730,0.478
"407","butte",407,"2021-01-19",498,13846,433,10383,65,3463,0,0,225,8461,273,2695,225,11156,"California",217769,0.0123754988083703,50426,0.494,48730,0.478
"408","butte",408,"2021-01-20",1369,15215,688,11071,681,4144,0,0,1066,9224,303,2998,1066,12222,"California",217769,0.0137668814202205,50426,0.494,48730,0.478
"409","butte",409,"2021-01-21",1474,16689,866,11937,608,4752,0,0,1366,10483,107,3105,1366,13588,"California",217769,0.0142582277550983,50426,0.494,48730,0.478
"410","butte",410,"2021-01-22",1135,17824,476,12413,659,5411,0,0,1082,11512,53,3158,1082,14670,"California",217769,0.0145016049116265,50426,0.494,48730,0.478
"411","butte",411,"2021-01-23",129,17953,87,12500,42,5453,0,0,103,11589,26,3184,103,14773,"California",217769,0.01462099747898,50426,0.494,48730,0.478
"412","butte",412,"2021-01-24",9,17962,7,12507,2,5455,0,0,9,11598,0,3184,9,14782,"California",217769,0.01462099747898,50426,0.494,48730,0.478
"413","butte",413,"2021-01-25",655,18617,335,12842,320,5775,0,0,492,11927,163,3347,492,15274,"California",217769,0.0153694970358499,50426,0.494,48730,0.478
"414","butte",414,"2021-01-26",1468,20085,377,13219,1091,6866,0,0,1331,13121,137,3484,1331,16605,"California",217769,0.0159986040253663,50426,0.494,48730,0.478
"415","butte",415,"2021-01-27",2091,22176,705,13924,1386,8252,0,0,1362,13755,728,4212,1362,17967,"California",217769,0.0193415959112638,50426,0.494,48730,0.478
"416","butte",416,"2021-01-28",2260,24436,260,14184,2000,10252,0,0,1950,15396,309,4521,1950,19917,"California",217769,0.0207605306540417,50426,0.494,48730,0.478
"417","butte",417,"2021-01-29",1686,26122,487,14671,1199,11451,0,0,1307,16325,378,4899,1307,21224,"California",217769,0.0224963149024884,50426,0.494,48730,0.478
"418","butte",418,"2021-01-30",32,26154,9,14680,23,11474,0,0,29,16351,3,4902,29,21253,"California",217769,0.0225100909679523,50426,0.494,48730,0.478
"419","butte",419,"2021-01-31",16,26170,14,14694,2,11476,0,0,15,16365,1,4903,15,21268,"California",217769,0.0225146829897736,50426,0.494,48730,0.478
"420","butte",420,"2021-02-01",1749,27919,406,15100,1343,12819,0,0,1361,17340,386,5289,1361,22629,"California",217769,0.0242872034127906,50426,0.494,48730,0.478
"421","butte",421,"2021-02-02",1931,29850,363,15463,1568,14387,0,0,1628,18664,304,5593,1628,24257,"California",217769,0.0256831780464621,50426,0.494,48730,0.478
"422","butte",422,"2021-02-03",2732,32582,771,16234,1961,16348,0,0,1842,19618,888,6481,1842,26099,"California",217769,0.0297608934237656,50426,0.494,48730,0.478
"423","butte",423,"2021-02-04",2958,35540,327,16561,2631,18979,0,0,2402,21466,554,7035,2402,28501,"California",217769,0.0323048735127589,50426,0.494,48730,0.478
"424","butte",424,"2021-02-05",1264,36804,662,17223,602,19581,0,0,548,21299,716,7751,549,29050,"California",217769,0.0355927611368009,50426,0.494,48730,0.478
"425","butte",425,"2021-02-06",144,36948,103,17326,41,19622,0,0,62,21279,82,7833,62,29112,"California",217769,0.0359693069261465,50426,0.494,48730,0.478
"426","butte",426,"2021-02-07",37,36985,33,17359,4,19626,0,0,13,21268,24,7857,13,29125,"California",217769,0.0360795154498574,50426,0.494,48730,0.478
"427","butte",427,"2021-02-08",691,37676,542,17901,149,19775,0,0,238,21053,453,8310,238,29363,"California",217769,0.0381597013349007,50426,0.494,48730,0.478
"428","butte",428,"2021-02-09",953,38629,459,18360,494,20269,0,0,723,21546,230,8540,723,30086,"California",217769,0.0392158663537969,50426,0.494,48730,0.478
"429","butte",429,"2021-02-10",1706,40335,1190,19550,516,20785,0,0,675,21192,1029,9569,675,30761,"California",217769,0.043941056807902,50426,0.494,48730,0.478
"430","butte",430,"2021-02-11",2202,42537,1349,20899,853,21638,0,0,1006,21002,1196,10765,1006,31767,"California",217769,0.049433114906162,50426,0.494,48730,0.478
"431","butte",431,"2021-02-12",1001,43538,433,21332,568,22206,0,0,330,20662,670,11435,330,32097,"California",217769,0.0525097695264248,50426,0.494,48730,0.478
"432","butte",432,"2021-02-13",252,43790,44,21376,208,22414,0,0,150,20710,102,11537,150,32247,"California",217769,0.0529781557521961,50426,0.494,48730,0.478
"433","butte",433,"2021-02-14",161,43951,9,21385,152,22566,0,0,156,20861,5,11542,156,32403,"California",217769,0.0530011158613026,50426,0.494,48730,0.478
"434","butte",434,"2021-02-15",263,44214,47,21432,216,22782,0,0,198,20994,65,11607,198,32601,"California",217769,0.0532995972796863,50426,0.494,48730,0.478
"435","butte",435,"2021-02-16",734,44948,433,21865,301,23083,0,0,275,20809,460,12067,275,32876,"California",217769,0.0554119273174786,50426,0.494,48730,0.478
"436","butte",436,"2021-02-17",1515,46463,848,22713,667,23750,0,0,842,20980,671,12738,842,33718,"California",217769,0.0584931739595627,50426,0.494,48730,0.478
"437","butte",437,"2021-02-18",1554,48017,760,23473,794,24544,0,0,747,20920,807,13545,747,34465,"California",217769,0.0621989355693418,50426,0.494,48730,0.478
"438","butte",438,"2021-02-19",1166,49183,387,23860,779,25323,0,0,401,20563,758,14303,401,34866,"California",217769,0.0656796881098779,50426,0.494,48730,0.478
"439","butte",439,"2021-02-20",475,49658,29,23889,446,25769,0,0,122,20333,352,14655,122,34988,"California",217769,0.0672960797909712,50426,0.494,48730,0.478
"440","butte",440,"2021-02-21",16,49674,14,23903,2,25771,0,0,11,20339,5,14660,11,34999,"California",217769,0.0673190399000776,50426,0.494,48730,0.478
"441","butte",441,"2021-02-22",1498,51172,296,24199,1202,26973,0,0,380,19604,1115,15775,380,35379,"California",217769,0.0724391442308134,50426,0.494,48730,0.478
"442","butte",442,"2021-02-23",1634,52806,297,24496,1337,28310,0,0,463,18901,1166,16941,463,35842,"California",217769,0.0777934416744348,50426,0.494,48730,0.478
"443","butte",443,"2021-02-24",2135,54941,596,25092,1539,29849,0,0,728,18230,1399,18340,728,36570,"California",217769,0.0842176802024163,50426,0.494,48730,0.478
"444","butte",444,"2021-02-25",2077,57018,579,25671,1498,31347,0,0,655,17469,1417,19757,656,37226,"California",217769,0.090724575123181,50426,0.494,48730,0.478
"445","butte",445,"2021-02-26",921,57939,311,25982,610,31957,0,0,398,17347,520,20277,398,37624,"California",217769,0.0931124264702506,50426,0.494,48730,0.478
"446","butte",446,"2021-02-27",235,58174,48,26030,187,32144,0,0,186,17486,47,20324,186,37810,"California",217769,0.0933282514958511,50426,0.494,48730,0.478
"447","butte",447,"2021-02-28",140,58314,16,26046,124,32268,0,0,132,17610,8,20332,132,37942,"California",217769,0.0933649876704214,50426,0.494,48730,0.478
"448","butte",448,"2021-03-01",1629,59943,178,26224,1450,33718,1,1,329,16643,1297,21629,330,38272,"California",217769,0.0993208399726316,50426,0.494,48730,0.478
"449","butte",449,"2021-03-02",1742,61685,196,26420,1546,35264,0,1,309,15523,1429,23058,309,38581,"California",217769,0.105882839155252,50426,0.494,48730,0.478
"450","butte",450,"2021-03-03",2783,64468,848,27268,1935,37199,0,1,482,13705,2300,25358,482,39063,"California",217769,0.116444489344213,50426,0.494,48730,0.478
"451","butte",451,"2021-03-04",3141,67609,678,27946,2463,39662,0,1,622,11809,2518,27876,622,39685,"California",217769,0.128007200290216,50426,0.494,48730,0.478
"452","butte",452,"2021-03-05",1349,68958,617,28563,731,40393,1,2,736,11936,610,28486,737,40422,"California",217769,0.130808333601201,50426,0.494,48730,0.478
"453","butte",453,"2021-03-06",247,69205,27,28590,197,40590,23,25,186,12085,60,28546,209,40631,"California",217769,0.131083854910479,50426,0.494,48730,0.478
"454","butte",454,"2021-03-07",55,69260,3,28593,35,40625,17,42,30,12107,25,28571,47,40678,"California",217769,0.131198655456011,50426,0.494,48730,0.478
"455","butte",455,"2021-03-08",1265,70525,129,28722,1059,41684,77,119,1100,13122,162,28733,1177,41855,"California",217769,0.131942562991059,50426,0.494,48730,0.478
"456","butte",456,"2021-03-09",1900,72425,279,29001,1518,43202,103,222,1413,14153,485,29218,1516,43371,"California",217769,0.134169693574384,50426,0.494,48730,0.478
"457","butte",457,"2021-03-10",2321,74746,965,29966,1255,44457,101,323,1579,15095,737,29955,1679,45050,"California",217769,0.137554013656673,50426,0.494,48730,0.478
"458","butte",458,"2021-03-11",2808,77554,1315,31281,1367,45824,126,449,1982,16388,815,30770,2108,47158,"California",217769,0.141296511441022,50426,0.494,48730,0.478
"459","butte",459,"2021-03-12",1144,78698,329,31610,466,46290,349,798,355,16309,783,31553,704,47862,"California",217769,0.144892064527091,50426,0.494,48730,0.478
"460","butte",460,"2021-03-13",253,78951,67,31677,137,46427,49,847,64,16232,189,31742,112,47974,"California",217769,0.145759956651314,50426,0.494,48730,0.478
"461","butte",461,"2021-03-14",161,79112,15,31692,104,46531,42,889,21,16156,139,31881,63,48037,"California",217769,0.146398247684473,50426,0.494,48730,0.478
"462","butte",462,"2021-03-15",1719,80831,360,32052,1066,47597,293,1182,1125,16986,588,32469,1418,49455,"California",217769,0.14909835651539,50426,0.494,48730,0.478
"463","butte",463,"2021-03-16",1630,82461,417,32469,1135,48732,78,1260,1090,17616,537,33006,1167,50622,"California",217769,0.151564272233422,50426,0.494,48730,0.478
"464","butte",464,"2021-03-17",1952,84413,1358,33827,513,49245,81,1341,1134,18020,810,33816,1214,51836,"California",217769,0.155283809908665,50426,0.494,48730,0.478
"465","butte",465,"2021-03-18",1805,86218,1462,35289,214,49459,129,1470,1062,18473,737,34553,1190,53026,"California",217769,0.158668129990954,50426,0.494,48730,0.478
"466","butte",466,"2021-03-19",699,86917,313,35602,302,49761,84,1554,346,18559,344,34897,430,53456,"California",217769,0.160247785497477,50426,0.494,48730,0.478
"467","butte",467,"2021-03-20",205,87122,32,35634,157,49918,16,1570,93,18556,112,35009,109,53565,"California",217769,0.160762091941461,50426,0.494,48730,0.478
"468","butte",468,"2021-03-21",58,87180,27,35661,2,49920,29,1599,15,18557,43,35052,44,53609,"California",217769,0.160959548879776,50426,0.494,48730,0.478
"469","butte",469,"2021-03-22",1461,88641,353,36014,1014,50934,94,1693,1196,19584,263,35315,1290,54899,"California",217769,0.162167250618775,50426,0.494,48730,0.478
"470","butte",470,"2021-03-23",1805,90446,493,36507,1198,52132,114,1807,1455,20806,347,35662,1569,56468,"California",217769,0.163760682190762,50426,0.494,48730,0.478
"471","butte",471,"2021-03-24",2247,92693,1266,37773,855,52987,126,1933,1701,22090,542,36204,1826,58294,"California",217769,0.1662495580179,50426,0.494,48730,0.478
"472","butte",472,"2021-03-25",1489,94182,1205,38978,192,53179,92,2025,1024,22745,461,36665,1116,59410,"California",217769,0.168366480077513,50426,0.494,48730,0.478
"473","butte",473,"2021-03-26",1212,95394,442,39420,524,53703,246,2271,567,22921,637,37302,813,60223,"California",217769,0.171291597977674,50426,0.494,48730,0.478
"474","butte",474,"2021-03-27",299,95693,83,39503,192,53895,24,2295,132,22911,164,37466,154,60377,"California",217769,0.172044689556365,50426,0.494,48730,0.478
"475","butte",475,"2021-03-28",226,95919,43,39546,175,54070,8,2303,101,22897,122,37588,108,60485,"California",217769,0.172604916218562,50426,0.494,48730,0.478
"476","butte",476,"2021-03-29",1721,97640,381,39927,1270,55340,70,2373,1306,23863,410,37998,1376,61861,"California",217769,0.17448764516529,50426,0.494,48730,0.478
"477","butte",477,"2021-03-30",1041,98681,471,40398,480,55820,90,2463,498,23914,537,38535,588,62449,"California",217769,0.176953560883321,50426,0.494,48730,0.478
"478","butte",478,"2021-03-31",1778,100459,1304,41702,407,56227,67,2530,1089,24387,683,39218,1156,63605,"California",217769,0.180089911787261,50426,0.494,48730,0.478
"479","butte",479,"2021-04-01",3279,103738,2663,44365,489,56716,127,2657,2211,25663,1063,40281,2339,65944,"California",217769,0.18497123098329,50426,0.494,48730,0.478
"480","butte",480,"2021-04-02",997,104735,417,44782,460,57176,120,2777,558,25908,431,40712,676,66620,"California",217769,0.186950392388265,50426,0.494,48730,0.478
"481","butte",481,"2021-04-03",346,105081,47,44829,224,57400,75,2852,167,25971,179,40891,242,66862,"California",217769,0.187772364294275,50426,0.494,48730,0.478
"482","butte",482,"2021-04-04",184,105265,23,44852,138,57538,23,2875,106,26024,76,40967,129,66991,"California",217769,0.188121357952693,50426,0.494,48730,0.478
"483","butte",483,"2021-04-05",1958,107223,422,45274,1366,58904,170,3045,597,25438,1352,42319,766,67757,"California",217769,0.194329771455074,50426,0.494,48730,0.478
"484","butte",484,"2021-04-06",2188,109411,617,45891,1151,60055,420,3465,790,25254,1392,43711,1208,68965,"California",217769,0.200721865830306,50426,0.494,48730,0.478
"485","butte",485,"2021-04-07",3006,112417,1312,47203,1302,61357,392,3857,696,24038,2304,46015,1088,70053,"California",217769,0.211301884106553,50426,0.494,48730,0.478
"486","butte",486,"2021-04-08",2723,115140,1189,48392,1269,62626,265,4122,441,22464,2280,48295,706,70759,"California",217769,0.221771693859089,50426,0.494,48730,0.478
"487","butte",487,"2021-04-09",1367,116507,349,48741,538,63164,480,4602,328,22233,1036,49331,805,71564,"California",217769,0.226529028465943,50426,0.494,48730,0.478
"488","butte",488,"2021-04-10",219,116726,48,48789,74,63238,97,4699,96,22303,122,49453,192,71756,"California",217769,0.22708925512814,50426,0.494,48730,0.478
"489","butte",489,"2021-04-11",105,116831,44,48833,51,63289,10,4709,81,22372,22,49475,91,71847,"California",217769,0.227190279608209,50426,0.494,48730,0.478
"490","butte",490,"2021-04-12",1408,118239,316,49149,959,64248,133,4842,254,21605,1154,50629,387,72234,"California",217769,0.232489472789975,50426,0.494,48730,0.478
"491","butte",491,"2021-04-13",1636,119875,570,49719,1060,65308,6,4848,347,20677,1282,51911,354,72588,"California",217769,0.238376444764866,50426,0.494,48730,0.478
"492","butte",492,"2021-04-14",2829,122704,2339,52058,490,65798,0,4848,1313,20480,1511,53422,1314,73902,"California",217769,0.245314989736831,50426,0.494,48730,0.478
"493","butte",493,"2021-04-15",636,123340,392,52450,244,66042,0,4848,480,20807,153,53575,480,74382,"California",217769,0.246017569075488,50426,0.494,48730,0.478
"494","butte",494,"2021-04-16",809,124149,416,52866,393,66435,0,4848,474,20949,332,53907,474,74856,"California",217769,0.247542120320156,50426,0.494,48730,0.478
"495","butte",495,"2021-04-17",340,124489,61,52927,279,66714,0,4848,238,21087,100,54007,238,75094,"California",217769,0.248001322502285,50426,0.494,48730,0.478
"496","butte",496,"2021-04-18",39,124528,9,52936,30,66744,0,4848,35,21118,4,54011,35,75129,"California",217769,0.24801969058957,50426,0.494,48730,0.478
"497","butte",497,"2021-04-19",1558,126086,380,53316,1178,67922,0,4848,447,20458,1107,55118,447,75576,"California",217769,0.253103058745735,50426,0.494,48730,0.478
"498","butte",498,"2021-04-20",1969,128055,717,54033,1252,69174,0,4848,777,20049,1186,56304,777,76353,"California",217769,0.258549196625782,50426,0.494,48730,0.478
"499","butte",499,"2021-04-21",2049,130104,1165,55198,884,70058,0,4848,480,18966,1563,57867,480,76833,"California",217769,0.265726526732455,50426,0.494,48730,0.478
"500","butte",500,"2021-04-22",2190,132294,1912,57110,278,70336,0,4848,613,18006,1573,59440,613,77446,"California",217769,0.272949777057341,50426,0.494,48730,0.478
"501","butte",501,"2021-04-23",947,133241,447,57557,500,70836,0,4848,491,18042,455,59895,491,77937,"California",217769,0.275039146986026,50426,0.494,48730,0.478
"502","butte",502,"2021-04-24",345,133586,138,57695,207,71043,0,4848,191,18079,154,60049,191,78128,"California",217769,0.275746318346505,50426,0.494,48730,0.478
"503","butte",503,"2021-04-25",171,133757,67,57762,104,71147,0,4848,63,18034,108,60157,63,78191,"California",217769,0.276242256703204,50426,0.494,48730,0.478
"504","butte",504,"2021-04-26",1468,135225,408,58170,1055,72202,5,4853,410,17394,1055,61212,415,78606,"California",217769,0.281086839724662,50426,0.494,48730,0.478
"505","butte",505,"2021-04-27",904,136129,613,58783,263,72465,28,4881,546,17614,354,61566,574,79180,"California",217769,0.282712415449398,50426,0.494,48730,0.478
"506","butte",506,"2021-04-28",1391,137520,935,59718,432,72897,24,4905,498,17248,888,62454,522,79702,"California",217769,0.286790130826702,50426,0.494,48730,0.478
"507","butte",507,"2021-04-29",876,138396,540,60258,311,73208,25,4930,296,16993,576,63030,321,80023,"California",217769,0.289435135395763,50426,0.494,48730,0.478
"508","butte",508,"2021-04-30",892,139288,387,60645,484,73692,21,4951,452,17029,436,63466,472,80495,"California",217769,0.291437256909845,50426,0.494,48730,0.478
"509","butte",509,"2021-05-01",239,139527,64,60709,156,73848,19,4970,72,16954,166,63632,91,80586,"California",217769,0.292199532532179,50426,0.494,48730,0.478
"510","butte",510,"2021-05-02",146,139673,60,60769,73,73921,13,4983,42,16905,104,63736,55,80641,"California",217769,0.292677102801593,50426,0.494,48730,0.478
"511","butte",511,"2021-05-03",607,140280,248,61017,326,74247,33,5016,152,16645,445,64181,185,80826,"California",217769,0.294720552512066,50426,0.494,48730,0.478
"512","butte",512,"2021-05-04",809,141089,308,61325,467,74714,34,5050,205,16285,598,64779,238,81064,"California",217769,0.297466581561196,50426,0.494,48730,0.478
"513","butte",513,"2021-05-05",1333,142422,1090,62415,206,74920,37,5087,272,15537,1057,65836,309,81373,"California",217769,0.302320348626297,50426,0.494,48730,0.478
"514","butte",514,"2021-05-06",910,143332,649,63064,218,75138,43,5130,346,15366,560,66396,389,81762,"California",217769,0.304891880846218,50426,0.494,48730,0.478
"515","butte",515,"2021-05-07",571,143903,298,63362,235,75373,38,5168,290,15416,278,66674,328,82090,"California",217769,0.306168462912536,50426,0.494,48730,0.478
"516","butte",516,"2021-05-08",169,144072,34,63396,123,75496,12,5180,87,15434,81,66755,99,82189,"California",217769,0.30654041668006,50426,0.494,48730,0.478
"517","calaveras",517,"2020-12-16",5,5,5,5,0,0,0,0,5,5,0,0,5,5,"California",44289,0,10046,0.37,16518,0.608
"518","calaveras",518,"2020-12-17",3,8,3,8,0,0,0,0,3,8,0,0,3,8,"California",44289,0,10046,0.37,16518,0.608
"519","calaveras",519,"2020-12-18",38,46,38,46,0,0,0,0,38,46,0,0,38,46,"California",44289,0,10046,0.37,16518,0.608
"520","calaveras",520,"2020-12-19",3,49,3,49,0,0,0,0,3,49,0,0,3,49,"California",44289,0,10046,0.37,16518,0.608
"521","calaveras",521,"2020-12-20",3,52,3,52,0,0,0,0,3,52,0,0,3,52,"California",44289,0,10046,0.37,16518,0.608
"522","calaveras",522,"2020-12-21",55,107,48,100,7,7,0,0,55,107,0,0,55,107,"California",44289,0,10046,0.37,16518,0.608
"523","calaveras",523,"2020-12-22",82,189,78,178,4,11,0,0,83,190,0,0,83,190,"California",44289,0,10046,0.37,16518,0.608
"524","calaveras",524,"2020-12-23",76,265,74,252,2,13,0,0,76,266,0,0,76,266,"California",44289,0,10046,0.37,16518,0.608
"525","calaveras",525,"2020-12-24",2,267,2,254,0,13,0,0,2,268,0,0,2,268,"California",44289,0,10046,0.37,16518,0.608
"526","calaveras",526,"2020-12-26",3,270,3,257,0,13,0,0,3,271,0,0,3,271,"California",44289,0,10046,0.37,16518,0.608
"527","calaveras",527,"2020-12-28",22,292,18,275,4,17,0,0,21,291,1,1,21,292,"California",44289,2.2578969947391e-05,10046,0.37,16518,0.608
"528","calaveras",528,"2020-12-29",167,459,147,422,20,37,0,0,167,458,0,1,167,459,"California",44289,2.2578969947391e-05,10046,0.37,16518,0.608
"529","calaveras",529,"2020-12-30",93,552,81,503,12,49,0,0,93,551,0,1,93,552,"California",44289,2.2578969947391e-05,10046,0.37,16518,0.608
"530","calaveras",530,"2020-12-31",35,587,25,528,10,59,0,0,35,586,0,1,35,587,"California",44289,2.2578969947391e-05,10046,0.37,16518,0.608
"531","calaveras",531,"2021-01-02",11,598,11,539,0,59,0,0,11,597,0,1,11,598,"California",44289,2.2578969947391e-05,10046,0.37,16518,0.608
"532","calaveras",532,"2021-01-03",10,608,4,543,6,65,0,0,10,607,0,1,10,608,"California",44289,2.2578969947391e-05,10046,0.37,16518,0.608
"533","calaveras",533,"2021-01-04",33,641,5,548,28,93,0,0,33,640,0,1,33,641,"California",44289,2.2578969947391e-05,10046,0.37,16518,0.608
"534","calaveras",534,"2021-01-05",40,681,9,557,31,124,0,0,32,669,8,9,37,678,"California",44289,0.000203210729526519,10046,0.37,16518,0.608
"535","calaveras",535,"2021-01-06",107,788,30,587,77,201,0,0,97,756,10,19,97,775,"California",44289,0.000429000429000429,10046,0.37,16518,0.608
"536","calaveras",536,"2021-01-07",105,893,26,613,79,280,0,0,92,838,11,30,93,868,"California",44289,0.00067736909842173,10046,0.37,16518,0.608
"537","calaveras",537,"2021-01-08",68,961,38,651,30,310,0,0,45,861,23,53,46,914,"California",44289,0.00119668540721172,10046,0.37,16518,0.608
"538","calaveras",538,"2021-01-09",5,966,5,656,0,310,0,0,2,860,3,56,2,916,"California",44289,0.0012644223170539,10046,0.37,16518,0.608
"539","calaveras",539,"2021-01-10",2,968,0,656,2,312,0,0,2,862,0,56,2,918,"California",44289,0.0012644223170539,10046,0.37,16518,0.608
"540","calaveras",540,"2021-01-11",65,1033,59,715,6,318,0,0,27,854,37,93,29,947,"California",44289,0.00209984420510736,10046,0.37,16518,0.608
"541","calaveras",541,"2021-01-12",85,1118,52,767,33,351,0,0,52,874,33,126,53,1000,"California",44289,0.00284495021337127,10046,0.37,16518,0.608
"542","calaveras",542,"2021-01-13",109,1227,44,811,65,416,0,0,75,916,34,160,76,1076,"California",44289,0.00361263519158256,10046,0.37,16518,0.608
"543","calaveras",543,"2021-01-14",138,1365,41,852,97,513,0,0,105,990,32,192,106,1182,"California",44289,0.00433516222989907,10046,0.37,16518,0.608
"544","calaveras",544,"2021-01-15",91,1456,29,881,62,575,0,0,71,1041,20,212,71,1253,"California",44289,0.00478674162884689,10046,0.37,16518,0.608
"545","calaveras",545,"2021-01-16",13,1469,2,883,11,586,0,0,12,1052,1,213,12,1265,"California",44289,0.00480932059879428,10046,0.37,16518,0.608
"546","calaveras",546,"2021-01-17",9,1478,1,884,8,594,0,0,9,1061,0,213,9,1274,"California",44289,0.00480932059879428,10046,0.37,16518,0.608
"547","calaveras",547,"2021-01-18",132,1610,19,903,113,707,0,0,119,1170,13,226,122,1396,"California",44289,0.00510284720811037,10046,0.37,16518,0.608
"548","calaveras",548,"2021-01-19",203,1813,173,1076,30,737,0,0,62,1093,140,366,63,1459,"California",44289,0.00826390300074511,10046,0.37,16518,0.608
"549","calaveras",549,"2021-01-20",376,2189,82,1158,294,1031,0,0,290,1308,85,451,300,1759,"California",44289,0.0101831154462733,10046,0.37,16518,0.608
"550","calaveras",550,"2021-01-21",462,2651,40,1198,422,1453,0,0,433,1719,29,480,440,2199,"California",44289,0.0108379055747477,10046,0.37,16518,0.608
"551","calaveras",551,"2021-01-22",401,3052,23,1221,378,1831,0,0,390,2106,11,491,398,2597,"California",44289,0.011086274244169,10046,0.37,16518,0.608
"552","calaveras",552,"2021-01-23",22,3074,10,1231,12,1843,0,0,18,2120,4,495,18,2615,"California",44289,0.0111765901239585,10046,0.37,16518,0.608
"553","calaveras",553,"2021-01-24",13,3087,8,1239,5,1848,0,0,11,2129,2,497,11,2626,"California",44289,0.0112217480638533,10046,0.37,16518,0.608
"554","calaveras",554,"2021-01-25",85,3172,8,1247,77,1925,0,0,80,2204,5,502,80,2706,"California",44289,0.0113346429135903,10046,0.37,16518,0.608
"555","calaveras",555,"2021-01-26",47,3219,15,1262,32,1957,0,0,39,2235,8,510,39,2745,"California",44289,0.0115152746731694,10046,0.37,16518,0.608
"556","calaveras",556,"2021-01-27",133,3352,43,1305,90,2047,0,0,105,2313,27,537,105,2850,"California",44289,0.012124906861749,10046,0.37,16518,0.608
"557","calaveras",557,"2021-01-28",164,3516,24,1329,140,2187,0,0,141,2434,23,560,144,2994,"California",44289,0.012644223170539,10046,0.37,16518,0.608
"558","calaveras",558,"2021-01-29",387,3903,11,1340,376,2563,0,0,362,2780,25,585,371,3365,"California",44289,0.0132086974192237,10046,0.37,16518,0.608
"559","calaveras",559,"2021-01-30",27,3930,10,1350,17,2580,0,0,25,2805,0,585,25,3390,"California",44289,0.0132086974192237,10046,0.37,16518,0.608
"560","calaveras",560,"2021-01-31",6,3936,4,1354,2,2582,0,0,5,2809,1,586,5,3395,"California",44289,0.0132312763891711,10046,0.37,16518,0.608
"561","calaveras",561,"2021-02-01",24,3960,11,1365,13,2595,0,0,17,2819,7,593,17,3412,"California",44289,0.0133893291788029,10046,0.37,16518,0.608
"562","calaveras",562,"2021-02-02",109,4069,22,1387,87,2682,0,0,71,2857,34,627,72,3484,"California",44289,0.0141570141570142,10046,0.37,16518,0.608
"563","calaveras",563,"2021-02-03",429,4498,42,1429,387,3069,0,0,346,3122,82,709,347,3831,"California",44289,0.0160084896927002,10046,0.37,16518,0.608
"564","calaveras",564,"2021-02-04",381,4879,25,1454,356,3425,0,0,297,3337,84,793,299,4130,"California",44289,0.0179051231682811,10046,0.37,16518,0.608
"565","calaveras",565,"2021-02-05",78,4957,22,1476,56,3481,0,0,40,3340,38,831,41,4171,"California",44289,0.0187631240262819,10046,0.37,16518,0.608
"566","calaveras",566,"2021-02-06",21,4978,12,1488,9,3490,0,0,21,3361,0,831,21,4192,"California",44289,0.0187631240262819,10046,0.37,16518,0.608
"567","calaveras",567,"2021-02-07",4,4982,1,1489,3,3493,0,0,2,3361,2,833,2,4194,"California",44289,0.0188082819661767,10046,0.37,16518,0.608
"568","calaveras",568,"2021-02-08",38,5020,17,1506,21,3514,0,0,30,3385,6,839,30,4224,"California",44289,0.018943755785861,10046,0.37,16518,0.608
"569","calaveras",569,"2021-02-09",193,5213,77,1583,116,3630,0,0,131,3461,56,895,132,4356,"California",44289,0.0202081781029149,10046,0.37,16518,0.608
"570","calaveras",570,"2021-02-10",513,5726,31,1614,482,4112,0,0,442,3836,71,966,446,4802,"California",44289,0.0218112849691797,10046,0.37,16518,0.608
"571","calaveras",571,"2021-02-11",583,6309,81,1695,502,4614,0,0,473,4205,107,1073,476,5278,"California",44289,0.0242272347535505,10046,0.37,16518,0.608
"572","calaveras",572,"2021-02-12",570,6879,325,2020,245,4859,0,0,494,4627,74,1147,496,5774,"California",44289,0.0258980785296575,10046,0.37,16518,0.608
"573","calaveras",573,"2021-02-13",193,7072,37,2057,156,5015,0,0,178,4790,15,1162,178,5952,"California",44289,0.0262367630788683,10046,0.37,16518,0.608
"574","calaveras",574,"2021-02-14",221,7293,71,2128,150,5165,0,0,206,4982,14,1176,206,6158,"California",44289,0.0265528686581318,10046,0.37,16518,0.608
"575","calaveras",575,"2021-02-15",383,7676,23,2151,360,5525,0,0,263,5128,117,1293,263,6421,"California",44289,0.0291946081419766,10046,0.37,16518,0.608
"576","calaveras",576,"2021-02-16",267,7943,143,2294,124,5649,0,0,230,5322,37,1330,231,6652,"California",44289,0.03003003003003,10046,0.37,16518,0.608
"577","calaveras",577,"2021-02-17",509,8452,38,2332,471,6120,0,0,210,5244,290,1620,212,6864,"California",44289,0.0365779313147734,10046,0.37,16518,0.608
"578","calaveras",578,"2021-02-18",499,8951,91,2423,408,6528,0,0,99,4955,388,2008,99,6963,"California",44289,0.0453385716543611,10046,0.37,16518,0.608
"579","calaveras",579,"2021-02-19",440,9391,43,2466,397,6925,0,0,98,4721,332,2340,98,7061,"California",44289,0.0528347896768949,10046,0.37,16518,0.608
"580","calaveras",580,"2021-02-20",59,9450,15,2481,44,6969,0,0,48,4758,11,2351,48,7109,"California",44289,0.0530831583463162,10046,0.37,16518,0.608
"581","calaveras",581,"2021-02-21",23,9473,14,2495,9,6978,0,0,19,4773,4,2355,19,7128,"California",44289,0.0531734742261058,10046,0.37,16518,0.608
"582","calaveras",582,"2021-02-22",62,9535,38,2533,24,7002,0,0,33,4777,29,2384,33,7161,"California",44289,0.0538282643545801,10046,0.37,16518,0.608
"583","calaveras",583,"2021-02-23",125,9660,40,2573,85,7087,0,0,89,4831,36,2420,90,7251,"California",44289,0.0546411072726862,10046,0.37,16518,0.608
"584","calaveras",584,"2021-02-24",96,9756,47,2620,49,7136,0,0,66,4868,29,2449,66,7317,"California",44289,0.0552958974011606,10046,0.37,16518,0.608
"585","calaveras",585,"2021-02-25",550,10306,99,2719,451,7587,0,0,359,5040,187,2636,359,7676,"California",44289,0.0595181647813227,10046,0.37,16518,0.608
"586","calaveras",586,"2021-02-26",705,11011,46,2765,659,8246,0,0,369,5091,320,2956,371,8047,"California",44289,0.0667434351644878,10046,0.37,16518,0.608
"587","calaveras",587,"2021-02-27",205,11216,22,2787,183,8429,0,0,181,5248,24,2980,181,8228,"California",44289,0.0672853304432252,10046,0.37,16518,0.608
"588","calaveras",588,"2021-02-28",99,11315,16,2803,83,8512,0,0,93,5336,5,2985,93,8321,"California",44289,0.0673982252929621,10046,0.37,16518,0.608
"589","calaveras",589,"2021-03-01",226,11541,40,2843,186,8698,0,0,146,5405,78,3063,147,8468,"California",44289,0.0691593849488586,10046,0.37,16518,0.608
"590","calaveras",590,"2021-03-02",248,11789,96,2939,152,8850,0,0,202,5565,43,3106,203,8671,"California",44289,0.0701302806565964,10046,0.37,16518,0.608
"591","calaveras",591,"2021-03-03",510,12299,103,3042,407,9257,0,0,213,5486,292,3398,213,8884,"California",44289,0.0767233398812346,10046,0.37,16518,0.608
"592","calaveras",592,"2021-03-04",742,13041,66,3108,675,9932,1,1,351,5455,383,3781,352,9236,"California",44289,0.0853710853710854,10046,0.37,16518,0.608
"593","calaveras",593,"2021-03-05",456,13497,271,3379,181,10113,4,5,141,5289,311,4092,145,9381,"California",44289,0.092393145024724,10046,0.37,16518,0.608
"594","calaveras",594,"2021-03-06",155,13652,42,3421,107,10220,6,11,122,5384,33,4125,128,9509,"California",44289,0.0931382510329879,10046,0.37,16518,0.608
"595","calaveras",595,"2021-03-07",75,13727,32,3453,36,10256,7,18,34,5384,41,4166,41,9550,"California",44289,0.0940639888008309,10046,0.37,16518,0.608
"596","calaveras",596,"2021-03-08",161,13888,26,3479,127,10383,8,26,127,5486,33,4199,135,9685,"California",44289,0.0948090948090948,10046,0.37,16518,0.608
"597","calaveras",597,"2021-03-09",360,14248,136,3615,218,10601,6,32,32,5200,324,4523,38,9723,"California",44289,0.102124681072049,10046,0.37,16518,0.608
"598","calaveras",598,"2021-03-10",417,14665,29,3644,385,10986,3,35,57,4905,355,4878,60,9783,"California",44289,0.110140215403373,10046,0.37,16518,0.608
"599","calaveras",599,"2021-03-11",848,15513,420,4064,415,11401,13,48,432,4938,412,5290,445,10228,"California",44289,0.119442751021698,10046,0.37,16518,0.608
"600","calaveras",600,"2021-03-12",399,15912,212,4276,177,11578,10,58,325,5206,73,5363,341,10569,"California",44289,0.121091015827858,10046,0.37,16518,0.608
"601","calaveras",601,"2021-03-13",176,16088,16,4292,152,11730,8,66,142,5325,33,5396,152,10721,"California",44289,0.121836121836122,10046,0.37,16518,0.608
"602","calaveras",602,"2021-03-14",156,16244,11,4303,144,11874,1,67,18,5213,138,5534,26,10747,"California",44289,0.124952019688862,10046,0.37,16518,0.608
"603","calaveras",603,"2021-03-15",332,16576,49,4352,257,12131,26,93,53,5018,278,5812,83,10830,"California",44289,0.131228973334236,10046,0.37,16518,0.608
"604","calaveras",604,"2021-03-16",685,17261,550,4902,115,12246,20,113,545,5445,138,5950,565,11395,"California",44289,0.134344871186976,10046,0.37,16518,0.608
"605","calaveras",605,"2021-03-17",279,17540,52,4954,213,12459,14,127,51,5286,225,6175,66,11461,"California",44289,0.139425139425139,10046,0.37,16518,0.608
"606","calaveras",606,"2021-03-18",666,18206,571,5525,80,12539,15,142,550,5737,116,6291,567,12028,"California",44289,0.142044299939037,10046,0.37,16518,0.608
"607","calaveras",607,"2021-03-19",231,18437,50,5575,107,12646,74,216,56,5695,171,6462,129,12157,"California",44289,0.145905303800041,10046,0.37,16518,0.608
"608","calaveras",608,"2021-03-20",80,18517,21,5596,58,12704,1,217,23,5663,57,6519,25,12182,"California",44289,0.147192305087042,10046,0.37,16518,0.608
"609","calaveras",609,"2021-03-21",48,18565,31,5627,6,12710,11,228,12,5650,36,6555,23,12205,"California",44289,0.148005148005148,10046,0.37,16518,0.608
"610","calaveras",610,"2021-03-22",79,18644,36,5663,22,12732,21,249,25,5642,54,6609,46,12251,"California",44289,0.149224412382307,10046,0.37,16518,0.608
"611","calaveras",611,"2021-03-23",292,18936,204,5867,78,12810,10,259,114,5597,169,6778,124,12375,"California",44289,0.153040258303416,10046,0.37,16518,0.608
"612","calaveras",612,"2021-03-24",132,19068,50,5917,72,12882,10,269,43,5562,88,6866,53,12428,"California",44289,0.155027207658787,10046,0.37,16518,0.608
"613","calaveras",613,"2021-03-25",741,19809,102,6019,636,13518,3,272,448,5723,290,7156,451,12879,"California",44289,0.16157510894353,10046,0.37,16518,0.608
"614","calaveras",614,"2021-03-26",426,20235,28,6047,392,13910,6,278,89,5486,334,7490,97,12976,"California",44289,0.169116484905959,10046,0.37,16518,0.608
"615","calaveras",615,"2021-03-27",212,20447,19,6066,189,14099,4,282,37,5357,172,7662,43,13019,"California",44289,0.17300006773691,10046,0.37,16518,0.608
"616","calaveras",616,"2021-03-28",112,20559,12,6078,98,14197,2,284,8,5265,103,7765,11,13030,"California",44289,0.175325701641491,10046,0.37,16518,0.608
"617","calaveras",617,"2021-03-29",178,20737,22,6100,153,14350,3,287,58,5209,118,7883,62,13092,"California",44289,0.177990020095283,10046,0.37,16518,0.608
"618","calaveras",618,"2021-03-30",532,21269,24,6124,491,14841,17,304,356,5407,175,8058,373,13465,"California",44289,0.181941339836077,10046,0.37,16518,0.608
"619","calaveras",619,"2021-03-31",322,21591,140,6264,172,15013,10,314,156,5408,166,8224,167,13632,"California",44289,0.185689448847344,10046,0.37,16518,0.608
"620","calaveras",620,"2021-04-01",684,22275,442,6706,241,15254,1,315,186,5101,497,8721,190,13822,"California",44289,0.196911196911197,10046,0.37,16518,0.608
"621","calaveras",621,"2021-04-02",394,22669,231,6937,155,15409,8,323,118,4955,273,8994,127,13949,"California",44289,0.203075255706835,10046,0.37,16518,0.608
"622","calaveras",622,"2021-04-03",144,22813,34,6971,106,15515,4,327,39,4893,105,9099,43,13992,"California",44289,0.205446047551311,10046,0.37,16518,0.608
"623","calaveras",623,"2021-04-04",79,22892,26,6997,53,15568,0,327,50,4914,29,9128,50,14042,"California",44289,0.206100837679785,10046,0.37,16518,0.608
"624","calaveras",624,"2021-04-05",208,23100,79,7076,120,15688,9,336,99,4914,109,9237,109,14151,"California",44289,0.208561945404051,10046,0.37,16518,0.608
"625","calaveras",625,"2021-04-06",650,23750,573,7649,64,15752,13,349,111,4502,536,9773,124,14275,"California",44289,0.220664273295852,10046,0.37,16518,0.608
"626","calaveras",626,"2021-04-07",756,24506,658,8307,62,15814,36,385,619,5021,137,9910,656,14931,"California",44289,0.223757592178645,10046,0.37,16518,0.608
"627","calaveras",627,"2021-04-08",946,25452,855,9162,70,15884,21,406,435,4971,508,10418,458,15389,"California",44289,0.235227708911919,10046,0.37,16518,0.608
"628","calaveras",628,"2021-04-09",153,25605,57,9219,48,15932,48,454,56,4980,96,10514,105,15494,"California",44289,0.237395290026869,10046,0.37,16518,0.608
"629","calaveras",629,"2021-04-10",188,25793,42,9261,128,16060,18,472,147,5105,41,10555,166,15660,"California",44289,0.238321027794712,10046,0.37,16518,0.608
"630","calaveras",630,"2021-04-11",69,25862,44,9305,23,16083,2,474,48,5134,21,10576,50,15710,"California",44289,0.238795186163607,10046,0.37,16518,0.608
"631","calaveras",631,"2021-04-12",103,25965,46,9351,38,16121,19,493,54,5159,49,10625,74,15784,"California",44289,0.239901555691029,10046,0.37,16518,0.608
"632","calaveras",632,"2021-04-13",422,26387,367,9718,55,16176,0,493,363,5466,58,10683,365,16149,"California",44289,0.241211135947978,10046,0.37,16518,0.608
"633","calaveras",633,"2021-04-14",182,26569,28,9746,154,16330,0,493,136,5557,46,10729,137,16286,"California",44289,0.242249768565558,10046,0.37,16518,0.608
"634","calaveras",634,"2021-04-15",336,26905,287,10033,49,16379,0,493,253,5730,80,10809,253,16539,"California",44289,0.244056086161349,10046,0.37,16518,0.608
"635","calaveras",635,"2021-04-16",98,27003,24,10057,74,16453,0,493,46,5728,48,10857,46,16585,"California",44289,0.245139876718824,10046,0.37,16518,0.608
"636","calaveras",636,"2021-04-17",331,27334,129,10186,202,16655,0,493,288,5974,42,10899,288,16873,"California",44289,0.246088193456615,10046,0.37,16518,0.608
"637","calaveras",637,"2021-04-18",18,27352,5,10191,13,16668,0,493,11,5978,7,10906,11,16884,"California",44289,0.246246246246246,10046,0.37,16518,0.608
"638","calaveras",638,"2021-04-19",67,27419,25,10216,42,16710,0,493,40,5993,26,10932,41,16925,"California",44289,0.246833299464878,10046,0.37,16518,0.608
"639","calaveras",639,"2021-04-20",258,27677,92,10308,166,16876,0,493,193,6123,63,10995,193,17118,"California",44289,0.248255774571564,10046,0.37,16518,0.608
"640","calaveras",640,"2021-04-21",212,27889,144,10452,68,16944,0,493,85,6084,125,11120,86,17204,"California",44289,0.251078145814988,10046,0.37,16518,0.608
"641","calaveras",641,"2021-04-22",543,28432,97,10549,446,17390,0,493,142,5829,400,11520,145,17349,"California",44289,0.260109733793944,10046,0.37,16518,0.608
"642","calaveras",642,"2021-04-23",158,28590,80,10629,78,17468,0,493,65,5803,91,11611,65,17414,"California",44289,0.262164420059157,10046,0.37,16518,0.608
"643","calaveras",643,"2021-04-24",172,28762,36,10665,136,17604,0,493,129,5891,42,11653,130,17544,"California",44289,0.263112736796947,10046,0.37,16518,0.608
"644","calaveras",644,"2021-04-25",43,28805,28,10693,15,17619,0,493,22,5894,21,11674,24,17568,"California",44289,0.263586895165843,10046,0.37,16518,0.608
"645","calaveras",645,"2021-04-26",93,28898,59,10752,34,17653,0,493,27,5856,66,11740,28,17596,"California",44289,0.26507710718237,10046,0.37,16518,0.608
"646","calaveras",646,"2021-04-27",423,29321,58,10810,351,18004,14,507,58,5565,363,12103,72,17668,"California",44289,0.273273273273273,10046,0.37,16518,0.608
"647","calaveras",647,"2021-04-28",641,29962,573,11383,37,18041,31,538,52,5068,589,12692,92,17760,"California",44289,0.286572286572287,10046,0.37,16518,0.608
"648","calaveras",648,"2021-04-29",508,30470,439,11822,50,18091,19,557,74,4733,433,13125,98,17858,"California",44289,0.296348980559507,10046,0.37,16518,0.608
"649","calaveras",649,"2021-04-30",148,30618,60,11882,83,18174,5,562,67,4730,81,13206,78,17936,"California",44289,0.298177877125246,10046,0.37,16518,0.608
"650","calaveras",650,"2021-05-01",197,30815,109,11991,86,18260,2,564,130,4800,66,13272,136,18072,"California",44289,0.299668089141773,10046,0.37,16518,0.608
"651","calaveras",651,"2021-05-02",52,30867,35,12026,16,18276,1,565,20,4791,31,13303,22,18094,"California",44289,0.300368037210142,10046,0.37,16518,0.608
"652","calaveras",652,"2021-05-03",90,30957,68,12094,17,18293,5,570,28,4765,62,13365,36,18130,"California",44289,0.301767933346881,10046,0.37,16518,0.608
"653","calaveras",653,"2021-05-04",411,31368,327,12421,47,18340,37,607,40,4473,370,13735,78,18208,"California",44289,0.310122152227415,10046,0.37,16518,0.608
"654","calaveras",654,"2021-05-05",107,31475,54,12475,22,18362,31,638,44,4486,62,13797,75,18283,"California",44289,0.311522048364154,10046,0.37,16518,0.608
"655","calaveras",655,"2021-05-06",253,31728,195,12670,34,18396,24,662,44,4348,208,14005,70,18353,"California",44289,0.316218474113211,10046,0.37,16518,0.608
"656","calaveras",656,"2021-05-07",81,31809,23,12693,52,18448,6,668,53,4379,28,14033,59,18412,"California",44289,0.316850685271738,10046,0.37,16518,0.608
"657","calaveras",657,"2021-05-08",286,32095,139,12832,145,18593,2,670,88,4273,196,14229,90,18502,"California",44289,0.321276163381427,10046,0.37,16518,0.608
"658","colusa",658,"2020-12-18",1,1,1,1,0,0,0,0,1,1,0,0,1,1,"California",22593,0,3239,0.407,4559,0.573
"659","colusa",659,"2020-12-21",2,3,2,3,0,0,0,0,2,3,0,0,2,3,"California",22593,0,3239,0.407,4559,0.573
"660","colusa",660,"2020-12-22",10,13,10,13,0,0,0,0,10,13,0,0,10,13,"California",22593,0,3239,0.407,4559,0.573
"661","colusa",661,"2020-12-23",10,23,10,23,0,0,0,0,10,23,0,0,10,23,"California",22593,0,3239,0.407,4559,0.573
"662","colusa",662,"2020-12-24",2,25,1,24,1,1,0,0,2,25,0,0,2,25,"California",22593,0,3239,0.407,4559,0.573
"663","colusa",663,"2020-12-27",1,26,1,25,0,1,0,0,1,26,0,0,1,26,"California",22593,0,3239,0.407,4559,0.573
"664","colusa",664,"2020-12-28",7,33,3,28,4,5,0,0,7,33,0,0,7,33,"California",22593,0,3239,0.407,4559,0.573
"665","colusa",665,"2020-12-29",11,44,8,36,3,8,0,0,11,44,0,0,11,44,"California",22593,0,3239,0.407,4559,0.573
"666","colusa",666,"2020-12-30",50,94,13,49,37,45,0,0,50,94,0,0,50,94,"California",22593,0,3239,0.407,4559,0.573
"667","colusa",667,"2020-12-31",18,112,1,50,17,62,0,0,18,112,0,0,18,112,"California",22593,0,3239,0.407,4559,0.573
"668","colusa",668,"2021-01-04",4,116,0,50,4,66,0,0,4,116,0,0,4,116,"California",22593,0,3239,0.407,4559,0.573
"669","colusa",669,"2021-01-05",67,183,1,51,66,132,0,0,67,183,0,0,67,183,"California",22593,0,3239,0.407,4559,0.573
"670","colusa",670,"2021-01-06",15,198,9,60,6,138,0,0,15,198,0,0,15,198,"California",22593,0,3239,0.407,4559,0.573
"671","colusa",671,"2021-01-07",38,236,4,64,34,172,0,0,37,234,1,1,37,235,"California",22593,4.4261496923826e-05,3239,0.407,4559,0.573
"672","colusa",672,"2021-01-08",9,245,7,71,2,174,0,0,8,241,1,2,8,243,"California",22593,8.85229938476519e-05,3239,0.407,4559,0.573
"673","colusa",673,"2021-01-09",2,247,1,72,1,175,0,0,2,243,0,2,2,245,"California",22593,8.85229938476519e-05,3239,0.407,4559,0.573
"674","colusa",674,"2021-01-10",1,248,0,72,1,176,0,0,1,244,0,2,1,246,"California",22593,8.85229938476519e-05,3239,0.407,4559,0.573
"675","colusa",675,"2021-01-11",12,260,6,78,6,182,0,0,7,246,5,7,7,253,"California",22593,0.000309830478466782,3239,0.407,4559,0.573
"676","colusa",676,"2021-01-12",11,271,9,87,2,184,0,0,6,247,5,12,6,259,"California",22593,0.000531137963085912,3239,0.407,4559,0.573
"677","colusa",677,"2021-01-13",21,292,13,100,8,192,0,0,13,252,8,20,13,272,"California",22593,0.000885229938476519,3239,0.407,4559,0.573
"678","colusa",678,"2021-01-14",35,327,28,128,7,199,0,0,33,283,2,22,33,305,"California",22593,0.000973752932324171,3239,0.407,4559,0.573
"679","colusa",679,"2021-01-15",41,368,5,133,36,235,0,0,39,320,2,24,39,344,"California",22593,0.00106227592617182,3239,0.407,4559,0.573
"680","colusa",680,"2021-01-16",12,380,1,134,11,246,0,0,11,330,1,25,11,355,"California",22593,0.00110653742309565,3239,0.407,4559,0.573
"681","colusa",681,"2021-01-17",3,383,2,136,1,247,0,0,2,331,1,26,2,357,"California",22593,0.00115079892001948,3239,0.407,4559,0.573
"682","colusa",682,"2021-01-18",4,387,0,136,4,251,0,0,4,335,0,26,4,361,"California",22593,0.00115079892001948,3239,0.407,4559,0.573
"683","colusa",683,"2021-01-19",9,396,8,144,1,252,0,0,5,336,4,30,5,366,"California",22593,0.00132784490771478,3239,0.407,4559,0.573
"684","colusa",684,"2021-01-20",115,511,101,245,14,266,0,0,102,425,13,43,102,468,"California",22593,0.00190324436772452,3239,0.407,4559,0.573
"685","colusa",685,"2021-01-21",56,567,41,286,15,281,0,0,55,479,1,44,55,523,"California",22593,0.00194750586464834,3239,0.407,4559,0.573
"686","colusa",686,"2021-01-22",40,607,17,303,23,304,0,0,35,509,5,49,35,558,"California",22593,0.00216881334926747,3239,0.407,4559,0.573
"687","colusa",687,"2021-01-23",35,642,6,309,29,333,0,0,35,544,0,49,35,593,"California",22593,0.00216881334926747,3239,0.407,4559,0.573
"688","colusa",688,"2021-01-25",7,649,0,309,7,340,0,0,7,551,0,49,7,600,"California",22593,0.00216881334926747,3239,0.407,4559,0.573
"689","colusa",689,"2021-01-26",8,657,5,314,3,343,0,0,5,553,3,52,5,605,"California",22593,0.00230159784003895,3239,0.407,4559,0.573
"690","colusa",690,"2021-01-27",109,766,31,345,78,421,0,0,107,658,2,54,107,712,"California",22593,0.0023901208338866,3239,0.407,4559,0.573
"691","colusa",691,"2021-01-28",79,845,46,391,33,454,0,0,72,723,7,61,72,784,"California",22593,0.00269995131235338,3239,0.407,4559,0.573
"692","colusa",692,"2021-01-29",41,886,7,398,34,488,0,0,40,762,1,62,40,824,"California",22593,0.00274421280927721,3239,0.407,4559,0.573
"693","colusa",693,"2021-01-30",27,913,4,402,23,511,0,0,27,789,0,62,27,851,"California",22593,0.00274421280927721,3239,0.407,4559,0.573
"694","colusa",694,"2021-01-31",7,920,7,409,0,511,0,0,7,796,0,62,7,858,"California",22593,0.00274421280927721,3239,0.407,4559,0.573
"695","colusa",695,"2021-02-01",27,947,10,419,17,528,0,0,22,813,5,67,22,880,"California",22593,0.00296552029389634,3239,0.407,4559,0.573
"696","colusa",696,"2021-02-02",42,989,8,427,34,562,0,0,36,843,6,73,36,916,"California",22593,0.0032310892754393,3239,0.407,4559,0.573
"697","colusa",697,"2021-02-03",69,1058,10,437,59,621,0,0,59,892,10,83,59,975,"California",22593,0.00367370424467755,3239,0.407,4559,0.573
"698","colusa",698,"2021-02-04",143,1201,81,518,62,683,0,0,115,979,28,111,115,1090,"California",22593,0.00491302615854468,3239,0.407,4559,0.573
"699","colusa",699,"2021-02-05",32,1233,8,526,24,707,0,0,29,1005,3,114,29,1119,"California",22593,0.00504581064931616,3239,0.407,4559,0.573
"700","colusa",700,"2021-02-06",284,1517,8,534,276,983,0,0,273,1267,11,125,273,1392,"California",22593,0.00553268711547825,3239,0.407,4559,0.573
"701","colusa",701,"2021-02-07",2,1519,1,535,1,984,0,0,0,1265,2,127,0,1392,"California",22593,0.0056212101093259,3239,0.407,4559,0.573
"702","colusa",702,"2021-02-08",40,1559,5,540,35,1019,0,0,37,1299,3,130,37,1429,"California",22593,0.00575399460009738,3239,0.407,4559,0.573
"703","colusa",703,"2021-02-09",231,1790,14,554,217,1236,0,0,176,1420,55,185,176,1605,"California",22593,0.0081883769309078,3239,0.407,4559,0.573
"704","colusa",704,"2021-02-10",116,1906,41,595,75,1311,0,0,73,1450,43,228,73,1678,"California",22593,0.0100916212986323,3239,0.407,4559,0.573
"705","colusa",705,"2021-02-11",98,2004,36,631,62,1373,0,0,73,1498,25,253,73,1751,"California",22593,0.011198158721728,3239,0.407,4559,0.573
"706","colusa",706,"2021-02-12",117,2121,9,640,108,1481,0,0,79,1538,39,292,79,1830,"California",22593,0.0129243571017572,3239,0.407,4559,0.573
"707","colusa",707,"2021-02-13",60,2181,8,648,52,1533,0,0,52,1582,8,300,52,1882,"California",22593,0.0132784490771478,3239,0.407,4559,0.573
"708","colusa",708,"2021-02-14",20,2201,8,656,12,1545,0,0,14,1590,6,306,14,1896,"California",22593,0.0135440180586907,3239,0.407,4559,0.573
"709","colusa",709,"2021-02-15",45,2246,10,666,35,1580,0,0,38,1621,7,313,38,1934,"California",22593,0.0138538485371575,3239,0.407,4559,0.573
"710","colusa",710,"2021-02-16",67,2313,4,670,63,1643,0,0,66,1686,1,314,66,2000,"California",22593,0.0138981100340814,3239,0.407,4559,0.573
"711","colusa",711,"2021-02-17",206,2519,143,813,63,1706,0,0,60,1600,146,460,60,2060,"California",22593,0.0203602885849599,3239,0.407,4559,0.573
"712","colusa",712,"2021-02-18",135,2654,35,848,100,1806,0,0,112,1689,23,483,112,2172,"California",22593,0.0213783030142079,3239,0.407,4559,0.573
"713","colusa",713,"2021-02-19",155,2809,19,867,136,1942,0,0,129,1792,26,509,129,2301,"California",22593,0.0225291019342274,3239,0.407,4559,0.573
"714","colusa",714,"2021-02-20",28,2837,6,873,22,1964,0,0,12,1788,16,525,12,2313,"California",22593,0.0232372858850086,3239,0.407,4559,0.573
"715","colusa",715,"2021-02-21",1,2838,1,874,0,1964,0,0,0,1787,1,526,0,2313,"California",22593,0.0232815473819325,3239,0.407,4559,0.573
"716","colusa",716,"2021-02-22",43,2881,26,900,17,1981,0,0,29,1802,14,540,29,2342,"California",22593,0.023901208338866,3239,0.407,4559,0.573
"717","colusa",717,"2021-02-23",22,2903,6,906,16,1997,0,0,18,1816,4,544,18,2360,"California",22593,0.0240782543265613,3239,0.407,4559,0.573
"718","colusa",718,"2021-02-24",300,3203,54,960,246,2243,0,0,158,1832,142,686,158,2518,"California",22593,0.0303633868897446,3239,0.407,4559,0.573
"719","colusa",719,"2021-02-25",102,3305,55,1015,47,2290,0,0,66,1862,36,722,66,2584,"California",22593,0.0319568007790023,3239,0.407,4559,0.573
"720","colusa",720,"2021-02-26",99,3404,14,1029,85,2375,0,0,60,1883,39,761,60,2644,"California",22593,0.0336829991590316,3239,0.407,4559,0.573
"721","colusa",721,"2021-02-27",55,3459,4,1033,51,2426,0,0,40,1908,15,776,40,2684,"California",22593,0.034346921612889,3239,0.407,4559,0.573
"722","colusa",722,"2021-02-28",26,3485,14,1047,12,2438,0,0,18,1918,8,784,18,2702,"California",22593,0.0347010135882796,3239,0.407,4559,0.573
"723","colusa",723,"2021-03-01",46,3531,15,1062,31,2469,0,0,29,1930,17,801,29,2731,"California",22593,0.0354534590359846,3239,0.407,4559,0.573
"724","colusa",724,"2021-03-02",49,3580,13,1075,36,2505,0,0,26,1933,23,824,26,2757,"California",22593,0.0364714734652326,3239,0.407,4559,0.573
"725","colusa",725,"2021-03-03",242,3822,43,1118,199,2704,0,0,185,2061,57,881,185,2942,"California",22593,0.0389943787898907,3239,0.407,4559,0.573
"726","colusa",726,"2021-03-04",138,3960,58,1176,80,2784,0,0,80,2083,58,939,80,3022,"California",22593,0.0415615456114726,3239,0.407,4559,0.573
"727","colusa",727,"2021-03-05",98,4058,25,1201,64,2848,9,9,53,2100,45,984,62,3084,"California",22593,0.0435533129730447,3239,0.407,4559,0.573
"728","colusa",728,"2021-03-06",274,4332,9,1210,265,3113,0,9,37,1900,237,1221,37,3121,"California",22593,0.0540432877439915,3239,0.407,4559,0.573
"729","colusa",729,"2021-03-07",8,4340,5,1215,3,3116,0,9,6,1904,2,1223,6,3127,"California",22593,0.0541318107378392,3239,0.407,4559,0.573
"730","colusa",730,"2021-03-08",89,4429,21,1236,33,3149,35,44,45,1940,44,1267,80,3207,"California",22593,0.0560793166024875,3239,0.407,4559,0.573
"731","colusa",731,"2021-03-09",274,4703,72,1308,179,3328,23,67,83,1855,191,1458,106,3313,"California",22593,0.0645332625149383,3239,0.407,4559,0.573
"732","colusa",732,"2021-03-10",289,4992,37,1345,216,3544,36,103,203,2008,86,1544,239,3552,"California",22593,0.0683397512503873,3239,0.407,4559,0.573
"733","colusa",733,"2021-03-11",420,5412,60,1405,339,3883,21,124,339,2285,81,1625,358,3910,"California",22593,0.0719249325012172,3239,0.407,4559,0.573
"734","colusa",734,"2021-03-12",109,5521,18,1423,78,3961,13,137,19,2227,90,1715,32,3942,"California",22593,0.0759084672243615,3239,0.407,4559,0.573
"735","colusa",735,"2021-03-13",61,5582,16,1439,36,3997,9,146,18,2211,43,1758,27,3969,"California",22593,0.077811711592086,3239,0.407,4559,0.573
"736","colusa",736,"2021-03-14",20,5602,0,1439,18,4015,2,148,6,2206,13,1771,8,3977,"California",22593,0.0783871110520958,3239,0.407,4559,0.573
"737","colusa",737,"2021-03-15",69,5671,26,1465,35,4050,8,156,14,2173,55,1826,22,3999,"California",22593,0.0808214933829062,3239,0.407,4559,0.573
"738","colusa",738,"2021-03-16",296,5967,16,1481,234,4284,46,202,189,2301,107,1933,235,4234,"California",22593,0.0855574735537556,3239,0.407,4559,0.573
"739","colusa",739,"2021-03-17",195,6162,49,1530,146,4430,0,202,110,2326,85,2018,110,4344,"California",22593,0.0893197007922808,3239,0.407,4559,0.573
"740","colusa",740,"2021-03-18",325,6487,38,1568,216,4646,71,273,202,2476,123,2141,273,4617,"California",22593,0.0947638649139114,3239,0.407,4559,0.573
"741","colusa",741,"2021-03-19",78,6565,20,1588,56,4702,2,275,53,2506,25,2166,55,4672,"California",22593,0.095870402337007,3239,0.407,4559,0.573
"742","colusa",742,"2021-03-20",49,6614,7,1595,41,4743,1,276,36,2530,13,2179,37,4709,"California",22593,0.0964458017970168,3239,0.407,4559,0.573
"743","colusa",743,"2021-03-21",6,6620,4,1599,2,4745,0,276,4,2532,2,2181,4,4713,"California",22593,0.0965343247908644,3239,0.407,4559,0.573
"744","colusa",744,"2021-03-22",62,6682,10,1609,43,4788,9,285,40,2559,22,2203,49,4762,"California",22593,0.0975080777231886,3239,0.407,4559,0.573
"745","colusa",745,"2021-03-23",81,6763,16,1625,63,4851,2,287,54,2588,27,2230,56,4818,"California",22593,0.0987031381401319,3239,0.407,4559,0.573
"746","colusa",746,"2021-03-24",337,7100,57,1682,274,5125,6,293,69,2394,268,2498,74,4892,"California",22593,0.110565219315717,3239,0.407,4559,0.573
"747","colusa",747,"2021-03-25",110,7210,61,1743,44,5169,5,298,53,2395,57,2555,58,4950,"California",22593,0.113088124640375,3239,0.407,4559,0.573
"748","colusa",748,"2021-03-26",298,7508,47,1790,247,5416,4,302,245,2591,53,2608,249,5199,"California",22593,0.115433983977338,3239,0.407,4559,0.573
"749","colusa",749,"2021-03-27",63,7571,5,1795,58,5474,0,302,25,2578,38,2646,25,5224,"California",22593,0.117115920860444,3239,0.407,4559,0.573
"750","colusa",750,"2021-03-28",15,7586,6,1801,9,5483,0,302,7,2577,8,2654,7,5231,"California",22593,0.117470012835834,3239,0.407,4559,0.573
"751","colusa",751,"2021-03-29",71,7657,20,1821,45,5528,6,308,31,2574,40,2694,37,5268,"California",22593,0.119240472712787,3239,0.407,4559,0.573
"752","colusa",752,"2021-03-30",147,7804,78,1899,67,5595,2,310,75,2579,72,2766,77,5345,"California",22593,0.122427300491303,3239,0.407,4559,0.573
"753","colusa",753,"2021-03-31",234,8038,42,1941,192,5787,0,310,74,2494,159,2925,74,5419,"California",22593,0.129464878502191,3239,0.407,4559,0.573
"754","colusa",754,"2021-04-01",428,8466,69,2010,305,6092,54,364,306,2732,121,3046,359,5778,"California",22593,0.134820519629974,3239,0.407,4559,0.573
"755","colusa",755,"2021-04-02",81,8547,12,2022,55,6147,14,378,37,2739,44,3090,51,5829,"California",22593,0.136768025494622,3239,0.407,4559,0.573
"756","colusa",756,"2021-04-03",61,8608,10,2032,28,6175,23,401,13,2727,48,3138,36,5865,"California",22593,0.138892577346966,3239,0.407,4559,0.573
"757","colusa",757,"2021-04-04",18,8626,0,2032,8,6183,10,411,3,2725,15,3153,13,5878,"California",22593,0.139556499800823,3239,0.407,4559,0.573
"758","colusa",758,"2021-04-05",95,8721,25,2057,55,6238,15,426,39,2723,56,3209,54,5932,"California",22593,0.142035143628558,3239,0.407,4559,0.573
"759","colusa",759,"2021-04-06",128,8849,33,2090,45,6283,50,476,43,2731,85,3294,93,6025,"California",22593,0.145797370867083,3239,0.407,4559,0.573
"760","colusa",760,"2021-04-07",358,9207,40,2130,295,6578,23,499,132,2661,226,3520,156,6181,"California",22593,0.155800469171867,3239,0.407,4559,0.573
"761","colusa",761,"2021-04-08",428,9635,35,2165,366,6944,27,526,122,2507,303,3823,149,6330,"California",22593,0.169211702739787,3239,0.407,4559,0.573
"762","colusa",762,"2021-04-09",77,9712,21,2186,33,6977,23,549,29,2511,48,3871,52,6382,"California",22593,0.17133625459213,3239,0.407,4559,0.573
"763","colusa",763,"2021-04-10",44,9756,9,2195,15,6992,20,569,12,2511,32,3903,32,6414,"California",22593,0.172752622493693,3239,0.407,4559,0.573
"764","colusa",764,"2021-04-11",16,9772,3,2198,11,7003,2,571,8,2513,8,3911,10,6424,"California",22593,0.173106714469083,3239,0.407,4559,0.573
"765","colusa",765,"2021-04-12",31,9803,3,2201,28,7031,0,571,24,2530,7,3918,24,6448,"California",22593,0.17341654494755,3239,0.407,4559,0.573
"766","colusa",766,"2021-04-13",278,10081,23,2224,255,7286,0,571,93,2439,184,4102,93,6541,"California",22593,0.181560660381534,3239,0.407,4559,0.573
"767","colusa",767,"2021-04-14",94,10175,19,2243,75,7361,0,571,33,2411,61,4163,33,6574,"California",22593,0.184260611693887,3239,0.407,4559,0.573
"768","colusa",768,"2021-04-15",323,10498,47,2290,276,7637,0,571,130,2348,193,4356,130,6704,"California",22593,0.192803080600186,3239,0.407,4559,0.573
"769","colusa",769,"2021-04-16",80,10578,11,2301,69,7706,0,571,36,2341,43,4399,36,6740,"California",22593,0.19470632496791,3239,0.407,4559,0.573
"770","colusa",770,"2021-04-17",53,10631,7,2308,46,7752,0,571,31,2350,22,4421,31,6771,"California",22593,0.195680077900235,3239,0.407,4559,0.573
"771","colusa",771,"2021-04-18",9,10640,2,2310,7,7759,0,571,7,2355,2,4423,7,6778,"California",22593,0.195768600894082,3239,0.407,4559,0.573
"772","colusa",772,"2021-04-19",61,10701,22,2332,39,7798,0,571,17,2328,44,4467,17,6795,"California",22593,0.197716106758731,3239,0.407,4559,0.573
"773","colusa",773,"2021-04-20",176,10877,32,2364,144,7942,0,571,128,2408,48,4515,128,6923,"California",22593,0.199840658611074,3239,0.407,4559,0.573
"774","colusa",774,"2021-04-21",170,11047,59,2423,111,8053,0,571,110,2458,60,4575,110,7033,"California",22593,0.202496348426504,3239,0.407,4559,0.573
"775","colusa",775,"2021-04-22",417,11464,26,2449,390,8443,1,572,214,2470,202,4777,214,7247,"California",22593,0.211437170805117,3239,0.407,4559,0.573
"776","colusa",776,"2021-04-23",91,11555,17,2466,74,8517,0,572,37,2453,54,4831,37,7284,"California",22593,0.213827291639003,3239,0.407,4559,0.573
"777","colusa",777,"2021-04-24",237,11792,19,2485,217,8734,1,573,204,2625,33,4864,205,7489,"California",22593,0.215287921037489,3239,0.407,4559,0.573
"778","colusa",778,"2021-04-25",11,11803,5,2490,6,8740,0,573,8,2630,3,4867,8,7497,"California",22593,0.215420705528261,3239,0.407,4559,0.573
"779","colusa",779,"2021-04-26",22,11825,4,2494,17,8757,1,574,6,2621,15,4882,6,7503,"California",22593,0.216084627982118,3239,0.407,4559,0.573
"780","colusa",780,"2021-04-27",92,11917,21,2515,67,8824,4,578,43,2619,49,4931,47,7550,"California",22593,0.218253441331386,3239,0.407,4559,0.573
"781","colusa",781,"2021-04-28",188,12105,27,2542,158,8982,3,581,138,2711,49,4980,141,7691,"California",22593,0.220422254680653,3239,0.407,4559,0.573
"782","colusa",782,"2021-04-29",316,12421,25,2567,287,9269,4,585,46,2493,268,5248,50,7741,"California",22593,0.232284335856239,3239,0.407,4559,0.573
"783","colusa",783,"2021-04-30",65,12486,18,2585,47,9316,0,585,41,2510,24,5272,41,7782,"California",22593,0.23334661178241,3239,0.407,4559,0.573
"784","colusa",784,"2021-05-01",19,12505,8,2593,8,9324,3,588,9,2512,10,5282,12,7794,"California",22593,0.233789226751649,3239,0.407,4559,0.573
"785","colusa",785,"2021-05-02",3,12508,0,2593,2,9326,1,589,2,2514,1,5283,3,7797,"California",22593,0.233833488248573,3239,0.407,4559,0.573
"786","colusa",786,"2021-05-03",21,12529,7,2600,14,9340,0,589,6,2505,15,5298,6,7803,"California",22593,0.23449741070243,3239,0.407,4559,0.573
"787","colusa",787,"2021-05-04",86,12615,44,2644,41,9381,1,590,63,2546,23,5321,64,7867,"California",22593,0.235515425131678,3239,0.407,4559,0.573
"788","colusa",788,"2021-05-05",65,12680,14,2658,50,9431,1,591,30,2542,35,5356,31,7898,"California",22593,0.237064577524012,3239,0.407,4559,0.573
"789","colusa",789,"2021-05-06",247,12927,14,2672,230,9661,3,594,103,2504,144,5500,106,8004,"California",22593,0.243438233081043,3239,0.407,4559,0.573
"790","colusa",790,"2021-05-07",69,12996,4,2676,61,9722,4,598,29,2497,40,5540,33,8037,"California",22593,0.245208692957996,3239,0.407,4559,0.573
"791","colusa",791,"2021-05-08",18,13014,5,2681,13,9735,0,598,9,2497,9,5549,9,8046,"California",22593,0.24560704643031,3239,0.407,4559,0.573
"792","contra costa",792,"2020-12-15",18,18,18,18,0,0,0,0,18,18,0,0,18,18,"California",1160099,0,416386,0.716,152877,0.263
"793","contra costa",793,"2020-12-16",522,540,522,540,0,0,0,0,522,540,0,0,522,540,"California",1160099,0,416386,0.716,152877,0.263
"794","contra costa",794,"2020-12-17",908,1448,908,1448,0,0,0,0,908,1448,0,0,908,1448,"California",1160099,0,416386,0.716,152877,0.263
"795","contra costa",795,"2020-12-18",1591,3039,1590,3038,1,1,0,0,1591,3039,0,0,1591,3039,"California",1160099,0,416386,0.716,152877,0.263
"796","contra costa",796,"2020-12-19",1103,4142,1102,4140,1,2,0,0,1103,4142,0,0,1103,4142,"California",1160099,0,416386,0.716,152877,0.263
"797","contra costa",797,"2020-12-20",584,4726,583,4723,1,3,0,0,584,4726,0,0,584,4726,"California",1160099,0,416386,0.716,152877,0.263
"798","contra costa",798,"2020-12-21",1653,6379,1651,6374,2,5,0,0,1653,6379,0,0,1653,6379,"California",1160099,0,416386,0.716,152877,0.263
"799","contra costa",799,"2020-12-22",1667,8046,1563,7937,104,109,0,0,1667,8046,0,0,1667,8046,"California",1160099,0,416386,0.716,152877,0.263
"800","contra costa",800,"2020-12-23",1590,9636,1342,9279,248,357,0,0,1590,9636,0,0,1590,9636,"California",1160099,0,416386,0.716,152877,0.263
"801","contra costa",801,"2020-12-24",656,10292,336,9615,320,677,0,0,656,10292,0,0,656,10292,"California",1160099,0,416386,0.716,152877,0.263
"802","contra costa",802,"2020-12-25",39,10331,17,9632,22,699,0,0,39,10331,0,0,39,10331,"California",1160099,0,416386,0.716,152877,0.263
"803","contra costa",803,"2020-12-26",641,10972,131,9763,510,1209,0,0,641,10972,0,0,641,10972,"California",1160099,0,416386,0.716,152877,0.263
"804","contra costa",804,"2020-12-27",240,11212,87,9850,153,1362,0,0,240,11212,0,0,240,11212,"California",1160099,0,416386,0.716,152877,0.263
"805","contra costa",805,"2020-12-28",1833,13045,863,10713,970,2332,0,0,1833,13045,0,0,1833,13045,"California",1160099,0,416386,0.716,152877,0.263
"806","contra costa",806,"2020-12-29",1830,14875,824,11537,1006,3338,0,0,1830,14875,0,0,1830,14875,"California",1160099,0,416386,0.716,152877,0.263
"807","contra costa",807,"2020-12-30",2392,17267,1214,12751,1178,4516,0,0,2391,17266,0,0,2391,17266,"California",1160099,0,416386,0.716,152877,0.263
"808","contra costa",808,"2020-12-31",915,18182,308,13059,607,5123,0,0,914,18180,0,0,914,18180,"California",1160099,0,416386,0.716,152877,0.263
"809","contra costa",809,"2021-01-01",61,18243,23,13082,38,5161,0,0,61,18241,0,0,61,18241,"California",1160099,0,416386,0.716,152877,0.263
"810","contra costa",810,"2021-01-02",335,18578,173,13255,162,5323,0,0,335,18576,0,0,335,18576,"California",1160099,0,416386,0.716,152877,0.263
"811","contra costa",811,"2021-01-03",175,18753,117,13372,58,5381,0,0,174,18750,0,0,174,18750,"California",1160099,0,416386,0.716,152877,0.263
"812","contra costa",812,"2021-01-04",1904,20657,1251,14623,653,6034,0,0,1883,20614,19,19,1883,20633,"California",1160099,1.63779125747027e-05,416386,0.716,152877,0.263
"813","contra costa",813,"2021-01-05",2105,22762,1259,15882,846,6880,0,0,1846,22203,258,277,1847,22480,"California",1160099,0.000238772725431192,416386,0.716,152877,0.263
"814","contra costa",814,"2021-01-06",3279,26041,2247,18129,1032,7912,0,0,2519,23971,754,1031,2522,25002,"California",1160099,0.000888717256027287,416386,0.716,152877,0.263
"815","contra costa",815,"2021-01-07",3092,29133,2059,20188,1033,8945,0,0,1881,24644,1208,2239,1881,26883,"California",1160099,0.00193000769761891,416386,0.716,152877,0.263
"816","contra costa",816,"2021-01-08",3383,32516,2391,22579,992,9937,0,0,1821,24911,1557,3796,1824,28707,"California",1160099,0.00327213453334586,416386,0.716,152877,0.263
"817","contra costa",817,"2021-01-09",1585,34101,1133,23712,452,10389,0,0,748,24825,836,4632,750,29457,"California",1160099,0.00399276268663278,416386,0.716,152877,0.263
"818","contra costa",818,"2021-01-10",362,34463,286,23998,76,10465,0,0,153,24769,209,4841,153,29610,"California",1160099,0.00417291972495451,416386,0.716,152877,0.263
"819","contra costa",819,"2021-01-11",3837,38300,3145,27143,692,11157,0,0,2233,25401,1604,6445,2236,31846,"California",1160099,0.00555556034441888,416386,0.716,152877,0.263
"820","contra costa",820,"2021-01-12",3908,42208,2933,30076,975,12132,0,0,2581,26658,1327,7772,2584,34430,"California",1160099,0.00669942823845206,416386,0.716,152877,0.263
"821","contra costa",821,"2021-01-13",4708,46916,2917,32993,1791,13923,0,0,3764,29483,940,8712,3765,38195,"California",1160099,0.00750970391320051,416386,0.716,152877,0.263
"822","contra costa",822,"2021-01-14",4305,51221,1555,34548,2750,16673,0,0,3923,33024,382,9094,3923,42118,"California",1160099,0.0078389861554919,416386,0.716,152877,0.263
"823","contra costa",823,"2021-01-15",5338,56559,2461,37009,2877,19550,0,0,5015,37721,322,9416,5019,47137,"California",1160099,0.00811654867386318,416386,0.716,152877,0.263
"824","contra costa",824,"2021-01-16",1719,58278,554,37563,1165,20715,0,0,1644,39290,75,9491,1644,48781,"California",1160099,0.00818119832876332,416386,0.716,152877,0.263
"825","contra costa",825,"2021-01-17",1636,59914,974,38537,662,21377,0,0,1513,40683,123,9614,1516,50297,"California",1160099,0.00828722376279955,416386,0.716,152877,0.263
"826","contra costa",826,"2021-01-18",3205,63119,1262,39799,1943,23320,0,0,2580,42645,619,10233,2581,52878,"California",1160099,0.00882079891457539,416386,0.716,152877,0.263
"827","contra costa",827,"2021-01-19",7068,70187,3163,42962,3905,27225,0,0,6064,47713,1001,11234,6069,58947,"California",1160099,0.00968365630864262,416386,0.716,152877,0.263
"828","contra costa",828,"2021-01-20",6663,76850,4103,47065,2560,29785,0,0,5430,51919,1229,12463,5435,64382,"California",1160099,0.0107430486536063,416386,0.716,152877,0.263
"829","contra costa",829,"2021-01-21",6977,83827,3112,50177,3865,33650,0,0,6249,57453,723,13186,6257,70639,"California",1160099,0.0113662713268437,416386,0.716,152877,0.263
"830","contra costa",830,"2021-01-22",6369,90196,2706,52883,3663,37313,0,0,5511,62118,849,14035,5514,76153,"California",1160099,0.0120981054203133,416386,0.716,152877,0.263
"831","contra costa",831,"2021-01-23",2031,92227,363,53246,1668,38981,0,0,1773,63637,256,14291,1775,77928,"California",1160099,0.0123187762423724,416386,0.716,152877,0.263
"832","contra costa",832,"2021-01-24",1581,93808,218,53464,1363,40344,0,0,1436,64932,145,14436,1440,79368,"California",1160099,0.0124437655751794,416386,0.716,152877,0.263
"833","contra costa",833,"2021-01-25",6655,100463,3017,56481,3638,43982,0,0,5092,68466,1561,15997,5095,84463,"California",1160099,0.013789340392501,416386,0.716,152877,0.263
"834","contra costa",834,"2021-01-26",8091,108554,4689,61170,3402,47384,0,0,6247,72881,1836,17833,6251,90714,"California",1160099,0.0153719639444565,416386,0.716,152877,0.263
"835","contra costa",835,"2021-01-27",8247,116801,5505,66675,2742,50126,0,0,6341,77401,1825,19658,6345,97059,"California",1160099,0.0169451055470266,416386,0.716,152877,0.263
"836","contra costa",836,"2021-01-28",7446,124247,4085,70760,3361,53487,0,0,5839,81643,1601,21259,5843,102902,"California",1160099,0.018325160180295,416386,0.716,152877,0.263
"837","contra costa",837,"2021-01-29",7441,131688,3890,74650,3551,57038,0,0,6128,86464,1309,22568,6130,109032,"California",1160099,0.0194535121571521,416386,0.716,152877,0.263
"838","contra costa",838,"2021-01-30",2083,133771,597,75247,1486,58524,0,0,1717,87822,359,22927,1717,110749,"California",1160099,0.0197629685052741,416386,0.716,152877,0.263
"839","contra costa",839,"2021-01-31",698,134469,479,75726,219,58743,0,0,572,88271,123,23050,572,111321,"California",1160099,0.0198689939393104,416386,0.716,152877,0.263
"840","contra costa",840,"2021-02-01",5529,139998,3767,79493,1762,60505,0,0,3897,90545,1626,24676,3900,115221,"California",1160099,0.0212705984575454,416386,0.716,152877,0.263
"841","contra costa",841,"2021-02-02",7762,147760,5273,84766,2489,62994,0,0,5909,94604,1851,26527,5910,121131,"California",1160099,0.0228661519404809,416386,0.716,152877,0.263
"842","contra costa",842,"2021-02-03",8274,156034,5465,90231,2809,65803,0,0,5612,97567,2650,29177,5613,126744,"California",1160099,0.0251504397469526,416386,0.716,152877,0.263
"843","contra costa",843,"2021-02-04",7442,163476,3535,93766,3907,69710,0,0,5711,101554,1727,30904,5714,132458,"California",1160099,0.0266391058004532,416386,0.716,152877,0.263
"844","contra costa",844,"2021-02-05",8432,171908,4824,98590,3608,73318,0,0,5719,104567,2706,33610,5719,138177,"California",1160099,0.0289716653492504,416386,0.716,152877,0.263
"845","contra costa",845,"2021-02-06",3471,175379,2156,100746,1315,74633,0,0,2818,106734,652,34262,2819,140996,"California",1160099,0.0295336863491823,416386,0.716,152877,0.263
"846","contra costa",846,"2021-02-07",981,176360,710,101456,271,74904,0,0,604,106962,376,34638,604,141600,"California",1160099,0.0298577966190816,416386,0.716,152877,0.263
"847","contra costa",847,"2021-02-08",5817,182177,3441,104897,2376,77280,0,0,4336,109823,1476,36114,4337,145937,"California",1160099,0.0311301018275164,416386,0.716,152877,0.263
"848","contra costa",848,"2021-02-09",8668,190845,4780,109677,3888,81168,0,0,5770,112701,2893,39007,5771,151708,"California",1160099,0.0336238545158646,416386,0.716,152877,0.263
"849","contra costa",849,"2021-02-10",8632,199477,4647,114324,3985,85153,0,0,5357,114802,3260,42267,5361,157069,"California",1160099,0.0364339595155241,416386,0.716,152877,0.263
"850","contra costa",850,"2021-02-11",9310,208787,4216,118540,5094,90247,0,0,5264,116032,4039,46306,5269,162338,"California",1160099,0.0399155589307464,416386,0.716,152877,0.263
"851","contra costa",851,"2021-02-12",10073,218860,4614,123154,5459,95706,0,0,5455,116879,4611,50917,5458,167796,"California",1160099,0.0438902197140072,416386,0.716,152877,0.263
"852","contra costa",852,"2021-02-13",4881,223741,1367,124521,3514,99220,0,0,3400,118802,1478,52395,3401,171197,"California",1160099,0.0451642489132393,416386,0.716,152877,0.263
"853","contra costa",853,"2021-02-14",2087,225828,865,125386,1222,100442,0,0,1225,119167,860,53255,1225,172422,"California",1160099,0.0459055649560943,416386,0.716,152877,0.263
"854","contra costa",854,"2021-02-15",4457,230285,2469,127855,1988,102430,0,0,2349,119416,2101,55356,2350,174772,"California",1160099,0.0477166172886969,416386,0.716,152877,0.263
"855","contra costa",855,"2021-02-16",10416,240701,4909,132764,5507,107937,0,0,4642,118296,5766,61122,4646,179418,"California",1160099,0.0526868827574198,416386,0.716,152877,0.263
"856","contra costa",856,"2021-02-17",12282,252983,6136,138900,6146,114083,0,0,5629,117288,6638,67760,5630,185048,"California",1160099,0.0584088082137818,416386,0.716,152877,0.263
"857","contra costa",857,"2021-02-18",11472,264455,5970,144870,5502,119585,0,0,5322,116473,6139,73899,5324,190372,"California",1160099,0.0637005979662081,416386,0.716,152877,0.263
"858","contra costa",858,"2021-02-19",11406,275861,7107,151977,4299,123884,0,0,5175,115435,6214,80113,5176,195548,"California",1160099,0.0690570373735345,416386,0.716,152877,0.263
"859","contra costa",859,"2021-02-20",6447,282308,2894,154871,3553,127437,0,0,4566,118138,1865,81978,4568,200116,"California",1160099,0.0706646587920514,416386,0.716,152877,0.263
"860","contra costa",860,"2021-02-21",1814,284122,1264,156135,550,127987,0,0,1094,118514,718,82696,1094,201210,"California",1160099,0.0712835714882954,416386,0.716,152877,0.263
"861","contra costa",861,"2021-02-22",7537,291659,5100,161235,2437,130424,0,0,3459,117909,4066,86762,3461,204671,"California",1160099,0.0747884447792818,416386,0.716,152877,0.263
"862","contra costa",862,"2021-02-23",11913,303572,7257,168492,4656,135080,0,0,5929,117872,5970,92732,5933,210604,"California",1160099,0.0799345573093331,416386,0.716,152877,0.263
"863","contra costa",863,"2021-02-24",10487,314059,7685,176177,2802,137882,0,0,5054,117512,5416,98148,5056,215660,"California",1160099,0.084603124388522,416386,0.716,152877,0.263
"864","contra costa",864,"2021-02-25",11471,325530,7211,183388,4260,142142,0,0,5206,116477,6245,104393,5210,220870,"California",1160099,0.0899862856532072,416386,0.716,152877,0.263
"865","contra costa",865,"2021-02-26",10706,336236,6755,190143,3951,146093,0,0,5308,116403,5383,109776,5309,226179,"California",1160099,0.0946264068842401,416386,0.716,152877,0.263
"866","contra costa",866,"2021-02-27",6626,342862,4212,194355,2414,148507,0,0,4115,118016,2503,112279,4116,230295,"California",1160099,0.0967839813671075,416386,0.716,152877,0.263
"867","contra costa",867,"2021-02-28",3793,346655,3122,197477,671,149178,0,0,3195,120617,595,112874,3196,233491,"California",1160099,0.0972968686293153,416386,0.716,152877,0.263
"868","contra costa",868,"2021-03-01",8104,354759,6084,203561,2015,151193,5,5,4977,122490,3111,115985,4984,238475,"California",1160099,0.0999785363145732,416386,0.716,152877,0.263
"869","contra costa",869,"2021-03-02",10159,364918,6332,209893,3826,155019,1,6,5263,122874,4880,120865,5264,243739,"California",1160099,0.104185073860076,416386,0.716,152877,0.263
"870","contra costa",870,"2021-03-03",11170,376088,6985,216878,4184,159203,1,7,6252,124224,4904,125769,6254,249993,"California",1160099,0.108412299295146,416386,0.716,152877,0.263
"871","contra costa",871,"2021-03-04",11889,387977,7103,223981,4786,163989,0,7,6159,124672,5711,131480,6159,256152,"California",1160099,0.113335155016943,416386,0.716,152877,0.263
"872","contra costa",872,"2021-03-05",11239,399216,6671,230652,4562,168551,6,13,6400,126254,4824,136304,6406,262558,"California",1160099,0.11749342082012,416386,0.716,152877,0.263
"873","contra costa",873,"2021-03-06",7299,406515,4012,234664,2977,171528,310,323,4720,128715,2567,138871,5028,267586,"California",1160099,0.119706163008502,416386,0.716,152877,0.263
"874","contra costa",874,"2021-03-07",3632,410147,2276,236940,1294,172822,62,385,2957,131060,674,139545,3019,270605,"California",1160099,0.120287147907204,416386,0.716,152877,0.263
"875","contra costa",875,"2021-03-08",8063,418210,3766,240706,3993,176815,304,689,5372,134060,2680,142225,5680,276285,"California",1160099,0.122597295575636,416386,0.716,152877,0.263
"876","contra costa",876,"2021-03-09",10223,428433,5019,245725,4909,181724,295,984,5052,134244,5163,147388,5347,281632,"California",1160099,0.127047777818962,416386,0.716,152877,0.263
"877","contra costa",877,"2021-03-10",12154,440587,5971,251696,4687,186411,1496,2480,5478,134544,6665,154053,6965,288597,"California",1160099,0.132792977151088,416386,0.716,152877,0.263
"878","contra costa",878,"2021-03-11",12472,453059,6568,258264,5341,191752,563,3043,6364,135386,6086,160139,6928,295525,"California",1160099,0.138039081147385,416386,0.716,152877,0.263
"879","contra costa",879,"2021-03-12",12547,465606,5151,263415,6851,198603,545,3588,6271,135939,6261,166400,6814,302339,"California",1160099,0.143436034338449,416386,0.716,152877,0.263
"880","contra costa",880,"2021-03-13",7766,473372,3077,266492,4265,202868,424,4012,3082,134772,4667,171067,3500,305839,"California",1160099,0.147458966864035,416386,0.716,152877,0.263
"881","contra costa",881,"2021-03-14",4348,477720,2547,269039,1317,204185,484,4496,2068,135051,2272,173339,2551,308390,"California",1160099,0.14941742040981,416386,0.716,152877,0.263
"882","contra costa",882,"2021-03-15",9384,487104,5062,274101,3569,207754,753,5249,4753,135943,4614,177953,5506,313896,"California",1160099,0.153394667179267,416386,0.716,152877,0.263
"883","contra costa",883,"2021-03-16",14255,501359,8466,282567,5393,213147,396,5645,7266,136637,6967,184920,7661,321557,"California",1160099,0.15940018912179,416386,0.716,152877,0.263
"884","contra costa",884,"2021-03-17",14999,516358,10345,292912,4440,217587,214,5859,8581,139041,6397,191317,8801,330358,"California",1160099,0.164914373687073,416386,0.716,152877,0.263
"885","contra costa",885,"2021-03-18",15371,531729,8544,301456,6347,223934,480,6339,8794,141765,6548,197865,9272,339630,"California",1160099,0.170558719557555,416386,0.716,152877,0.263
"886","contra costa",886,"2021-03-19",15501,547230,8906,310362,5205,229139,1390,7729,8301,144275,7186,205051,9696,349326,"California",1160099,0.176753018492387,416386,0.716,152877,0.263
"887","contra costa",887,"2021-03-20",10617,557847,6340,316702,3974,233113,303,8032,5242,144463,5358,210409,5546,354872,"California",1160099,0.181371589838453,416386,0.716,152877,0.263
"888","contra costa",888,"2021-03-21",4441,562288,3888,320590,466,233579,87,8119,2083,144281,2351,212760,2169,357041,"California",1160099,0.183398141020723,416386,0.716,152877,0.263
"889","contra costa",889,"2021-03-22",11528,573816,8688,329278,2591,236170,249,8368,7089,147191,4427,217187,7337,364378,"California",1160099,0.187214194650629,416386,0.716,152877,0.263
"890","contra costa",890,"2021-03-23",15604,589420,10748,340026,4686,240856,170,8538,9497,150782,6079,223266,9670,374048,"California",1160099,0.192454264679135,416386,0.716,152877,0.263
"891","contra costa",891,"2021-03-24",14980,604400,11681,351707,3087,243943,212,8750,9206,154460,5742,229008,9420,383468,"California",1160099,0.19740384225829,416386,0.716,152877,0.263
"892","contra costa",892,"2021-03-25",15270,619670,11896,363603,3090,247033,284,9034,9428,158365,5805,234813,9710,393178,"California",1160099,0.202407725547561,416386,0.716,152877,0.263
"893","contra costa",893,"2021-03-26",14936,634606,10701,374304,3840,250873,395,9429,8817,161479,6093,240906,9207,402385,"California",1160099,0.207659863511649,416386,0.716,152877,0.263
"894","contra costa",894,"2021-03-27",10429,645035,6750,381054,3169,254042,510,9939,5769,163101,4650,245556,6272,408657,"California",1160099,0.211668142115457,416386,0.716,152877,0.263
"895","contra costa",895,"2021-03-28",4130,649165,2925,383979,1153,255195,52,9991,1766,162565,2354,247910,1818,410475,"California",1160099,0.213697279283923,416386,0.716,152877,0.263
"896","contra costa",896,"2021-03-29",10826,659991,8448,392427,2263,257458,115,10106,7073,166017,3738,251648,7190,417665,"California",1160099,0.216919418084146,416386,0.716,152877,0.263
"897","contra costa",897,"2021-03-30",16721,676712,9124,401551,6245,263703,1352,11458,11030,172723,5676,257324,12382,430047,"California",1160099,0.221812103966989,416386,0.716,152877,0.263
"898","contra costa",898,"2021-03-31",17954,694666,12561,414112,3953,267656,1440,12898,11535,179309,6386,263710,12972,443019,"California",1160099,0.227316806582886,416386,0.716,152877,0.263
"899","contra costa",899,"2021-04-01",17420,712086,12193,426305,3865,271521,1362,14260,11343,185957,6055,269765,12703,455722,"California",1160099,0.232536188721825,416386,0.716,152877,0.263
"900","contra costa",900,"2021-04-02",17388,729474,12832,439137,3551,275072,1005,15265,11559,192702,5818,275583,12563,468285,"California",1160099,0.237551277951278,416386,0.716,152877,0.263
"901","contra costa",901,"2021-04-03",10756,740230,6417,445554,2803,277875,1536,16801,6159,195812,4584,280167,7694,475979,"California",1160099,0.241502664858775,416386,0.716,152877,0.263
"902","contra costa",902,"2021-04-04",3317,743547,1313,446867,1409,279284,595,17396,889,194875,2420,282587,1483,477462,"California",1160099,0.243588693723553,416386,0.716,152877,0.263
"903","contra costa",903,"2021-04-05",12043,755590,7855,454722,3212,282496,976,18372,6569,196960,5460,288047,7545,485007,"California",1160099,0.248295188600283,416386,0.716,152877,0.263
"904","contra costa",904,"2021-04-06",17294,772884,11987,466709,3025,285521,2282,20654,9759,201486,7514,295561,12040,497047,"California",1160099,0.254772222025879,416386,0.716,152877,0.263
"905","contra costa",905,"2021-04-07",18453,791337,12486,479195,3162,288683,2805,23459,10468,206830,7965,303526,13309,510356,"California",1160099,0.261638015376274,416386,0.716,152877,0.263
"906","contra costa",906,"2021-04-08",18605,809942,12404,491599,3289,291972,2912,26371,9988,211128,8589,312115,12887,523243,"California",1160099,0.269041693855438,416386,0.716,152877,0.263
"907","contra costa",907,"2021-04-09",18667,828609,11922,503521,4270,296242,2475,28846,9974,214905,8667,320782,12444,535687,"California",1160099,0.276512607975699,416386,0.716,152877,0.263
"908","contra costa",908,"2021-04-10",10505,839114,3801,507322,2156,298398,4548,33394,3286,215522,7204,327986,7821,543508,"California",1160099,0.282722422827707,416386,0.716,152877,0.263
"909","contra costa",909,"2021-04-11",3315,842429,1980,509302,682,299080,653,34047,1120,215106,2189,330175,1773,545281,"California",1160099,0.284609330755392,416386,0.716,152877,0.263
"910","contra costa",910,"2021-04-12",11861,854290,7842,517144,2966,302046,1053,35100,5592,215500,6255,336430,6649,551930,"California",1160099,0.290001111974064,416386,0.716,152877,0.263
"911","contra costa",911,"2021-04-13",17789,872079,10875,528019,6909,308955,5,35105,11883,221509,5885,342315,11894,563824,"California",1160099,0.295073954895229,416386,0.716,152877,0.263
"912","contra costa",912,"2021-04-14",17531,889610,10987,539006,6543,315498,1,35106,9705,223411,7807,350122,9709,573533,"California",1160099,0.301803552972634,416386,0.716,152877,0.263
"913","contra costa",913,"2021-04-15",17497,907107,10728,549734,6768,322266,1,35107,8122,222207,9346,359468,8142,581675,"California",1160099,0.309859761968591,416386,0.716,152877,0.263
"914","contra costa",914,"2021-04-16",16857,923964,10532,560266,6324,328590,1,35108,7613,220606,9220,368688,7619,589294,"California",1160099,0.317807359544315,416386,0.716,152877,0.263
"915","contra costa",915,"2021-04-17",11421,935385,6275,566541,5146,333736,0,35108,6134,221471,5274,373962,6139,595433,"California",1160099,0.322353523276893,416386,0.716,152877,0.263
"916","contra costa",916,"2021-04-18",2731,938116,2112,568653,619,334355,0,35108,1776,222300,947,374909,1776,597209,"California",1160099,0.323169832919432,416386,0.716,152877,0.263
"917","contra costa",917,"2021-04-19",11336,949452,8479,577132,2857,337212,0,35108,3550,218092,7760,382669,3552,600761,"California",1160099,0.3298589172131,416386,0.716,152877,0.263
"918","contra costa",918,"2021-04-20",16615,966067,10794,587926,5821,343033,0,35108,6239,213985,10350,393019,6243,607004,"California",1160099,0.33878056958932,416386,0.716,152877,0.263
"919","contra costa",919,"2021-04-21",17292,983359,14116,602042,3176,346209,0,35108,6154,209043,11104,404123,6162,613166,"California",1160099,0.348352166496135,416386,0.716,152877,0.263
"920","contra costa",920,"2021-04-22",17143,1000502,13887,615929,3255,349464,1,35109,6073,204089,11038,415161,6084,619250,"California",1160099,0.357866871706639,416386,0.716,152877,0.263
"921","contra costa",921,"2021-04-23",16949,1017451,13482,629411,3467,352931,0,35109,5471,198123,11444,426605,5478,624728,"California",1160099,0.367731547049002,416386,0.716,152877,0.263
"922","contra costa",922,"2021-04-24",10881,1028332,8417,637828,2464,355395,0,35109,4164,195594,6697,433302,4168,628896,"California",1160099,0.373504330233885,416386,0.716,152877,0.263
"923","contra costa",923,"2021-04-25",3225,1031557,2176,640004,1047,356442,2,35111,2035,196447,1187,434489,2040,630936,"California",1160099,0.374527518772105,416386,0.716,152877,0.263
"924","contra costa",924,"2021-04-26",9540,1041097,8093,648097,1423,357865,24,35135,2802,192561,6722,441211,2836,633772,"California",1160099,0.380321851841955,416386,0.716,152877,0.263
"925","contra costa",925,"2021-04-27",14126,1055223,10417,658514,3558,361423,151,35286,3787,186190,10319,451530,3948,637720,"California",1160099,0.389216782360816,416386,0.716,152877,0.263
"926","contra costa",926,"2021-04-28",13840,1069063,10765,669279,2787,364210,288,35574,3466,179607,10341,461871,3758,641478,"California",1160099,0.398130676778447,416386,0.716,152877,0.263
"927","contra costa",927,"2021-04-29",13000,1082063,10060,679339,2770,366980,170,35744,2831,172470,10143,472014,3006,644484,"California",1160099,0.406873896107143,416386,0.716,152877,0.263
"928","contra costa",928,"2021-04-30",13635,1095698,10755,690094,2630,369610,250,35994,3089,165292,10521,482535,3343,647827,"California",1160099,0.415942949696535,416386,0.716,152877,0.263
"929","contra costa",929,"2021-05-01",8000,1103698,5843,695937,1838,371448,319,36313,1910,161452,6070,488605,2230,650057,"California",1160099,0.421175261766453,416386,0.716,152877,0.263
"930","contra costa",930,"2021-05-02",2319,1106017,1578,697515,662,372110,79,36392,986,161194,1323,489928,1065,651122,"California",1160099,0.422315681678891,416386,0.716,152877,0.263
"931","contra costa",931,"2021-05-03",9119,1115136,8033,705548,920,373030,166,36558,1943,156147,7161,497089,2114,653236,"California",1160099,0.428488430728757,416386,0.716,152877,0.263
"932","contra costa",932,"2021-05-04",14017,1129153,12110,717658,1584,374614,323,36881,2278,147033,11715,508804,2601,655837,"California",1160099,0.438586706824159,416386,0.716,152877,0.263
"933","contra costa",933,"2021-05-05",12491,1141644,10777,728435,1506,376120,208,37089,2406,139588,10059,518863,2614,658451,"California",1160099,0.447257518539366,416386,0.716,152877,0.263
"934","contra costa",934,"2021-05-06",10243,1151887,8505,736940,1397,377517,341,37430,1925,133566,8294,527157,2272,660723,"California",1160099,0.454406908375923,416386,0.716,152877,0.263
"935","contra costa",935,"2021-05-07",9580,1161467,7698,744638,1649,379166,233,37663,2193,128634,7355,534512,2423,663146,"California",1160099,0.46074688453313,416386,0.716,152877,0.263
"936","contra costa",936,"2021-05-08",5238,1166705,3948,748586,1122,380288,168,37831,1216,126019,4001,538513,1386,664532,"California",1160099,0.464195728123203,416386,0.716,152877,0.263
"937","del norte",937,"2020-12-21",23,23,23,23,0,0,0,0,23,23,0,0,23,23,"California",27558,0,4677,0.408,6461,0.564
"938","del norte",938,"2020-12-22",46,69,46,69,0,0,0,0,46,69,0,0,46,69,"California",27558,0,4677,0.408,6461,0.564
"939","del norte",939,"2020-12-23",58,127,48,117,10,10,0,0,56,125,0,0,56,125,"California",27558,0,4677,0.408,6461,0.564
"940","del norte",940,"2020-12-28",34,161,34,151,0,10,0,0,34,159,0,0,34,159,"California",27558,0,4677,0.408,6461,0.564
"941","del norte",941,"2020-12-29",4,165,4,155,0,10,0,0,4,163,0,0,4,163,"California",27558,0,4677,0.408,6461,0.564
"942","del norte",942,"2020-12-30",67,232,55,210,12,22,0,0,68,231,0,0,68,231,"California",27558,0,4677,0.408,6461,0.564
"943","del norte",943,"2020-12-31",16,248,13,223,3,25,0,0,16,247,0,0,16,247,"California",27558,0,4677,0.408,6461,0.564
"944","del norte",944,"2021-01-04",102,350,49,272,53,78,0,0,102,349,0,0,102,349,"California",27558,0,4677,0.408,6461,0.564
"945","del norte",945,"2021-01-05",32,382,0,272,32,110,0,0,32,381,0,0,32,381,"California",27558,0,4677,0.408,6461,0.564
"946","del norte",946,"2021-01-06",77,459,18,290,59,169,0,0,77,458,0,0,77,458,"California",27558,0,4677,0.408,6461,0.564
"947","del norte",947,"2021-01-07",21,480,1,291,20,189,0,0,21,479,0,0,21,479,"California",27558,0,4677,0.408,6461,0.564
"948","del norte",948,"2021-01-08",78,558,7,298,71,260,0,0,78,557,0,0,78,557,"California",27558,0,4677,0.408,6461,0.564
"949","del norte",949,"2021-01-11",40,598,21,319,19,279,0,0,18,554,22,22,19,576,"California",27558,0.000798316278394659,4677,0.408,6461,0.564
"950","del norte",950,"2021-01-12",51,649,32,351,19,298,0,0,30,563,21,43,30,606,"California",27558,0.00156034545322592,4677,0.408,6461,0.564
"951","del norte",951,"2021-01-13",86,735,40,391,46,344,0,0,53,583,33,76,53,659,"California",27558,0.00275781987081791,4677,0.408,6461,0.564
"952","del norte",952,"2021-01-14",52,787,14,405,38,382,0,0,46,623,6,82,46,705,"California",27558,0.00297554249219827,4677,0.408,6461,0.564
"953","del norte",953,"2021-01-15",107,894,18,423,89,471,0,0,95,706,12,94,95,800,"California",27558,0.003410987734959,4677,0.408,6461,0.564
"954","del norte",954,"2021-01-17",1,895,1,424,0,471,0,0,1,707,0,94,1,801,"California",27558,0.003410987734959,4677,0.408,6461,0.564
"955","del norte",955,"2021-01-18",2,897,0,424,2,473,0,0,2,709,0,94,2,803,"California",27558,0.003410987734959,4677,0.408,6461,0.564
"956","del norte",956,"2021-01-19",119,1016,56,480,63,536,0,0,77,744,42,136,77,880,"California",27558,0.00493504608462153,4677,0.408,6461,0.564
"957","del norte",957,"2021-01-20",158,1174,84,564,74,610,0,0,96,778,62,198,96,976,"California",27558,0.00718484650555193,4677,0.408,6461,0.564
"958","del norte",958,"2021-01-21",43,1217,40,604,3,613,0,0,32,799,11,209,32,1008,"California",27558,0.00758400464474926,4677,0.408,6461,0.564
"959","del norte",959,"2021-01-22",20,1237,17,621,3,616,0,0,13,805,7,216,13,1021,"California",27558,0.00783801436969301,4677,0.408,6461,0.564
"960","del norte",960,"2021-01-23",1,1238,0,621,1,617,0,0,1,806,0,216,1,1022,"California",27558,0.00783801436969301,4677,0.408,6461,0.564
"961","del norte",961,"2021-01-24",1,1239,0,621,1,618,0,0,1,807,0,216,1,1023,"California",27558,0.00783801436969301,4677,0.408,6461,0.564
"962","del norte",962,"2021-01-25",100,1339,82,703,18,636,0,0,56,819,44,260,56,1079,"California",27558,0.00943464692648233,4677,0.408,6461,0.564
"963","del norte",963,"2021-01-26",18,1357,11,714,7,643,0,0,7,815,11,271,7,1086,"California",27558,0.00983380506567966,4677,0.408,6461,0.564
"964","del norte",964,"2021-01-27",64,1421,21,735,43,686,0,0,61,873,3,274,61,1147,"California",27558,0.00994266637636984,4677,0.408,6461,0.564
"965","del norte",965,"2021-01-28",291,1712,20,755,271,957,0,0,286,1154,5,279,286,1433,"California",27558,0.0101241018941868,4677,0.408,6461,0.564
"966","del norte",966,"2021-01-29",55,1767,21,776,34,991,0,0,44,1187,11,290,44,1477,"California",27558,0.0105232600333841,4677,0.408,6461,0.564
"967","del norte",967,"2021-01-30",8,1775,1,777,7,998,0,0,8,1195,0,290,8,1485,"California",27558,0.0105232600333841,4677,0.408,6461,0.564
"968","del norte",968,"2021-02-01",41,1816,1,778,40,1038,0,0,26,1206,15,305,26,1511,"California",27558,0.011067566586835,4677,0.408,6461,0.564
"969","del norte",969,"2021-02-02",142,1958,34,812,108,1146,0,0,73,1211,68,373,73,1584,"California",27558,0.0135350896291458,4677,0.408,6461,0.564
"970","del norte",970,"2021-02-03",126,2084,40,852,86,1232,0,0,71,1227,55,428,71,1655,"California",27558,0.0155308803251324,4677,0.408,6461,0.564
"971","del norte",971,"2021-02-04",71,2155,29,881,42,1274,0,0,42,1240,29,457,42,1697,"California",27558,0.0165832063284709,4677,0.408,6461,0.564
"972","del norte",972,"2021-02-05",184,2339,22,903,162,1436,0,0,119,1295,64,521,119,1816,"California",27558,0.018905580956528,4677,0.408,6461,0.564
"973","del norte",973,"2021-02-06",312,2651,6,909,306,1742,0,0,312,1607,0,521,312,2128,"California",27558,0.018905580956528,4677,0.408,6461,0.564
"974","del norte",974,"2021-02-07",2,2653,1,910,1,1743,0,0,2,1609,0,521,2,2130,"California",27558,0.018905580956528,4677,0.408,6461,0.564
"975","del norte",975,"2021-02-08",36,2689,1,911,35,1778,0,0,32,1637,4,525,32,2162,"California",27558,0.0190507293707816,4677,0.408,6461,0.564
"976","del norte",976,"2021-02-09",8,2697,5,916,3,1781,0,0,2,1633,6,531,2,2164,"California",27558,0.019268451992162,4677,0.408,6461,0.564
"977","del norte",977,"2021-02-10",143,2840,20,936,123,1904,0,0,86,1663,56,587,86,2250,"California",27558,0.021300529791712,4677,0.408,6461,0.564
"978","del norte",978,"2021-02-11",177,3017,59,995,118,2022,0,0,64,1614,113,700,64,2314,"California",27558,0.0254009724943755,4677,0.408,6461,0.564
"979","del norte",979,"2021-02-12",121,3138,14,1009,107,2129,0,0,67,1627,54,754,67,2381,"California",27558,0.0273604760867988,4677,0.408,6461,0.564
"980","del norte",980,"2021-02-13",2,3140,1,1010,1,2130,0,0,2,1629,0,754,2,2383,"California",27558,0.0273604760867988,4677,0.408,6461,0.564
"981","del norte",981,"2021-02-14",3,3143,1,1011,2,2132,0,0,2,1630,1,755,2,2385,"California",27558,0.0273967631903621,4677,0.408,6461,0.564
"982","del norte",982,"2021-02-15",4,3147,0,1011,4,2136,0,0,2,1630,2,757,2,2387,"California",27558,0.0274693373974889,4677,0.408,6461,0.564
"983","del norte",983,"2021-02-16",132,3279,1,1012,131,2267,0,0,13,1524,119,876,13,2400,"California",27558,0.0317875027215328,4677,0.408,6461,0.564
"984","del norte",984,"2021-02-17",91,3370,20,1032,71,2338,0,0,24,1481,67,943,24,2424,"California",27558,0.0342187386602801,4677,0.408,6461,0.564
"985","del norte",985,"2021-02-18",77,3447,24,1056,53,2391,0,0,51,1506,26,969,51,2475,"California",27558,0.0351622033529284,4677,0.408,6461,0.564
"986","del norte",986,"2021-02-19",43,3490,17,1073,26,2417,0,0,33,1529,10,979,33,2508,"California",27558,0.0355250743885623,4677,0.408,6461,0.564
"987","del norte",987,"2021-02-20",8,3498,5,1078,3,2420,0,0,6,1533,2,981,6,2514,"California",27558,0.0355976485956891,4677,0.408,6461,0.564
"988","del norte",988,"2021-02-22",2,3500,0,1078,2,2422,0,0,2,1535,0,981,2,2516,"California",27558,0.0355976485956891,4677,0.408,6461,0.564
"989","del norte",989,"2021-02-23",107,3607,89,1167,18,2440,0,0,31,1491,76,1057,32,2548,"California",27558,0.038355468466507,4677,0.408,6461,0.564
"990","del norte",990,"2021-02-24",152,3759,98,1265,54,2494,0,0,79,1497,73,1130,79,2627,"California",27558,0.0410044270266347,4677,0.408,6461,0.564
"991","del norte",991,"2021-02-25",476,4235,131,1396,345,2839,0,0,213,1449,261,1391,213,2840,"California",27558,0.0504753610566805,4677,0.408,6461,0.564
"992","del norte",992,"2021-02-26",213,4448,176,1572,37,2876,0,0,167,1570,46,1437,167,3007,"California",27558,0.0521445678205966,4677,0.408,6461,0.564
"993","del norte",993,"2021-02-27",152,4600,145,1717,6,2882,1,1,141,1701,11,1448,142,3149,"California",27558,0.0525437259597939,4677,0.408,6461,0.564
"994","del norte",994,"2021-02-28",4,4604,1,1718,3,2885,0,1,3,1703,1,1449,3,3152,"California",27558,0.0525800130633573,4677,0.408,6461,0.564
"995","del norte",995,"2021-03-01",28,4632,2,1720,26,2911,0,1,4,1683,24,1473,4,3156,"California",27558,0.0534509035488787,4677,0.408,6461,0.564
"996","del norte",996,"2021-03-02",220,4852,141,1861,79,2990,0,1,187,1837,33,1506,187,3343,"California",27558,0.0546483779664707,4677,0.408,6461,0.564
"997","del norte",997,"2021-03-03",167,5019,99,1960,68,3058,0,1,126,1922,41,1547,126,3469,"California",27558,0.0561361492125699,4677,0.408,6461,0.564
"998","del norte",998,"2021-03-04",120,5139,83,2043,37,3095,0,1,91,1985,28,1575,91,3560,"California",27558,0.0571521881123449,4677,0.408,6461,0.564
"999","del norte",999,"2021-03-05",120,5259,10,2053,110,3205,0,1,72,2009,48,1623,72,3632,"California",27558,0.0588939690833878,4677,0.408,6461,0.564
"1000","del norte",1000,"2021-03-06",466,5725,78,2131,338,3543,50,51,164,1878,302,1925,171,3803,"California",27558,0.0698526743595326,4677,0.408,6461,0.564
"1001","del norte",1001,"2021-03-07",2,5727,1,2132,1,3544,0,51,1,1878,1,1926,1,3804,"California",27558,0.069888961463096,4677,0.408,6461,0.564
"1002","del norte",1002,"2021-03-08",28,5755,1,2133,25,3569,2,53,5,1862,23,1949,7,3811,"California",27558,0.0707235648450541,4677,0.408,6461,0.564
"1003","del norte",1003,"2021-03-09",193,5948,112,2245,78,3647,3,56,182,2036,11,1960,185,3996,"California",27558,0.0711227229842514,4677,0.408,6461,0.564
"1004","del norte",1004,"2021-03-10",233,6181,96,2341,109,3756,28,84,134,2099,99,2059,162,4158,"California",27558,0.0747151462370274,4677,0.408,6461,0.564
"1005","del norte",1005,"2021-03-11",151,6332,55,2396,91,3847,5,89,103,2159,48,2107,108,4266,"California",27558,0.0764569272080702,4677,0.408,6461,0.564
"1006","del norte",1006,"2021-03-12",178,6510,89,2485,89,3936,0,89,125,2231,53,2160,125,4391,"California",27558,0.0783801436969301,4677,0.408,6461,0.564
"1007","del norte",1007,"2021-03-13",94,6604,93,2578,1,3937,0,89,91,2319,3,2163,91,4482,"California",27558,0.0784890050076203,4677,0.408,6461,0.564
"1008","del norte",1008,"2021-03-14",1,6605,0,2578,1,3938,0,89,1,2319,1,2164,1,4483,"California",27558,0.0785252921111837,4677,0.408,6461,0.564
"1009","del norte",1009,"2021-03-15",38,6643,0,2578,38,3976,0,89,34,2349,4,2168,34,4517,"California",27558,0.0786704405254373,4677,0.408,6461,0.564
"1010","del norte",1010,"2021-03-16",281,6924,135,2713,146,4122,0,89,260,2588,21,2189,260,4777,"California",27558,0.0794324697002685,4677,0.408,6461,0.564
"1011","del norte",1011,"2021-03-17",283,7207,95,2808,186,4308,2,91,169,2645,114,2303,171,4948,"California",27558,0.0835691995064954,4677,0.408,6461,0.564
"1012","del norte",1012,"2021-03-18",285,7492,107,2915,175,4483,3,94,149,2662,135,2438,152,5100,"California",27558,0.0884679584875535,4677,0.408,6461,0.564
"1013","del norte",1013,"2021-03-19",266,7758,159,3074,101,4584,6,100,91,2584,175,2613,97,5197,"California",27558,0.0948182016111474,4677,0.408,6461,0.564
"1014","del norte",1014,"2021-03-20",157,7915,154,3228,3,4587,0,100,15,2457,142,2755,15,5212,"California",27558,0.0999709703171493,4677,0.408,6461,0.564
"1015","del norte",1015,"2021-03-21",4,7919,2,3230,2,4589,0,100,2,2457,2,2757,2,5214,"California",27558,0.100043544524276,4677,0.408,6461,0.564
"1016","del norte",1016,"2021-03-22",43,7962,3,3233,39,4628,1,101,39,2494,3,2760,40,5254,"California",27558,0.100152405834966,4677,0.408,6461,0.564
"1017","del norte",1017,"2021-03-23",335,8297,164,3397,153,4781,18,119,165,2508,168,2928,182,5436,"California",27558,0.106248639233616,4677,0.408,6461,0.564
"1018","del norte",1018,"2021-03-24",397,8694,107,3504,249,5030,41,160,236,2624,161,3089,277,5713,"California",27558,0.112090862907323,4677,0.408,6461,0.564
"1019","del norte",1019,"2021-03-25",192,8886,89,3593,103,5133,0,160,84,2601,107,3196,84,5797,"California",27558,0.115973582988606,4677,0.408,6461,0.564
"1020","del norte",1020,"2021-03-26",232,9118,112,3705,120,5253,0,160,197,2763,35,3231,197,5994,"California",27558,0.117243631613325,4677,0.408,6461,0.564
"1021","del norte",1021,"2021-03-27",108,9226,87,3792,4,5257,17,177,17,2706,91,3322,34,6028,"California",27558,0.120545758037593,4677,0.408,6461,0.564
"1022","del norte",1022,"2021-03-28",4,9230,2,3794,2,5259,0,177,1,2704,3,3325,1,6029,"California",27558,0.120654619348284,4677,0.408,6461,0.564
"1023","del norte",1023,"2021-03-29",57,9287,6,3800,34,5293,17,194,32,2728,25,3350,49,6078,"California",27558,0.121561796937368,4677,0.408,6461,0.564
"1024","del norte",1024,"2021-03-30",339,9626,118,3918,210,5503,11,205,128,2656,211,3561,139,6217,"California",27558,0.129218375789244,4677,0.408,6461,0.564
"1025","del norte",1025,"2021-03-31",353,9979,100,4018,236,5739,17,222,198,2718,153,3714,215,6432,"California",27558,0.134770302634444,4677,0.408,6461,0.564
"1026","del norte",1026,"2021-04-01",164,10143,58,4076,72,5811,34,256,69,2727,94,3808,103,6535,"California",27558,0.138181290369403,4677,0.408,6461,0.564
"1027","del norte",1027,"2021-04-02",230,10373,78,4154,103,5914,49,305,47,2641,183,3991,97,6632,"California",27558,0.144821830321504,4677,0.408,6461,0.564
"1028","del norte",1028,"2021-04-03",106,10479,82,4236,2,5916,22,327,4,2566,101,4092,26,6658,"California",27558,0.148486827781406,4677,0.408,6461,0.564
"1029","del norte",1029,"2021-04-04",4,10483,0,4236,0,5916,4,331,0,2566,4,4096,4,6662,"California",27558,0.14863197619566,4677,0.408,6461,0.564
"1030","del norte",1030,"2021-04-05",46,10529,5,4241,37,5953,4,335,39,2602,7,4103,43,6705,"California",27558,0.148885985920604,4677,0.408,6461,0.564
"1031","del norte",1031,"2021-04-06",378,10907,119,4360,222,6175,37,372,145,2556,229,4332,183,6888,"California",27558,0.157195732636621,4677,0.408,6461,0.564
"1032","del norte",1032,"2021-04-07",430,11337,114,4474,255,6430,61,433,283,2754,146,4478,344,7232,"California",27558,0.162493649756876,4677,0.408,6461,0.564
"1033","del norte",1033,"2021-04-08",233,11570,54,4528,111,6541,68,501,111,2811,122,4600,179,7411,"California",27558,0.16692067639161,4677,0.408,6461,0.564
"1034","del norte",1034,"2021-04-09",205,11775,47,4575,81,6622,77,578,98,2878,106,4706,173,7584,"California",27558,0.17076710936933,4677,0.408,6461,0.564
"1035","del norte",1035,"2021-04-10",47,11822,26,4601,4,6626,17,595,27,2902,20,4726,44,7628,"California",27558,0.171492851440598,4677,0.408,6461,0.564
"1036","del norte",1036,"2021-04-11",12,11834,3,4604,2,6628,7,602,2,2901,10,4736,9,7637,"California",27558,0.171855722476232,4677,0.408,6461,0.564
"1037","del norte",1037,"2021-04-12",28,11862,1,4605,9,6637,18,620,1,2894,26,4762,19,7656,"California",27558,0.17279918716888,4677,0.408,6461,0.564
"1038","del norte",1038,"2021-04-13",297,12159,49,4654,248,6885,0,620,154,2905,143,4905,154,7810,"California",27558,0.177988242978445,4677,0.408,6461,0.564
"1039","del norte",1039,"2021-04-14",327,12486,23,4677,304,7189,0,620,137,2857,190,5095,142,7952,"California",27558,0.18488279265549,4677,0.408,6461,0.564
"1040","del norte",1040,"2021-04-15",163,12649,30,4707,133,7322,0,620,44,2783,119,5214,45,7997,"California",27558,0.189200957979534,4677,0.408,6461,0.564
"1041","del norte",1041,"2021-04-16",160,12809,39,4746,121,7443,0,620,58,2740,102,5316,59,8056,"California",27558,0.192902242543,4677,0.408,6461,0.564
"1042","del norte",1042,"2021-04-17",102,12911,70,4816,32,7475,0,620,97,2832,5,5321,97,8153,"California",27558,0.193083678060817,4677,0.408,6461,0.564
"1043","del norte",1043,"2021-04-18",5,12916,4,4820,1,7476,0,620,4,2835,1,5322,4,8157,"California",27558,0.193119965164381,4677,0.408,6461,0.564
"1044","del norte",1044,"2021-04-19",50,12966,6,4826,44,7520,0,620,8,2801,42,5364,8,8165,"California",27558,0.194644023514043,4677,0.408,6461,0.564
"1045","del norte",1045,"2021-04-20",209,13175,40,4866,169,7689,0,620,74,2740,135,5499,74,8239,"California",27558,0.199542782495101,4677,0.408,6461,0.564
"1046","del norte",1046,"2021-04-21",287,13462,22,4888,265,7954,0,620,63,2582,224,5723,66,8305,"California",27558,0.207671093693301,4677,0.408,6461,0.564
"1047","del norte",1047,"2021-04-22",114,13576,15,4903,99,8053,0,620,62,2592,52,5775,62,8367,"California",27558,0.209558023078598,4677,0.408,6461,0.564
"1048","del norte",1048,"2021-04-23",152,13728,21,4924,131,8184,0,620,40,2520,112,5887,40,8407,"California",27558,0.213622178677698,4677,0.408,6461,0.564
"1049","del norte",1049,"2021-04-24",25,13753,14,4938,11,8195,0,620,20,2535,5,5892,20,8427,"California",27558,0.213803614195515,4677,0.408,6461,0.564
"1050","del norte",1050,"2021-04-25",2,13755,0,4938,2,8197,0,620,2,2537,0,5892,2,8429,"California",27558,0.213803614195515,4677,0.408,6461,0.564
"1051","del norte",1051,"2021-04-26",29,13784,0,4938,29,8226,0,620,7,2522,22,5914,7,8436,"California",27558,0.21460193047391,4677,0.408,6461,0.564
"1052","del norte",1052,"2021-04-27",175,13959,19,4957,151,8377,5,625,49,2450,126,6040,54,8490,"California",27558,0.219174105522897,4677,0.408,6461,0.564
"1053","del norte",1053,"2021-04-28",352,14311,101,5058,246,8623,5,630,63,2232,287,6327,69,8559,"California",27558,0.229588504245591,4677,0.408,6461,0.564
"1054","del norte",1054,"2021-04-29",92,14403,5,5063,83,8706,4,634,26,2196,66,6393,30,8589,"California",27558,0.231983453080775,4677,0.408,6461,0.564
"1055","del norte",1055,"2021-04-30",83,14486,6,5069,67,8773,10,644,44,2211,39,6432,54,8643,"California",27558,0.233398650119747,4677,0.408,6461,0.564
"1056","del norte",1056,"2021-05-01",8,14494,3,5072,5,8778,0,644,6,2215,2,6434,6,8649,"California",27558,0.233471224326874,4677,0.408,6461,0.564
"1057","del norte",1057,"2021-05-02",8,14502,0,5072,8,8786,0,644,8,2223,0,6434,8,8657,"California",27558,0.233471224326874,4677,0.408,6461,0.564
"1058","del norte",1058,"2021-05-03",40,14542,3,5075,34,8820,3,647,2,2191,37,6471,5,8662,"California",27558,0.23481384715872,4677,0.408,6461,0.564
"1059","del norte",1059,"2021-05-04",218,14760,36,5111,177,8997,5,652,44,2066,174,6645,49,8711,"California",27558,0.24112780317875,4677,0.408,6461,0.564
"1060","del norte",1060,"2021-05-05",232,14992,19,5130,205,9202,8,660,58,1961,174,6819,69,8780,"California",27558,0.247441759198781,4677,0.408,6461,0.564
"1061","del norte",1061,"2021-05-06",114,15106,24,5154,77,9279,13,673,30,1920,84,6903,43,8823,"California",27558,0.250489875898106,4677,0.408,6461,0.564
"1062","del norte",1062,"2021-05-07",141,15247,26,5180,111,9390,4,677,29,1841,112,7015,33,8856,"California",27558,0.254554031497206,4677,0.408,6461,0.564
"1063","del norte",1063,"2021-05-08",66,15313,56,5236,8,9398,2,679,9,1795,57,7072,11,8867,"California",27558,0.256622396400319,4677,0.408,6461,0.564
"1064","el dorado",1064,"2020-12-15",12,12,12,12,0,0,0,0,12,12,0,0,12,12,"California",193098,0,51621,0.444,61838,0.532
"1065","el dorado",1065,"2020-12-16",40,52,40,52,0,0,0,0,40,52,0,0,40,52,"California",193098,0,51621,0.444,61838,0.532
"1066","el dorado",1066,"2020-12-17",31,83,31,83,0,0,0,0,31,83,0,0,31,83,"California",193098,0,51621,0.444,61838,0.532
"1067","el dorado",1067,"2020-12-18",236,319,236,319,0,0,0,0,236,319,0,0,236,319,"California",193098,0,51621,0.444,61838,0.532
"1068","el dorado",1068,"2020-12-19",116,435,116,435,0,0,0,0,116,435,0,0,116,435,"California",193098,0,51621,0.444,61838,0.532
"1069","el dorado",1069,"2020-12-20",85,520,85,520,0,0,0,0,85,520,0,0,85,520,"California",193098,0,51621,0.444,61838,0.532
"1070","el dorado",1070,"2020-12-21",309,829,308,828,1,1,0,0,309,829,0,0,309,829,"California",193098,0,51621,0.444,61838,0.532
"1071","el dorado",1071,"2020-12-22",238,1067,214,1042,24,25,0,0,238,1067,0,0,238,1067,"California",193098,0,51621,0.444,61838,0.532
"1072","el dorado",1072,"2020-12-23",189,1256,140,1182,49,74,0,0,189,1256,0,0,189,1256,"California",193098,0,51621,0.444,61838,0.532
"1073","el dorado",1073,"2020-12-24",87,1343,66,1248,21,95,0,0,87,1343,0,0,87,1343,"California",193098,0,51621,0.444,61838,0.532
"1074","el dorado",1074,"2020-12-25",8,1351,8,1256,0,95,0,0,8,1351,0,0,8,1351,"California",193098,0,51621,0.444,61838,0.532
"1075","el dorado",1075,"2020-12-26",44,1395,26,1282,18,113,0,0,44,1395,0,0,44,1395,"California",193098,0,51621,0.444,61838,0.532
"1076","el dorado",1076,"2020-12-27",37,1432,33,1315,4,117,0,0,37,1432,0,0,37,1432,"California",193098,0,51621,0.444,61838,0.532
"1077","el dorado",1077,"2020-12-28",215,1647,168,1483,47,164,0,0,215,1647,0,0,215,1647,"California",193098,0,51621,0.444,61838,0.532
"1078","el dorado",1078,"2020-12-29",459,2106,142,1625,317,481,0,0,459,2106,0,0,459,2106,"California",193098,0,51621,0.444,61838,0.532
"1079","el dorado",1079,"2020-12-30",507,2613,136,1761,371,852,0,0,507,2613,0,0,507,2613,"California",193098,0,51621,0.444,61838,0.532
"1080","el dorado",1080,"2020-12-31",110,2723,70,1831,40,892,0,0,110,2723,0,0,110,2723,"California",193098,0,51621,0.444,61838,0.532
"1081","el dorado",1081,"2021-01-01",7,2730,4,1835,3,895,0,0,7,2730,0,0,7,2730,"California",193098,0,51621,0.444,61838,0.532
"1082","el dorado",1082,"2021-01-02",153,2883,141,1976,12,907,0,0,153,2883,0,0,153,2883,"California",193098,0,51621,0.444,61838,0.532
"1083","el dorado",1083,"2021-01-03",92,2975,17,1993,75,982,0,0,92,2975,0,0,92,2975,"California",193098,0,51621,0.444,61838,0.532
"1084","el dorado",1084,"2021-01-04",189,3164,62,2055,127,1109,0,0,189,3164,0,0,189,3164,"California",193098,0,51621,0.444,61838,0.532
"1085","el dorado",1085,"2021-01-05",207,3371,51,2106,156,1265,0,0,191,3339,16,16,191,3355,"California",193098,8.28594806782049e-05,51621,0.444,61838,0.532
"1086","el dorado",1086,"2021-01-06",261,3632,189,2295,72,1337,0,0,197,3472,64,80,197,3552,"California",193098,0.000414297403391024,51621,0.444,61838,0.532
"1087","el dorado",1087,"2021-01-07",330,3962,136,2431,194,1531,0,0,259,3660,71,151,259,3811,"California",193098,0.000781986348900558,51621,0.444,61838,0.532
"1088","el dorado",1088,"2021-01-08",976,4938,501,2932,475,2006,0,0,773,4231,203,354,774,4585,"California",193098,0.00183326601000528,51621,0.444,61838,0.532
"1089","el dorado",1089,"2021-01-09",194,5132,157,3089,37,2043,0,0,126,4289,68,422,126,4711,"California",193098,0.00218541880288765,51621,0.444,61838,0.532
"1090","el dorado",1090,"2021-01-10",180,5312,129,3218,51,2094,0,0,110,4330,70,492,111,4822,"California",193098,0.0025479290308548,51621,0.444,61838,0.532
"1091","el dorado",1091,"2021-01-11",659,5971,293,3511,366,2460,0,0,459,4591,199,691,460,5282,"California",193098,0.00357849382178997,51621,0.444,61838,0.532
"1092","el dorado",1092,"2021-01-12",696,6667,422,3933,274,2734,0,0,447,4789,249,940,447,5729,"California",193098,0.00486799448984454,51621,0.444,61838,0.532
"1093","el dorado",1093,"2021-01-13",701,7368,296,4229,405,3139,0,0,540,5168,161,1101,540,6269,"California",193098,0.00570176801416897,51621,0.444,61838,0.532
"1094","el dorado",1094,"2021-01-14",693,8061,219,4448,474,3613,0,0,598,5671,95,1196,598,6867,"California",193098,0.00619374618069581,51621,0.444,61838,0.532
"1095","el dorado",1095,"2021-01-15",684,8745,185,4633,499,4112,0,0,612,6211,72,1268,612,7479,"California",193098,0.00656661384374773,51621,0.444,61838,0.532
"1096","el dorado",1096,"2021-01-16",173,8918,104,4737,69,4181,0,0,146,6330,27,1295,146,7625,"California",193098,0.0067064392173922,51621,0.444,61838,0.532
"1097","el dorado",1097,"2021-01-17",100,9018,47,4784,53,4234,0,0,83,6396,17,1312,83,7708,"California",193098,0.0067944774156128,51621,0.444,61838,0.532
"1098","el dorado",1098,"2021-01-18",421,9439,138,4922,283,4517,0,0,353,6681,68,1380,353,8061,"California",193098,0.00714663020849517,51621,0.444,61838,0.532
"1099","el dorado",1099,"2021-01-19",654,10093,354,5276,300,4817,0,0,504,7036,150,1530,505,8566,"California",193098,0.00792343783985334,51621,0.444,61838,0.532
"1100","el dorado",1100,"2021-01-20",1011,11104,686,5962,325,5142,0,0,900,7826,110,1640,900,9466,"California",193098,0.008493096769516,51621,0.444,61838,0.532
"1101","el dorado",1101,"2021-01-21",1162,12266,577,6539,585,5727,0,0,955,8615,166,1806,955,10421,"California",193098,0.00935276388155237,51621,0.444,61838,0.532
"1102","el dorado",1102,"2021-01-22",1104,13370,712,7251,392,6119,0,0,1050,9612,53,1859,1050,11471,"California",193098,0.00962723591129893,51621,0.444,61838,0.532
"1103","el dorado",1103,"2021-01-23",737,14107,617,7868,120,6239,0,0,626,10127,111,1970,626,12097,"California",193098,0.010202073558504,51621,0.444,61838,0.532
"1104","el dorado",1104,"2021-01-24",126,14233,76,7944,50,6289,0,0,107,10215,19,1989,107,12204,"California",193098,0.0103004691918093,51621,0.444,61838,0.532
"1105","el dorado",1105,"2021-01-25",612,14845,206,8150,406,6695,0,0,524,10651,88,2077,524,12728,"California",193098,0.0107561963355395,51621,0.444,61838,0.532
"1106","el dorado",1106,"2021-01-26",676,15521,365,8515,311,7006,0,0,571,11118,105,2182,572,13300,"California",193098,0.0112999616774902,51621,0.444,61838,0.532
"1107","el dorado",1107,"2021-01-27",981,16502,382,8897,599,7605,0,0,644,11424,338,2520,644,13944,"California",193098,0.0130503682068173,51621,0.444,61838,0.532
"1108","el dorado",1108,"2021-01-28",1106,17608,453,9350,653,8258,0,0,745,11808,361,2881,745,14689,"California",193098,0.0149198852396193,51621,0.444,61838,0.532
"1109","el dorado",1109,"2021-01-29",976,18584,490,9840,486,8744,0,0,746,12326,229,3110,747,15436,"California",193098,0.0161058115568261,51621,0.444,61838,0.532
"1110","el dorado",1110,"2021-01-30",610,19194,359,10199,251,8995,0,0,450,12616,160,3270,450,15886,"California",193098,0.0169344063636081,51621,0.444,61838,0.532
"1111","el dorado",1111,"2021-01-31",209,19403,188,10387,21,9016,0,0,180,12767,29,3299,180,16066,"California",193098,0.0170845891723374,51621,0.444,61838,0.532
"1112","el dorado",1112,"2021-02-01",799,20202,368,10755,431,9447,0,0,655,13279,143,3442,655,16721,"California",193098,0.0178251457808988,51621,0.444,61838,0.532
"1113","el dorado",1113,"2021-02-02",837,21039,367,11122,470,9917,0,0,676,13794,161,3603,676,17397,"California",193098,0.0186589193052233,51621,0.444,61838,0.532
"1114","el dorado",1114,"2021-02-03",900,21939,476,11598,424,10341,0,0,687,14268,213,3816,687,18084,"California",193098,0.0197619861417519,51621,0.444,61838,0.532
"1115","el dorado",1115,"2021-02-04",1267,23206,723,12321,544,10885,0,0,871,14744,395,4211,871,18955,"California",193098,0.021807579570995,51621,0.444,61838,0.532
"1116","el dorado",1116,"2021-02-05",1484,24690,598,12919,886,11771,0,0,868,15031,581,4792,868,19823,"California",193098,0.0248164144631224,51621,0.444,61838,0.532
"1117","el dorado",1117,"2021-02-06",639,25329,334,13253,305,12076,0,0,530,15453,109,4901,531,20354,"California",193098,0.0253808946752426,51621,0.444,61838,0.532
"1118","el dorado",1118,"2021-02-07",257,25586,177,13430,80,12156,0,0,193,15582,64,4965,193,20547,"California",193098,0.0257123325979554,51621,0.444,61838,0.532
"1119","el dorado",1119,"2021-02-08",882,26468,417,13847,465,12621,0,0,608,15916,274,5239,608,21155,"California",193098,0.0271313012045697,51621,0.444,61838,0.532
"1120","el dorado",1120,"2021-02-09",909,27377,487,14334,422,13043,0,0,487,15981,422,5661,487,21642,"California",193098,0.0293167200074574,51621,0.444,61838,0.532
"1121","el dorado",1121,"2021-02-10",1247,28624,727,15061,520,13563,0,0,655,16045,591,6252,655,22297,"California",193098,0.0323773420750085,51621,0.444,61838,0.532
"1122","el dorado",1122,"2021-02-11",2154,30778,891,15952,1263,14826,0,0,961,15817,1190,7442,962,23259,"California",193098,0.03854001595045,51621,0.444,61838,0.532
"1123","el dorado",1123,"2021-02-12",1573,32351,826,16778,747,15573,0,0,679,15604,893,8335,680,23939,"California",193098,0.0431646107158023,51621,0.444,61838,0.532
"1124","el dorado",1124,"2021-02-13",978,33329,669,17447,309,15882,0,0,434,15497,541,8876,434,24373,"California",193098,0.0459662969062341,51621,0.444,61838,0.532
"1125","el dorado",1125,"2021-02-14",484,33813,154,17601,330,16212,0,0,398,15809,86,8962,398,24771,"California",193098,0.0464116666148795,51621,0.444,61838,0.532
"1126","el dorado",1126,"2021-02-15",1184,34997,387,17988,797,17009,0,0,824,16276,360,9322,827,25598,"California",193098,0.0482760049301391,51621,0.444,61838,0.532
"1127","el dorado",1127,"2021-02-16",1202,36199,530,18518,672,17681,0,0,677,16430,524,9846,678,26276,"California",193098,0.0509896529223503,51621,0.444,61838,0.532
"1128","el dorado",1128,"2021-02-17",906,37105,375,18893,531,18212,0,0,419,16364,487,10333,421,26697,"California",193098,0.0535116883654932,51621,0.444,61838,0.532
"1129","el dorado",1129,"2021-02-18",2085,39190,1012,19905,1073,19285,0,0,1346,16972,738,11071,1346,28043,"California",193098,0.0573335819117754,51621,0.444,61838,0.532
"1130","el dorado",1130,"2021-02-19",1169,40359,605,20510,564,19849,0,0,649,17102,519,11590,649,28692,"California",193098,0.0600213363162746,51621,0.444,61838,0.532
"1131","el dorado",1131,"2021-02-20",921,41280,438,20948,483,20332,0,0,672,17531,243,11833,672,29364,"California",193098,0.0612797646790749,51621,0.444,61838,0.532
"1132","el dorado",1132,"2021-02-21",282,41562,225,21173,57,20389,0,0,99,17448,182,12015,99,29463,"California",193098,0.0622222912717895,51621,0.444,61838,0.532
"1133","el dorado",1133,"2021-02-22",869,42431,435,21608,434,20823,0,0,283,17146,585,12600,283,29746,"California",193098,0.0652518410340863,51621,0.444,61838,0.532
"1134","el dorado",1134,"2021-02-23",845,43276,473,22081,372,21195,0,0,348,16998,496,13096,348,30094,"California",193098,0.0678204849351107,51621,0.444,61838,0.532
"1135","el dorado",1135,"2021-02-24",1028,44304,439,22520,589,21784,0,0,429,16829,599,13695,430,30524,"California",193098,0.070922536743001,51621,0.444,61838,0.532
"1136","el dorado",1136,"2021-02-25",1648,45952,898,23418,750,22534,0,0,716,16621,926,14621,718,31242,"California",193098,0.0757180291872521,51621,0.444,61838,0.532
"1137","el dorado",1137,"2021-02-26",2354,48306,1482,24900,872,23406,0,0,1589,17447,763,15384,1589,32831,"California",193098,0.079669390672094,51621,0.444,61838,0.532
"1138","el dorado",1138,"2021-02-27",1659,49965,439,25339,1220,24626,0,0,1220,18231,436,15820,1220,34051,"California",193098,0.081927311520575,51621,0.444,61838,0.532
"1139","el dorado",1139,"2021-02-28",589,50554,203,25542,386,25012,0,0,437,18517,152,15972,438,34489,"California",193098,0.082714476587018,51621,0.444,61838,0.532
"1140","el dorado",1140,"2021-03-01",1141,51695,453,25995,687,25699,1,1,628,18634,512,16484,629,35118,"California",193098,0.0853659799687205,51621,0.444,61838,0.532
"1141","el dorado",1141,"2021-03-02",900,52595,266,26261,634,26333,0,1,461,18658,437,16921,461,35579,"California",193098,0.087629079534744,51621,0.444,61838,0.532
"1142","el dorado",1142,"2021-03-03",1680,54275,463,26724,1217,27550,0,1,1153,19293,520,17441,1155,36734,"California",193098,0.0903220126567857,51621,0.444,61838,0.532
"1143","el dorado",1143,"2021-03-04",2514,56789,1551,28275,963,28513,0,1,1221,19224,1290,18731,1221,37955,"California",193098,0.0970025582864659,51621,0.444,61838,0.532
"1144","el dorado",1144,"2021-03-05",1575,58364,422,28697,1148,29661,5,6,1042,19743,528,19259,1047,39002,"California",193098,0.0997369211488467,51621,0.444,61838,0.532
"1145","el dorado",1145,"2021-03-06",740,59104,211,28908,494,30155,35,41,392,19822,348,19607,427,39429,"California",193098,0.101539114853598,51621,0.444,61838,0.532
"1146","el dorado",1146,"2021-03-07",406,59510,198,29106,190,30345,18,59,242,19920,162,19769,260,39689,"California",193098,0.102378067095464,51621,0.444,61838,0.532
"1147","el dorado",1147,"2021-03-08",1327,60837,364,29470,891,31236,72,131,857,20381,467,20236,928,40617,"California",193098,0.10479652818776,51621,0.444,61838,0.532
"1148","el dorado",1148,"2021-03-09",979,61816,225,29695,687,31923,67,198,580,20644,384,20620,647,41264,"California",193098,0.106785155724037,51621,0.444,61838,0.532
"1149","el dorado",1149,"2021-03-10",947,62763,344,30039,547,32470,56,254,547,20852,394,21014,602,41866,"California",193098,0.108825570435737,51621,0.444,61838,0.532
"1150","el dorado",1150,"2021-03-11",3019,65782,1833,31872,1004,33474,182,436,1376,20785,1624,22638,1557,43423,"California",193098,0.117235807724575,51621,0.444,61838,0.532
"1151","el dorado",1151,"2021-03-12",1780,67562,620,32492,914,34388,246,682,743,20754,1020,23658,989,44412,"California",193098,0.122518099617811,51621,0.444,61838,0.532
"1152","el dorado",1152,"2021-03-13",1063,68625,344,32836,436,34824,283,965,374,20723,686,24344,655,45067,"California",193098,0.126070699851889,51621,0.444,61838,0.532
"1153","el dorado",1153,"2021-03-14",793,69418,208,33044,473,35297,112,1077,280,20602,513,24857,392,45459,"California",193098,0.128727381951134,51621,0.444,61838,0.532
"1154","el dorado",1154,"2021-03-15",1403,70821,303,33347,974,36271,126,1203,614,20558,785,25642,741,46200,"California",193098,0.132792675221908,51621,0.444,61838,0.532
"1155","el dorado",1155,"2021-03-16",1214,72035,407,33754,663,36934,144,1347,571,20636,637,26279,715,46915,"California",193098,0.136091518296409,51621,0.444,61838,0.532
"1156","el dorado",1156,"2021-03-17",1112,73147,351,34105,667,37601,94,1441,726,21070,386,26665,820,47735,"California",193098,0.138090503267771,51621,0.444,61838,0.532
"1157","el dorado",1157,"2021-03-18",2994,76141,1772,35877,1177,38778,45,1486,1993,22115,993,27658,2038,49773,"California",193098,0.143232969787362,51621,0.444,61838,0.532
"1158","el dorado",1158,"2021-03-19",1114,77255,364,36241,606,39384,144,1630,639,22423,475,28133,783,50556,"California",193098,0.145692860619996,51621,0.444,61838,0.532
"1159","el dorado",1159,"2021-03-20",945,78200,268,36509,660,40044,17,1647,367,22240,567,28700,384,50940,"California",193098,0.14862919346653,51621,0.444,61838,0.532
"1160","el dorado",1160,"2021-03-21",1026,79226,419,36928,602,40646,5,1652,936,23093,88,28788,941,51881,"California",193098,0.14908492061026,51621,0.444,61838,0.532
"1161","el dorado",1161,"2021-03-22",1502,80728,489,37417,930,41576,83,1735,1190,24059,307,29095,1273,53154,"California",193098,0.150674786895773,51621,0.444,61838,0.532
"1162","el dorado",1162,"2021-03-23",1144,81872,449,37866,602,42178,93,1828,733,24485,400,29495,826,53980,"California",193098,0.152746273912728,51621,0.444,61838,0.532
"1163","el dorado",1163,"2021-03-24",1452,83324,620,38486,636,42814,196,2024,660,24577,764,30259,856,54836,"California",193098,0.156702814115113,51621,0.444,61838,0.532
"1164","el dorado",1164,"2021-03-25",2505,85829,1683,40169,719,43533,103,2127,1382,24945,1117,31376,1485,56321,"California",193098,0.16248744160996,51621,0.444,61838,0.532
"1165","el dorado",1165,"2021-03-26",1820,87649,697,40866,1013,44546,110,2237,950,25157,849,32225,1061,57382,"California",193098,0.166884172803447,51621,0.444,61838,0.532
"1166","el dorado",1166,"2021-03-27",1316,88965,189,41055,1123,45669,4,2241,335,24521,975,33200,339,57721,"California",193098,0.171933422407275,51621,0.444,61838,0.532
"1167","el dorado",1167,"2021-03-28",632,89597,182,41237,441,46110,9,2250,203,24307,426,33626,212,57933,"California",193098,0.174139556080332,51621,0.444,61838,0.532
"1168","el dorado",1168,"2021-03-29",1315,90912,431,41668,868,46978,16,2266,825,24661,487,34113,841,58774,"California",193098,0.176661591523475,51621,0.444,61838,0.532
"1169","el dorado",1169,"2021-03-30",1360,92272,411,42079,857,47835,92,2358,704,24807,649,34762,795,59569,"California",193098,0.180022579208485,51621,0.444,61838,0.532
"1170","el dorado",1170,"2021-03-31",1559,93831,582,42661,914,48749,63,2421,703,24717,854,35616,764,60333,"California",193098,0.184445203989684,51621,0.444,61838,0.532
"1171","el dorado",1171,"2021-04-01",3221,97052,1761,44422,1378,50127,82,2503,1531,24644,1688,37304,1615,61948,"California",193098,0.193186879201235,51621,0.444,61838,0.532
"1172","el dorado",1172,"2021-04-02",1882,98934,560,44982,1227,51354,95,2598,754,24368,1125,38429,849,62797,"California",193098,0.199012936436421,51621,0.444,61838,0.532
"1173","el dorado",1173,"2021-04-03",746,99680,292,45274,333,51687,121,2719,227,24198,517,38946,347,63144,"California",193098,0.201690333405835,51621,0.444,61838,0.532
"1174","el dorado",1174,"2021-04-04",270,99950,85,45359,138,51825,47,2766,97,24170,172,39118,144,63288,"California",193098,0.202581072823126,51621,0.444,61838,0.532
"1175","el dorado",1175,"2021-04-05",1425,101375,425,45784,906,52731,94,2860,595,24033,825,39943,688,63976,"California",193098,0.206853514795596,51621,0.444,61838,0.532
"1176","el dorado",1176,"2021-04-06",1416,102791,524,46308,669,53400,223,3083,454,23749,959,40902,675,64651,"California",193098,0.211819904918746,51621,0.444,61838,0.532
"1177","el dorado",1177,"2021-04-07",1578,104369,554,46862,577,53977,447,3530,556,23730,1019,41921,1000,65651,"California",193098,0.217097018094439,51621,0.444,61838,0.532
"1178","el dorado",1178,"2021-04-08",2663,107032,1715,48577,713,54690,235,3765,1109,23527,1545,43466,1342,66993,"California",193098,0.225098136697428,51621,0.444,61838,0.532
"1179","el dorado",1179,"2021-04-09",1420,108452,447,49024,753,55443,220,3985,565,23457,852,44318,782,67775,"California",193098,0.229510404043543,51621,0.444,61838,0.532
"1180","el dorado",1180,"2021-04-10",827,109279,224,49248,493,55936,110,4095,481,23704,343,44661,590,68365,"California",193098,0.231286704160582,51621,0.444,61838,0.532
"1181","el dorado",1181,"2021-04-11",703,109982,454,49702,233,56169,16,4111,207,23433,494,45155,223,68588,"California",193098,0.233844990626521,51621,0.444,61838,0.532
"1182","el dorado",1182,"2021-04-12",1277,111259,495,50197,634,56803,148,4259,558,23426,712,45867,705,69293,"California",193098,0.237532237516701,51621,0.444,61838,0.532
"1183","el dorado",1183,"2021-04-13",1119,112378,614,50811,505,57308,0,4259,511,23333,604,46471,511,69804,"California",193098,0.240660182912304,51621,0.444,61838,0.532
"1184","el dorado",1184,"2021-04-14",1085,113463,457,51268,627,57935,1,4260,384,23030,688,47159,385,70189,"California",193098,0.244223140581466,51621,0.444,61838,0.532
"1185","el dorado",1185,"2021-04-15",2502,115965,1684,52952,818,58753,0,4260,969,22470,1530,48689,970,71159,"California",193098,0.25214657842132,51621,0.444,61838,0.532
"1186","el dorado",1186,"2021-04-16",1472,117437,522,53474,950,59703,0,4260,610,22224,857,49546,611,71770,"California",193098,0.256584739355146,51621,0.444,61838,0.532
"1187","el dorado",1187,"2021-04-17",787,118224,201,53675,586,60289,0,4260,487,22414,297,49843,487,72257,"California",193098,0.258122818465235,51621,0.444,61838,0.532
"1188","el dorado",1188,"2021-04-18",992,119216,88,53763,904,61193,0,4260,401,22225,590,50433,401,72658,"California",193098,0.261178261815244,51621,0.444,61838,0.532
"1189","el dorado",1189,"2021-04-19",1709,120925,437,54200,1272,62465,0,4260,690,21902,1013,51446,690,73348,"California",193098,0.266424302685683,51621,0.444,61838,0.532
"1190","el dorado",1190,"2021-04-20",1106,122031,356,54556,750,63215,0,4260,456,21713,645,52091,456,73804,"California",193098,0.269764575500523,51621,0.444,61838,0.532
"1191","el dorado",1191,"2021-04-21",1152,123183,464,55020,684,63899,4,4264,587,21743,558,52649,588,74392,"California",193098,0.272654299889175,51621,0.444,61838,0.532
"1192","el dorado",1192,"2021-04-22",2550,125733,1684,56704,866,64765,0,4264,1071,21336,1478,54127,1071,75463,"California",193098,0.280308444416825,51621,0.444,61838,0.532
"1193","el dorado",1193,"2021-04-23",1396,127129,497,57201,899,65664,0,4264,715,21374,678,54805,716,76179,"California",193098,0.283819614910564,51621,0.444,61838,0.532
"1194","el dorado",1194,"2021-04-24",961,128090,511,57712,450,66114,0,4264,730,21875,229,55034,730,76909,"California",193098,0.28500554122777,51621,0.444,61838,0.532
"1195","el dorado",1195,"2021-04-25",612,128702,433,58145,179,66293,0,4264,441,22145,171,55205,441,77350,"California",193098,0.285891101927519,51621,0.444,61838,0.532
"1196","el dorado",1196,"2021-04-26",1029,129731,429,58574,584,66877,16,4280,500,22133,528,55733,516,77866,"California",193098,0.288625464789899,51621,0.444,61838,0.532
"1197","el dorado",1197,"2021-04-27",950,130681,358,58932,564,67441,28,4308,438,22093,506,56239,466,78332,"California",193098,0.291245895866348,51621,0.444,61838,0.532
"1198","el dorado",1198,"2021-04-28",1030,131711,346,59278,644,68085,40,4348,401,21906,628,56867,441,78773,"California",193098,0.294498130482967,51621,0.444,61838,0.532
"1199","el dorado",1199,"2021-04-29",1926,133637,1304,60582,590,68675,32,4380,537,21088,1387,58254,569,79342,"California",193098,0.301681011714259,51621,0.444,61838,0.532
"1200","el dorado",1200,"2021-04-30",2111,135748,1325,61907,745,69420,41,4421,1357,21742,743,58997,1397,80739,"California",193098,0.305528798848253,51621,0.444,61838,0.532
"1201","el dorado",1201,"2021-05-01",616,136364,283,62190,306,69726,27,4448,277,21714,332,59329,304,81043,"California",193098,0.307248133072326,51621,0.444,61838,0.532
"1202","el dorado",1202,"2021-05-02",298,136662,212,62402,57,69783,29,4477,101,21649,194,59523,129,81172,"California",193098,0.308252804275549,51621,0.444,61838,0.532
"1203","el dorado",1203,"2021-05-03",814,137476,401,62803,366,70149,47,4524,273,21431,539,60062,321,81493,"California",193098,0.311044133030896,51621,0.444,61838,0.532
"1204","el dorado",1204,"2021-05-04",879,138355,436,63239,383,70532,60,4584,302,21219,573,60635,361,81854,"California",193098,0.314011538182684,51621,0.444,61838,0.532
"1205","el dorado",1205,"2021-05-05",860,139215,417,63656,373,70905,70,4654,403,21237,455,61090,473,82327,"California",193098,0.316367854664471,51621,0.444,61838,0.532
"1206","el dorado",1206,"2021-05-06",1103,140318,485,64141,574,71479,44,4698,463,21105,635,61725,503,82830,"California",193098,0.319656340303887,51621,0.444,61838,0.532
"1207","el dorado",1207,"2021-05-07",959,141277,378,64519,526,72005,55,4753,380,20961,579,62304,435,83265,"California",193098,0.32265481776093,51621,0.444,61838,0.532
"1208","el dorado",1208,"2021-05-08",479,141756,147,64666,294,72299,38,4791,171,20864,306,62610,209,83474,"California",193098,0.3242395053289,51621,0.444,61838,0.532
"1209","fresno",1209,"2020-12-15",2,2,2,2,0,0,0,0,2,2,0,0,2,2,"California",1032227,0,193025,0.529,164464,0.451
"1210","fresno",1210,"2020-12-16",121,123,121,123,0,0,0,0,121,123,0,0,121,123,"California",1032227,0,193025,0.529,164464,0.451
"1211","fresno",1211,"2020-12-17",121,244,121,244,0,0,0,0,121,244,0,0,121,244,"California",1032227,0,193025,0.529,164464,0.451
"1212","fresno",1212,"2020-12-18",344,588,344,588,0,0,0,0,344,588,0,0,344,588,"California",1032227,0,193025,0.529,164464,0.451
"1213","fresno",1213,"2020-12-19",158,746,158,746,0,0,0,0,158,746,0,0,158,746,"California",1032227,0,193025,0.529,164464,0.451
"1214","fresno",1214,"2020-12-20",258,1004,256,1002,2,2,0,0,258,1004,0,0,258,1004,"California",1032227,0,193025,0.529,164464,0.451
"1215","fresno",1215,"2020-12-21",925,1929,924,1926,1,3,0,0,956,1960,0,0,956,1960,"California",1032227,0,193025,0.529,164464,0.451
"1216","fresno",1216,"2020-12-22",901,2830,872,2798,29,32,0,0,905,2865,0,0,905,2865,"California",1032227,0,193025,0.529,164464,0.451
"1217","fresno",1217,"2020-12-23",1087,3917,1046,3844,41,73,0,0,1088,3953,0,0,1088,3953,"California",1032227,0,193025,0.529,164464,0.451
"1218","fresno",1218,"2020-12-24",583,4500,563,4407,20,93,0,0,583,4536,0,0,583,4536,"California",1032227,0,193025,0.529,164464,0.451
"1219","fresno",1219,"2020-12-25",2,4502,1,4408,1,94,0,0,2,4538,0,0,2,4538,"California",1032227,0,193025,0.529,164464,0.451
"1220","fresno",1220,"2020-12-26",723,5225,714,5122,9,103,0,0,723,5261,0,0,723,5261,"California",1032227,0,193025,0.529,164464,0.451
"1221","fresno",1221,"2020-12-27",300,5525,204,5326,96,199,0,0,300,5561,0,0,300,5561,"California",1032227,0,193025,0.529,164464,0.451
"1222","fresno",1222,"2020-12-28",1063,6588,775,6101,288,487,0,0,1064,6625,0,0,1064,6625,"California",1032227,0,193025,0.529,164464,0.451
"1223","fresno",1223,"2020-12-29",1772,8360,1038,7139,734,1221,0,0,1770,8394,1,1,1770,8395,"California",1032227,9.68779154197672e-07,193025,0.529,164464,0.451
"1224","fresno",1224,"2020-12-30",982,9342,479,7618,503,1724,0,0,982,9376,0,1,982,9377,"California",1032227,9.68779154197672e-07,193025,0.529,164464,0.451
"1225","fresno",1225,"2020-12-31",898,10240,310,7928,588,2312,0,0,897,10273,0,1,897,10274,"California",1032227,9.68779154197672e-07,193025,0.529,164464,0.451
"1226","fresno",1226,"2021-01-01",9,10249,3,7931,6,2318,0,0,9,10282,0,1,9,10283,"California",1032227,9.68779154197672e-07,193025,0.529,164464,0.451
"1227","fresno",1227,"2021-01-02",1030,11279,717,8648,313,2631,0,0,1030,11312,0,1,1030,11313,"California",1032227,9.68779154197672e-07,193025,0.529,164464,0.451
"1228","fresno",1228,"2021-01-03",153,11432,128,8776,25,2656,0,0,153,11465,0,1,153,11466,"California",1032227,9.68779154197672e-07,193025,0.529,164464,0.451
"1229","fresno",1229,"2021-01-04",619,12051,376,9152,243,2899,0,0,619,12084,0,1,619,12085,"California",1032227,9.68779154197672e-07,193025,0.529,164464,0.451
"1230","fresno",1230,"2021-01-05",781,12832,313,9465,468,3367,0,0,707,12717,74,75,707,12792,"California",1032227,7.26584365648254e-05,193025,0.529,164464,0.451
"1231","fresno",1231,"2021-01-06",976,13808,346,9811,630,3997,0,0,804,13349,172,247,804,13596,"California",1032227,0.000239288451086825,193025,0.529,164464,0.451
"1232","fresno",1232,"2021-01-07",1888,15696,916,10727,972,4969,0,0,1634,14732,254,501,1637,15233,"California",1032227,0.000485358356253033,193025,0.529,164464,0.451
"1233","fresno",1233,"2021-01-08",1787,17483,613,11340,1174,6143,0,0,1424,15795,361,862,1424,16657,"California",1032227,0.000835087630918393,193025,0.529,164464,0.451
"1234","fresno",1234,"2021-01-09",629,18112,387,11727,242,6385,0,0,354,15874,275,1137,354,17011,"California",1032227,0.00110150189832275,193025,0.529,164464,0.451
"1235","fresno",1235,"2021-01-10",517,18629,487,12214,30,6415,0,0,204,15765,313,1450,204,17215,"California",1032227,0.00140472977358662,193025,0.529,164464,0.451
"1236","fresno",1236,"2021-01-11",2157,20786,1749,13963,408,6823,0,0,1464,16539,693,2143,1467,18682,"California",1032227,0.00207609372744561,193025,0.529,164464,0.451
"1237","fresno",1237,"2021-01-12",2524,23310,1826,15789,698,7521,0,0,1677,17369,849,2992,1679,20361,"California",1032227,0.00289858722935943,193025,0.529,164464,0.451
"1238","fresno",1238,"2021-01-13",3538,26848,2421,18210,1117,8638,0,0,2682,19197,856,3848,2684,23045,"California",1032227,0.00372786218535264,193025,0.529,164464,0.451
"1239","fresno",1239,"2021-01-14",4157,31005,2202,20412,1955,10593,0,0,3686,22413,470,4318,3686,26731,"California",1032227,0.00418318838782555,193025,0.529,164464,0.451
"1240","fresno",1240,"2021-01-15",3649,34654,2531,22943,1118,11711,0,0,3291,25350,358,4676,3295,30026,"California",1032227,0.00453001132502831,193025,0.529,164464,0.451
"1241","fresno",1241,"2021-01-16",3153,37807,2310,25253,843,12554,0,0,2688,27575,464,5140,2689,32715,"California",1032227,0.00497952485257603,193025,0.529,164464,0.451
"1242","fresno",1242,"2021-01-17",977,38784,556,25809,421,12975,0,0,779,28156,198,5338,779,33494,"California",1032227,0.00517134312510717,193025,0.529,164464,0.451
"1243","fresno",1243,"2021-01-18",3076,41860,2369,28178,707,13682,0,0,2411,29906,663,6001,2413,35907,"California",1032227,0.00581364370434023,193025,0.529,164464,0.451
"1244","fresno",1244,"2021-01-19",4333,46193,2542,30720,1791,15473,0,0,3682,32941,651,6652,3686,39593,"California",1032227,0.00644431893372291,193025,0.529,164464,0.451
"1245","fresno",1245,"2021-01-20",3004,49197,1193,31913,1811,17284,0,0,2698,35339,303,6955,2701,42294,"California",1032227,0.00673785901744481,193025,0.529,164464,0.451
"1246","fresno",1246,"2021-01-21",4379,53576,2025,33938,2354,19638,0,0,4028,39042,330,7285,4033,46327,"California",1032227,0.00705755613833004,193025,0.529,164464,0.451
"1247","fresno",1247,"2021-01-22",3314,56890,1348,35286,1966,21604,0,0,2924,41594,373,7658,2925,49252,"California",1032227,0.00741891076284577,193025,0.529,164464,0.451
"1248","fresno",1248,"2021-01-23",3044,59934,1970,37256,1074,22678,0,0,2321,43200,722,8380,2328,51580,"California",1032227,0.00811836931217649,193025,0.529,164464,0.451
"1249","fresno",1249,"2021-01-24",553,60487,373,37629,180,22858,0,0,348,43346,205,8585,351,51931,"California",1032227,0.00831696903878701,193025,0.529,164464,0.451
"1250","fresno",1250,"2021-01-25",2344,62831,865,38494,1479,24337,0,0,1855,44716,489,9074,1859,53790,"California",1032227,0.00879070204518967,193025,0.529,164464,0.451
"1251","fresno",1251,"2021-01-26",2024,64855,586,39080,1438,25775,0,0,1316,45327,706,9780,1317,55107,"California",1032227,0.00947466012805323,193025,0.529,164464,0.451
"1252","fresno",1252,"2021-01-27",2275,67130,1164,40244,1111,26886,0,0,1753,46562,521,10301,1756,56863,"California",1032227,0.00997939406739022,193025,0.529,164464,0.451
"1253","fresno",1253,"2021-01-28",4501,71631,3058,43302,1443,28329,0,0,3478,49024,1019,11320,3481,60344,"California",1032227,0.0109665800255176,193025,0.529,164464,0.451
"1254","fresno",1254,"2021-01-29",1706,73337,983,44285,723,29052,0,0,1409,50140,294,11614,1410,61754,"California",1032227,0.0112514010968518,193025,0.529,164464,0.451
"1255","fresno",1255,"2021-01-30",1451,74788,551,44836,900,29952,0,0,1034,50757,417,12031,1034,62788,"California",1032227,0.0116553820041522,193025,0.529,164464,0.451
"1256","fresno",1256,"2021-01-31",226,75014,217,45053,9,29961,0,0,72,50675,154,12185,72,62860,"California",1032227,0.0118045739938986,193025,0.529,164464,0.451
"1257","fresno",1257,"2021-02-01",3339,78353,1667,46720,1672,31633,0,0,1824,51003,1514,13699,1842,64702,"California",1032227,0.0132713056333539,193025,0.529,164464,0.451
"1258","fresno",1258,"2021-02-02",2721,81074,552,47272,2169,33802,0,0,1583,51479,1123,14822,1599,66301,"California",1032227,0.0143592446235179,193025,0.529,164464,0.451
"1259","fresno",1259,"2021-02-03",3543,84617,2091,49363,1452,35254,0,0,1531,51014,1997,16819,1532,67833,"California",1032227,0.0162938965944506,193025,0.529,164464,0.451
"1260","fresno",1260,"2021-02-04",4200,88817,1899,51262,2301,37555,0,0,1930,50709,2240,19059,1935,69768,"California",1032227,0.0184639618998534,193025,0.529,164464,0.451
"1261","fresno",1261,"2021-02-05",5333,94150,2724,53986,2609,40164,0,0,2307,49999,3021,22080,2311,72079,"California",1032227,0.0213906437246846,193025,0.529,164464,0.451
"1262","fresno",1262,"2021-02-06",2937,97087,2049,56035,888,41052,0,0,978,49022,1956,24036,979,73058,"California",1032227,0.0232855757502952,193025,0.529,164464,0.451
"1263","fresno",1263,"2021-02-07",470,97557,289,56324,181,41233,0,0,275,49103,194,24230,275,73333,"California",1032227,0.0234735189062096,193025,0.529,164464,0.451
"1264","fresno",1264,"2021-02-08",4278,101835,2292,58616,1986,43219,0,0,1813,48484,2441,26671,1822,75155,"California",1032227,0.0258383088216061,193025,0.529,164464,0.451
"1265","fresno",1265,"2021-02-09",5332,107167,2084,60700,3248,46467,0,0,3119,49474,2138,28809,3128,78283,"California",1032227,0.0279095586532807,193025,0.529,164464,0.451
"1266","fresno",1266,"2021-02-10",3885,111052,1237,61937,2648,49115,0,0,1990,49636,1840,30649,2002,80285,"California",1032227,0.0296921122970044,193025,0.529,164464,0.451
"1267","fresno",1267,"2021-02-11",6458,117510,2097,64034,4361,53476,0,0,3365,49928,3078,33727,3370,83655,"California",1032227,0.0326740145336249,193025,0.529,164464,0.451
"1268","fresno",1268,"2021-02-12",5388,122898,1384,65418,4004,57480,0,0,2742,50052,2625,36352,2749,86404,"California",1032227,0.0352170598133938,193025,0.529,164464,0.451
"1269","fresno",1269,"2021-02-13",3737,126635,1548,66966,2189,59669,0,0,2083,50499,1642,37994,2089,88493,"California",1032227,0.0368077951845863,193025,0.529,164464,0.451
"1270","fresno",1270,"2021-02-14",1562,128197,282,67248,1280,60949,0,0,848,50635,714,38708,850,89343,"California",1032227,0.0374995035006835,193025,0.529,164464,0.451
"1271","fresno",1271,"2021-02-15",2891,131088,272,67520,2619,63568,0,0,1786,51324,1101,39809,1790,91133,"California",1032227,0.0385661293494551,193025,0.529,164464,0.451
"1272","fresno",1272,"2021-02-16",6696,137784,2408,69928,4288,67856,0,0,4252,53156,2426,42235,4258,95391,"California",1032227,0.0409163875775387,193025,0.529,164464,0.451
"1273","fresno",1273,"2021-02-17",5341,143125,2455,72383,2886,70742,0,0,2987,53839,2309,44544,2992,98383,"California",1032227,0.0431532986445811,193025,0.529,164464,0.451
"1274","fresno",1274,"2021-02-18",6863,149988,2906,75289,3957,74699,0,0,2573,52181,4241,48785,2583,100966,"California",1032227,0.0472618910375334,193025,0.529,164464,0.451
"1275","fresno",1275,"2021-02-19",3839,153827,1103,76392,2736,77435,0,0,1834,52023,1995,50780,1837,102803,"California",1032227,0.0491946054501578,193025,0.529,164464,0.451
"1276","fresno",1276,"2021-02-20",4538,158365,2502,78894,2036,79471,0,0,3057,53612,1474,52254,3063,105866,"California",1032227,0.0506225859234451,193025,0.529,164464,0.451
"1277","fresno",1277,"2021-02-21",191,158556,172,79066,19,79490,0,0,129,53692,49,52303,129,105995,"California",1032227,0.0506700561020008,193025,0.529,164464,0.451
"1278","fresno",1278,"2021-02-22",2233,160789,1002,80068,1231,80721,0,0,1227,53924,997,53300,1229,107224,"California",1032227,0.0516359289187359,193025,0.529,164464,0.451
"1279","fresno",1279,"2021-02-23",3911,164700,1501,81569,2410,83131,0,0,3048,56122,852,54152,3050,110274,"California",1032227,0.0524613287581123,193025,0.529,164464,0.451
"1280","fresno",1280,"2021-02-24",4189,168889,1500,83069,2689,85820,0,0,3440,58826,737,54889,3441,113715,"California",1032227,0.053175318994756,193025,0.529,164464,0.451
"1281","fresno",1281,"2021-02-25",7522,176411,2554,85623,4968,90788,0,0,6058,63490,1401,56290,6065,119780,"California",1032227,0.0545325785897869,193025,0.529,164464,0.451
"1282","fresno",1282,"2021-02-26",8367,184778,3061,88684,5306,96094,0,0,7075,69302,1269,57559,7081,126861,"California",1032227,0.0557619593364638,193025,0.529,164464,0.451
"1283","fresno",1283,"2021-02-27",6318,191096,2223,90907,4095,100189,0,0,5624,74246,681,58240,5625,132486,"California",1032227,0.0564216979404724,193025,0.529,164464,0.451
"1284","fresno",1284,"2021-02-28",1652,192748,535,91442,1117,101306,0,0,1562,75732,77,58317,1563,134049,"California",1032227,0.0564962939353456,193025,0.529,164464,0.451
"1285","fresno",1285,"2021-03-01",4946,197694,1313,92755,3633,104939,0,0,3630,78060,1306,59623,3634,137683,"California",1032227,0.0577615195107278,193025,0.529,164464,0.451
"1286","fresno",1286,"2021-03-02",8674,206368,2323,95078,6351,111290,0,0,7302,84037,1348,60971,7325,145008,"California",1032227,0.0590674338105862,193025,0.529,164464,0.451
"1287","fresno",1287,"2021-03-03",6888,213256,1692,96770,5195,116485,1,1,5874,89024,1002,61973,5989,150997,"California",1032227,0.0600381505230923,193025,0.529,164464,0.451
"1288","fresno",1288,"2021-03-04",8656,221912,2550,99320,6106,122591,0,1,7125,94652,1505,63478,7133,158130,"California",1032227,0.0614961631501598,193025,0.529,164464,0.451
"1289","fresno",1289,"2021-03-05",8072,229984,2720,102040,5350,127941,2,3,7046,100882,893,64371,7123,165253,"California",1032227,0.0623612829348583,193025,0.529,164464,0.451
"1290","fresno",1290,"2021-03-06",6485,236469,3551,105591,2816,130757,118,121,5531,105588,947,65318,5653,170906,"California",1032227,0.0632787167938835,193025,0.529,164464,0.451
"1291","fresno",1291,"2021-03-07",1482,237951,679,106270,767,131524,36,157,1252,106649,228,65546,1289,172195,"California",1032227,0.0634995984410406,193025,0.529,164464,0.451
"1292","fresno",1292,"2021-03-08",5081,243032,2022,108292,2906,134430,153,310,3901,109543,1171,66717,4065,176260,"California",1032227,0.0646340388306061,193025,0.529,164464,0.451
"1293","fresno",1293,"2021-03-09",7198,250230,2436,110728,4492,138922,270,580,4000,110668,3180,69897,4305,180565,"California",1032227,0.0677147565409547,193025,0.529,164464,0.451
"1294","fresno",1294,"2021-03-10",6647,256877,2762,113490,3492,142414,393,973,5241,114916,1396,71293,5644,186209,"California",1032227,0.0690671722402146,193025,0.529,164464,0.451
"1295","fresno",1295,"2021-03-11",11459,268336,4560,118050,6333,148747,566,1539,6215,116573,5200,76493,6857,193066,"California",1032227,0.0741048238420425,193025,0.529,164464,0.451
"1296","fresno",1296,"2021-03-12",11689,280025,5021,123071,6215,154962,453,1992,8689,122873,2983,79476,9283,202349,"California",1032227,0.0769946920590141,193025,0.529,164464,0.451
"1297","fresno",1297,"2021-03-13",8178,288203,3905,126976,3242,158204,1031,3023,3921,123662,4235,83711,5024,207373,"California",1032227,0.0810974717770413,193025,0.529,164464,0.451
"1298","fresno",1298,"2021-03-14",1766,289969,473,127449,1003,159207,290,3313,665,123526,1090,84801,954,208327,"California",1032227,0.0821534410551168,193025,0.529,164464,0.451
"1299","fresno",1299,"2021-03-15",7071,297040,3138,130587,3762,162969,171,3484,4906,126639,2150,86951,5263,213590,"California",1032227,0.0842363162366417,193025,0.529,164464,0.451
"1300","fresno",1300,"2021-03-16",10103,307143,4430,135017,5278,168247,395,3879,6065,129189,4006,90957,6556,220146,"California",1032227,0.0881172455283576,193025,0.529,164464,0.451
"1301","fresno",1301,"2021-03-17",8607,315750,3884,138901,4029,172276,694,4573,5826,133330,2760,93717,6901,227047,"California",1032227,0.0907910759939432,193025,0.529,164464,0.451
"1302","fresno",1302,"2021-03-18",12278,328028,6581,145482,5066,177342,631,5204,8009,138174,4221,97938,9065,236112,"California",1032227,0.0948802928038116,193025,0.529,164464,0.451
"1303","fresno",1303,"2021-03-19",10900,338928,5640,151122,4646,181988,614,5818,7401,143013,3471,101409,8310,244422,"California",1032227,0.0982429252480317,193025,0.529,164464,0.451
"1304","fresno",1304,"2021-03-20",7386,346314,4425,155547,2649,184637,312,6130,4509,145256,2853,104262,5096,249518,"California",1032227,0.101006852174958,193025,0.529,164464,0.451
"1305","fresno",1305,"2021-03-21",1778,348092,1205,156752,202,184839,371,6501,963,145779,811,105073,1334,250852,"California",1032227,0.101792532069012,193025,0.529,164464,0.451
"1306","fresno",1306,"2021-03-22",5650,353742,2891,159643,2164,187003,595,7096,3851,148642,1783,106856,4646,255498,"California",1032227,0.103519865300946,193025,0.529,164464,0.451
"1307","fresno",1307,"2021-03-23",10533,364275,5239,164882,4801,191804,493,7589,6053,151157,4459,111315,6974,262472,"California",1032227,0.107839651549514,193025,0.529,164464,0.451
"1308","fresno",1308,"2021-03-24",8636,372911,3656,168538,4152,195956,828,8417,4757,152949,3845,115160,5637,268109,"California",1032227,0.111564607397404,193025,0.529,164464,0.451
"1309","fresno",1309,"2021-03-25",12063,384974,5579,174117,5702,201658,782,9199,6177,154144,5844,121004,7039,275148,"California",1032227,0.117226152774535,193025,0.529,164464,0.451
"1310","fresno",1310,"2021-03-26",12032,397006,5336,179453,6051,207709,645,9844,5276,153377,6707,127711,5940,281088,"California",1032227,0.123723754561739,193025,0.529,164464,0.451
"1311","fresno",1311,"2021-03-27",9380,406386,4140,183593,4157,211866,1083,10927,2938,150998,6405,134116,4026,285114,"California",1032227,0.129928785044375,193025,0.529,164464,0.451
"1312","fresno",1312,"2021-03-28",3350,409736,1266,184859,1397,213263,687,11614,1258,151136,2084,136200,2222,287336,"California",1032227,0.131947720801723,193025,0.529,164464,0.451
"1313","fresno",1313,"2021-03-29",5994,415730,1980,186839,3471,216734,543,12157,2890,151502,3079,139279,3445,290781,"California",1032227,0.134930591817498,193025,0.529,164464,0.451
"1314","fresno",1314,"2021-03-30",10789,426519,4217,191056,5686,222420,886,13043,4453,150528,6310,145589,5336,296117,"California",1032227,0.141043588280485,193025,0.529,164464,0.451
"1315","fresno",1315,"2021-03-31",9272,435791,3327,194383,4962,227382,983,14026,3790,149855,5443,151032,4770,300887,"California",1032227,0.146316653216783,193025,0.529,164464,0.451
"1316","fresno",1316,"2021-04-01",11714,447505,4079,198462,6775,234157,860,14886,3928,146916,7686,158718,4747,305634,"California",1032227,0.153762689795946,193025,0.529,164464,0.451
"1317","fresno",1317,"2021-04-02",11604,459109,4408,202870,6409,240566,787,15673,4206,144671,7245,165963,5000,310634,"California",1032227,0.160781494768108,193025,0.529,164464,0.451
"1318","fresno",1318,"2021-04-03",6220,465329,3385,206255,2582,243148,253,15926,2225,143210,3980,169943,2519,313153,"California",1032227,0.164637235801815,193025,0.529,164464,0.451
"1319","fresno",1319,"2021-04-04",1489,466818,533,206788,912,244060,44,15970,559,142892,921,170864,603,313756,"California",1032227,0.165529481402831,193025,0.529,164464,0.451
"1320","fresno",1320,"2021-04-05",8293,475111,4468,211256,3028,247088,797,16767,2528,140535,5750,176614,3393,317149,"California",1032227,0.171099961539468,193025,0.529,164464,0.451
"1321","fresno",1321,"2021-04-06",9558,484669,4019,215275,4365,251453,1174,17941,3612,139426,5911,182525,4802,321951,"California",1032227,0.17682641511993,193025,0.529,164464,0.451
"1322","fresno",1322,"2021-04-07",10318,494987,5314,220589,3813,255266,1191,19132,3560,137483,6720,189245,4777,326728,"California",1032227,0.183336611036138,193025,0.529,164464,0.451
"1323","fresno",1323,"2021-04-08",10824,505811,5128,225717,4551,259817,1145,20277,3512,134911,7270,196515,4698,331426,"California",1032227,0.190379635487155,193025,0.529,164464,0.451
"1324","fresno",1324,"2021-04-09",10709,516520,5119,230836,4219,264036,1371,21648,3603,132842,7066,203581,4997,336423,"California",1032227,0.197225028990716,193025,0.529,164464,0.451
"1325","fresno",1325,"2021-04-10",7853,524373,5147,235983,2185,266221,521,22169,3723,132975,4110,207691,4243,340666,"California",1032227,0.201206711314469,193025,0.529,164464,0.451
"1326","fresno",1326,"2021-04-11",1388,525761,928,236911,371,266592,89,22258,448,132578,935,208626,538,341204,"California",1032227,0.202112519823643,193025,0.529,164464,0.451
"1327","fresno",1327,"2021-04-12",7143,532904,3770,240681,2458,269050,915,23173,2325,131024,4793,213419,3239,344443,"California",1032227,0.206755878309713,193025,0.529,164464,0.451
"1328","fresno",1328,"2021-04-13",8906,541810,4235,244916,4601,273651,70,23243,3496,129307,5374,218793,3657,348100,"California",1032227,0.211962097484371,193025,0.529,164464,0.451
"1329","fresno",1329,"2021-04-14",8843,550653,5149,250065,3693,277344,1,23244,3614,127785,5183,223976,3661,351761,"California",1032227,0.216983279840578,193025,0.529,164464,0.451
"1330","fresno",1330,"2021-04-15",7838,558491,3644,253709,4191,281535,3,23247,3053,126088,4756,228732,3059,354820,"California",1032227,0.221590793497942,193025,0.529,164464,0.451
"1331","fresno",1331,"2021-04-16",8964,567455,4252,257961,4710,286245,2,23249,3841,124852,5084,233816,3848,358668,"California",1032227,0.226516066717883,193025,0.529,164464,0.451
"1332","fresno",1332,"2021-04-17",5571,573026,3732,261693,1839,288084,0,23249,2714,124727,2841,236657,2716,361384,"California",1032227,0.229268368294958,193025,0.529,164464,0.451
"1333","fresno",1333,"2021-04-18",1021,574047,554,262247,467,288551,0,23249,476,124661,542,237199,476,361860,"California",1032227,0.229793446596534,193025,0.529,164464,0.451
"1334","fresno",1334,"2021-04-19",5407,579454,2919,265166,2484,291035,4,23253,2169,123636,3201,240400,2176,364036,"California",1032227,0.23289450866912,193025,0.529,164464,0.451
"1335","fresno",1335,"2021-04-20",6818,586272,3312,268478,3498,294533,8,23261,2539,121929,4255,244655,2548,366584,"California",1032227,0.237016663970231,193025,0.529,164464,0.451
"1336","fresno",1336,"2021-04-21",6260,592532,3410,271888,2841,297374,9,23270,2585,120878,3648,248303,2597,369181,"California",1032227,0.240550770324744,193025,0.529,164464,0.451
"1337","fresno",1337,"2021-04-22",6325,598857,3137,275025,3187,300561,1,23271,2333,119275,3940,252243,2337,371518,"California",1032227,0.244367760192283,193025,0.529,164464,0.451
"1338","fresno",1338,"2021-04-23",7020,605877,3766,278791,3235,303796,19,23290,2719,117740,4261,256504,2726,374244,"California",1032227,0.24849572816832,193025,0.529,164464,0.451
"1339","fresno",1339,"2021-04-24",4154,610031,2482,281273,1672,305468,0,23290,1956,117512,2184,258688,1956,376200,"California",1032227,0.250611541841087,193025,0.529,164464,0.451
"1340","fresno",1340,"2021-04-25",1379,611410,567,281840,810,306278,2,23292,691,117520,684,259372,692,376892,"California",1032227,0.251274186782558,193025,0.529,164464,0.451
"1341","fresno",1341,"2021-04-26",3788,615198,1848,283688,1897,308175,43,23335,1597,116992,2166,261538,1638,378530,"California",1032227,0.253372562430551,193025,0.529,164464,0.451
"1342","fresno",1342,"2021-04-27",4402,619600,2181,285869,2111,310286,110,23445,1722,116164,2660,264198,1832,380362,"California",1032227,0.255949514980716,193025,0.529,164464,0.451
"1343","fresno",1343,"2021-04-28",4702,624302,2625,288494,1950,312236,127,23572,1926,115461,2756,266954,2053,382415,"California",1032227,0.258619470329685,193025,0.529,164464,0.451
"1344","fresno",1344,"2021-04-29",4719,629021,2644,291138,1942,314178,133,23705,1738,114380,2952,269906,1871,384286,"California",1032227,0.261479306392877,193025,0.529,164464,0.451
"1345","fresno",1345,"2021-04-30",5302,634323,3227,294365,1946,316124,129,23834,2096,113431,3173,273079,2224,386510,"California",1032227,0.264553242649146,193025,0.529,164464,0.451
"1346","fresno",1346,"2021-05-01",4179,638502,3465,297830,577,316701,137,23971,1214,111830,2951,276030,1350,387860,"California",1032227,0.267412109933183,193025,0.529,164464,0.451
"1347","fresno",1347,"2021-05-02",1245,639747,777,298607,418,317119,50,24021,606,111856,629,276659,655,388515,"California",1032227,0.268021472021174,193025,0.529,164464,0.451
"1348","fresno",1348,"2021-05-03",3934,643681,2645,301252,1108,318227,181,24202,1287,110696,2624,279283,1464,389979,"California",1032227,0.270563548521788,193025,0.529,164464,0.451
"1349","fresno",1349,"2021-05-04",4647,648328,2346,303598,2158,320385,143,24345,1490,109194,3137,282420,1635,391614,"California",1032227,0.273602608728506,193025,0.529,164464,0.451
"1350","fresno",1350,"2021-05-05",4717,653045,2799,306397,1697,322082,221,24566,1441,107597,3252,285672,1655,393269,"California",1032227,0.276753078537957,193025,0.529,164464,0.451
"1351","fresno",1351,"2021-05-06",3870,656915,2314,308711,1452,323534,104,24670,1285,106432,2555,288227,1390,394659,"California",1032227,0.279228309276932,193025,0.529,164464,0.451
"1352","fresno",1352,"2021-05-07",4952,661867,3263,311974,1533,325067,156,24826,1527,104714,3401,291628,1683,396342,"California",1032227,0.282523127180359,193025,0.529,164464,0.451
"1353","fresno",1353,"2021-05-08",3845,665712,2471,314445,1231,326298,143,24969,1134,103304,2693,294321,1283,397625,"California",1032227,0.285132049442613,193025,0.529,164464,0.451
"1354","glenn",1354,"2020-12-17",1,1,1,1,0,0,0,0,1,1,0,0,1,1,"California",29348,0,3995,0.354,7063,0.625
"1355","glenn",1355,"2020-12-19",1,2,1,2,0,0,0,0,1,2,0,0,1,2,"California",29348,0,3995,0.354,7063,0.625
"1356","glenn",1356,"2020-12-20",1,3,1,3,0,0,0,0,1,3,0,0,1,3,"California",29348,0,3995,0.354,7063,0.625
"1357","glenn",1357,"2020-12-21",11,14,11,14,0,0,0,0,11,14,0,0,11,14,"California",29348,0,3995,0.354,7063,0.625
"1358","glenn",1358,"2020-12-22",59,73,59,73,0,0,0,0,59,73,0,0,59,73,"California",29348,0,3995,0.354,7063,0.625
"1359","glenn",1359,"2020-12-23",27,100,27,100,0,0,0,0,27,100,0,0,27,100,"California",29348,0,3995,0.354,7063,0.625
"1360","glenn",1360,"2020-12-24",9,109,9,109,0,0,0,0,9,109,0,0,9,109,"California",29348,0,3995,0.354,7063,0.625
"1361","glenn",1361,"2020-12-26",2,111,2,111,0,0,0,0,2,111,0,0,2,111,"California",29348,0,3995,0.354,7063,0.625
"1362","glenn",1362,"2020-12-27",4,115,4,115,0,0,0,0,4,115,0,0,4,115,"California",29348,0,3995,0.354,7063,0.625
"1363","glenn",1363,"2020-12-28",21,136,21,136,0,0,0,0,21,136,0,0,21,136,"California",29348,0,3995,0.354,7063,0.625
"1364","glenn",1364,"2020-12-29",82,218,82,218,0,0,0,0,82,218,0,0,82,218,"California",29348,0,3995,0.354,7063,0.625
"1365","glenn",1365,"2020-12-30",129,347,106,324,23,23,0,0,129,347,0,0,129,347,"California",29348,0,3995,0.354,7063,0.625
"1366","glenn",1366,"2020-12-31",38,385,9,333,29,52,0,0,38,385,0,0,38,385,"California",29348,0,3995,0.354,7063,0.625
"1367","glenn",1367,"2021-01-02",2,387,2,335,0,52,0,0,2,387,0,0,2,387,"California",29348,0,3995,0.354,7063,0.625
"1368","glenn",1368,"2021-01-04",7,394,5,340,2,54,0,0,7,394,0,0,7,394,"California",29348,0,3995,0.354,7063,0.625
"1369","glenn",1369,"2021-01-05",9,403,8,348,1,55,0,0,9,403,0,0,9,403,"California",29348,0,3995,0.354,7063,0.625
"1370","glenn",1370,"2021-01-06",60,463,8,356,52,107,0,0,60,463,0,0,60,463,"California",29348,0,3995,0.354,7063,0.625
"1371","glenn",1371,"2021-01-07",67,530,12,368,55,162,0,0,65,526,2,2,65,528,"California",29348,6.81477443096634e-05,3995,0.354,7063,0.625
"1372","glenn",1372,"2021-01-08",12,542,9,377,3,165,0,0,12,538,0,2,12,540,"California",29348,6.81477443096634e-05,3995,0.354,7063,0.625
"1373","glenn",1373,"2021-01-10",1,543,1,378,0,165,0,0,0,537,1,3,0,540,"California",29348,0.000102221616464495,3995,0.354,7063,0.625
"1374","glenn",1374,"2021-01-11",30,573,30,408,0,165,0,0,12,531,18,21,12,552,"California",29348,0.000715551315251465,3995,0.354,7063,0.625
"1375","glenn",1375,"2021-01-12",42,615,37,445,5,170,0,0,14,517,28,49,14,566,"California",29348,0.00166961973558675,3995,0.354,7063,0.625
"1376","glenn",1376,"2021-01-13",154,769,89,534,65,235,0,0,110,583,44,93,110,676,"California",29348,0.00316887011039935,3995,0.354,7063,0.625
"1377","glenn",1377,"2021-01-14",185,954,96,630,89,324,0,0,175,748,10,103,175,851,"California",29348,0.00350960883194766,3995,0.354,7063,0.625
"1378","glenn",1378,"2021-01-15",42,996,34,664,8,332,0,0,37,780,5,108,37,888,"California",29348,0.00367997819272182,3995,0.354,7063,0.625
"1379","glenn",1379,"2021-01-16",34,1030,14,678,20,352,0,0,24,794,10,118,24,912,"California",29348,0.00402071691427014,3995,0.354,7063,0.625
"1380","glenn",1380,"2021-01-17",4,1034,2,680,2,354,0,0,2,794,2,120,2,914,"California",29348,0.0040888646585798,3995,0.354,7063,0.625
"1381","glenn",1381,"2021-01-18",17,1051,16,696,1,355,0,0,9,795,8,128,9,923,"California",29348,0.00436145563581845,3995,0.354,7063,0.625
"1382","glenn",1382,"2021-01-19",31,1082,20,716,11,366,0,0,14,792,17,145,14,937,"California",29348,0.00494071146245059,3995,0.354,7063,0.625
"1383","glenn",1383,"2021-01-20",163,1245,94,810,69,435,0,0,82,793,81,226,82,1019,"California",29348,0.00770069510699196,3995,0.354,7063,0.625
"1384","glenn",1384,"2021-01-21",124,1369,98,908,26,461,0,0,30,729,94,320,30,1049,"California",29348,0.0109036390895461,3995,0.354,7063,0.625
"1385","glenn",1385,"2021-01-22",339,1708,65,973,274,735,0,0,332,1054,7,327,332,1381,"California",29348,0.01114215619463,3995,0.354,7063,0.625
"1386","glenn",1386,"2021-01-23",14,1722,7,980,7,742,0,0,12,1064,2,329,12,1393,"California",29348,0.0112103039389396,3995,0.354,7063,0.625
"1387","glenn",1387,"2021-01-24",2,1724,2,982,0,742,0,0,2,1066,0,329,2,1395,"California",29348,0.0112103039389396,3995,0.354,7063,0.625
"1388","glenn",1388,"2021-01-25",27,1751,9,991,18,760,0,0,24,1087,3,332,24,1419,"California",29348,0.0113125255554041,3995,0.354,7063,0.625
"1389","glenn",1389,"2021-01-26",29,1780,13,1004,16,776,0,0,23,1104,6,338,23,1442,"California",29348,0.0115169687883331,3995,0.354,7063,0.625
"1390","glenn",1390,"2021-01-27",188,1968,13,1017,175,951,0,0,166,1248,22,360,166,1608,"California",29348,0.0122665939757394,3995,0.354,7063,0.625
"1391","glenn",1391,"2021-01-28",146,2114,8,1025,138,1089,0,0,116,1334,30,390,116,1724,"California",29348,0.0132888101403844,3995,0.354,7063,0.625
"1392","glenn",1392,"2021-01-29",296,2410,12,1037,284,1373,0,0,282,1602,14,404,282,2006,"California",29348,0.013765844350552,3995,0.354,7063,0.625
"1393","glenn",1393,"2021-01-30",4,2414,0,1037,4,1377,0,0,4,1606,0,404,4,2010,"California",29348,0.013765844350552,3995,0.354,7063,0.625
"1394","glenn",1394,"2021-01-31",1,2415,0,1037,1,1378,0,0,1,1607,0,404,1,2011,"California",29348,0.013765844350552,3995,0.354,7063,0.625
"1395","glenn",1395,"2021-02-01",28,2443,10,1047,18,1396,0,0,16,1611,12,416,16,2027,"California",29348,0.01417473081641,3995,0.354,7063,0.625
"1396","glenn",1396,"2021-02-02",28,2471,13,1060,15,1411,0,0,19,1621,9,425,19,2046,"California",29348,0.0144813956658035,3995,0.354,7063,0.625
"1397","glenn",1397,"2021-02-03",207,2678,58,1118,149,1560,0,0,111,1637,96,521,112,2158,"California",29348,0.0177524873926673,3995,0.354,7063,0.625
"1398","glenn",1398,"2021-02-04",150,2828,84,1202,66,1626,0,0,45,1577,105,626,45,2203,"California",29348,0.0213302439689246,3995,0.354,7063,0.625
"1399","glenn",1399,"2021-02-05",319,3147,24,1226,295,1921,0,0,299,1856,20,646,299,2502,"California",29348,0.0220117214120213,3995,0.354,7063,0.625
"1400","glenn",1400,"2021-02-06",14,3161,2,1228,12,1933,0,0,13,1868,1,647,13,2515,"California",29348,0.0220457952841761,3995,0.354,7063,0.625
"1401","glenn",1401,"2021-02-07",2,3163,2,1230,0,1933,0,0,2,1870,0,647,2,2517,"California",29348,0.0220457952841761,3995,0.354,7063,0.625
"1402","glenn",1402,"2021-02-08",21,3184,17,1247,4,1937,0,0,4,1857,17,664,4,2521,"California",29348,0.0226250511108082,3995,0.354,7063,0.625
"1403","glenn",1403,"2021-02-09",49,3233,20,1267,29,1966,0,0,36,1880,13,677,36,2557,"California",29348,0.023068011448821,3995,0.354,7063,0.625
"1404","glenn",1404,"2021-02-10",139,3372,19,1286,120,2086,0,0,65,1871,74,751,65,2622,"California",29348,0.0255894779882786,3995,0.354,7063,0.625
"1405","glenn",1405,"2021-02-11",233,3605,133,1419,100,2186,0,0,150,1938,83,834,150,2772,"California",29348,0.0284176093771296,3995,0.354,7063,0.625
"1406","glenn",1406,"2021-02-12",420,4025,99,1518,321,2507,0,0,354,2226,66,900,354,3126,"California",29348,0.0306664849393485,3995,0.354,7063,0.625
"1407","glenn",1407,"2021-02-13",34,4059,7,1525,27,2534,0,0,16,2224,18,918,16,3142,"California",29348,0.0312798146381355,3995,0.354,7063,0.625
"1408","glenn",1408,"2021-02-14",1,4060,0,1525,1,2535,0,0,1,2225,0,918,1,3143,"California",29348,0.0312798146381355,3995,0.354,7063,0.625
"1409","glenn",1409,"2021-02-15",8,4068,0,1525,8,2543,0,0,8,2233,0,918,8,3151,"California",29348,0.0312798146381355,3995,0.354,7063,0.625
"1410","glenn",1410,"2021-02-16",39,4107,9,1534,30,2573,0,0,21,2236,18,936,21,3172,"California",29348,0.0318931443369224,3995,0.354,7063,0.625
"1411","glenn",1411,"2021-02-17",380,4487,15,1549,365,2938,0,0,302,2460,78,1014,302,3474,"California",29348,0.0345509063649993,3995,0.354,7063,0.625
"1412","glenn",1412,"2021-02-18",135,4622,100,1649,35,2973,0,0,111,2547,24,1038,111,3585,"California",29348,0.0353686792967153,3995,0.354,7063,0.625
"1413","glenn",1413,"2021-02-19",303,4925,17,1666,286,3259,0,0,29,2302,274,1312,29,3614,"California",29348,0.0447049202671392,3995,0.354,7063,0.625
"1414","glenn",1414,"2021-02-20",8,4933,0,1666,8,3267,0,0,0,2294,8,1320,0,3614,"California",29348,0.0449775112443778,3995,0.354,7063,0.625
"1415","glenn",1415,"2021-02-22",33,4966,14,1680,19,3286,0,0,17,2295,16,1336,17,3631,"California",29348,0.0455226931988551,3995,0.354,7063,0.625
"1416","glenn",1416,"2021-02-23",40,5006,10,1690,30,3316,0,0,28,2311,12,1348,28,3659,"California",29348,0.0459315796647131,3995,0.354,7063,0.625
"1417","glenn",1417,"2021-02-24",221,5227,15,1705,206,3522,0,0,47,2184,174,1522,47,3706,"California",29348,0.0518604334196538,3995,0.354,7063,0.625
"1418","glenn",1418,"2021-02-25",262,5489,148,1853,114,3636,0,0,118,2158,144,1666,118,3824,"California",29348,0.0567670710099496,3995,0.354,7063,0.625
"1419","glenn",1419,"2021-02-26",304,5793,24,1877,280,3916,0,0,20,1895,283,1949,20,3844,"California",29348,0.0664099768297669,3995,0.354,7063,0.625
"1420","glenn",1420,"2021-02-27",15,5808,5,1882,10,3926,0,0,5,1891,9,1958,5,3849,"California",29348,0.0667166416791604,3995,0.354,7063,0.625
"1421","glenn",1421,"2021-02-28",6,5814,3,1885,3,3929,0,0,3,1892,2,1960,3,3852,"California",29348,0.0667847894234701,3995,0.354,7063,0.625
"1422","glenn",1422,"2021-03-01",28,5842,6,1891,22,3951,0,0,12,1888,16,1976,12,3864,"California",29348,0.0673299713779474,3995,0.354,7063,0.625
"1423","glenn",1423,"2021-03-02",35,5877,7,1898,28,3979,0,0,17,1887,18,1994,17,3881,"California",29348,0.0679433010767344,3995,0.354,7063,0.625
"1424","glenn",1424,"2021-03-03",192,6069,37,1935,155,4134,0,0,101,1899,89,2083,101,3982,"California",29348,0.0709758756985144,3995,0.354,7063,0.625
"1425","glenn",1425,"2021-03-04",521,6590,175,2110,346,4480,0,0,375,2128,146,2229,375,4357,"California",29348,0.0759506610331198,3995,0.354,7063,0.625
"1426","glenn",1426,"2021-03-05",356,6946,48,2158,308,4788,0,0,35,1842,321,2550,35,4392,"California",29348,0.0868883739948208,3995,0.354,7063,0.625
"1427","glenn",1427,"2021-03-06",26,6972,3,2161,22,4810,1,1,9,1835,17,2567,10,4402,"California",29348,0.0874676298214529,3995,0.354,7063,0.625
"1428","glenn",1428,"2021-03-07",5,6977,0,2161,5,4815,0,1,3,1837,1,2568,3,4405,"California",29348,0.0875017036936077,3995,0.354,7063,0.625
"1429","glenn",1429,"2021-03-08",20,6997,2,2163,17,4832,1,2,18,1854,2,2570,19,4424,"California",29348,0.0875698514379174,3995,0.354,7063,0.625
"1430","glenn",1430,"2021-03-09",82,7079,11,2174,68,4900,3,5,54,1882,28,2598,56,4480,"California",29348,0.0885239198582527,3995,0.354,7063,0.625
"1431","glenn",1431,"2021-03-10",172,7251,68,2242,102,5002,2,7,95,1902,77,2675,97,4577,"California",29348,0.0911476080141747,3995,0.354,7063,0.625
"1432","glenn",1432,"2021-03-11",584,7835,170,2412,391,5393,23,30,454,2249,130,2805,477,5054,"California",29348,0.0955772113943028,3995,0.354,7063,0.625
"1433","glenn",1433,"2021-03-12",418,8253,14,2426,342,5735,62,92,41,1975,377,3182,103,5157,"California",29348,0.108423061196674,3995,0.354,7063,0.625
"1434","glenn",1434,"2021-03-13",12,8265,1,2427,3,5738,8,100,1,1973,11,3193,9,5166,"California",29348,0.108797873790378,3995,0.354,7063,0.625
"1435","glenn",1435,"2021-03-14",3,8268,1,2428,2,5740,0,100,2,1974,1,3194,2,5168,"California",29348,0.108831947662532,3995,0.354,7063,0.625
"1436","glenn",1436,"2021-03-15",75,8343,15,2443,55,5795,5,105,60,2024,15,3209,65,5233,"California",29348,0.109343055744855,3995,0.354,7063,0.625
"1437","glenn",1437,"2021-03-16",106,8449,33,2476,62,5857,11,116,65,2059,41,3250,76,5309,"California",29348,0.110740084503203,3995,0.354,7063,0.625
"1438","glenn",1438,"2021-03-17",417,8866,97,2573,313,6170,7,123,116,1879,301,3551,121,5430,"California",29348,0.120996320021807,3995,0.354,7063,0.625
"1439","glenn",1439,"2021-03-18",521,9387,215,2788,50,6220,256,379,145,1903,376,3927,400,5830,"California",29348,0.133808095952024,3995,0.354,7063,0.625
"1440","glenn",1440,"2021-03-19",92,9479,16,2804,70,6290,6,385,71,1960,20,3947,77,5907,"California",29348,0.134489573395121,3995,0.354,7063,0.625
"1441","glenn",1441,"2021-03-20",121,9600,1,2805,119,6409,1,386,119,2078,2,3949,120,6027,"California",29348,0.13455772113943,3995,0.354,7063,0.625
"1442","glenn",1442,"2021-03-21",6,9606,5,2810,0,6409,1,387,3,2080,2,3951,4,6031,"California",29348,0.13462586888374,3995,0.354,7063,0.625
"1443","glenn",1443,"2021-03-22",117,9723,54,2864,55,6464,8,395,97,2167,18,3969,105,6136,"California",29348,0.135239198582527,3995,0.354,7063,0.625
"1444","glenn",1444,"2021-03-23",173,9896,66,2930,56,6520,51,446,100,2246,72,4041,151,6287,"California",29348,0.137692517377675,3995,0.354,7063,0.625
"1445","glenn",1445,"2021-03-24",205,10101,99,3029,101,6621,5,451,133,2313,71,4112,138,6425,"California",29348,0.140111762300668,3995,0.354,7063,0.625
"1446","glenn",1446,"2021-03-25",458,10559,228,3257,136,6757,94,545,330,2610,127,4239,424,6849,"California",29348,0.144439144064331,3995,0.354,7063,0.625
"1447","glenn",1447,"2021-03-26",229,10788,37,3294,156,6913,36,581,178,2773,51,4290,214,7063,"California",29348,0.146176911544228,3995,0.354,7063,0.625
"1448","glenn",1448,"2021-03-27",151,10939,22,3316,124,7037,5,586,141,2909,10,4300,146,7209,"California",29348,0.146517650265776,3995,0.354,7063,0.625
"1449","glenn",1449,"2021-03-28",15,10954,10,3326,5,7042,0,586,10,2914,5,4305,10,7219,"California",29348,0.14668801962655,3995,0.354,7063,0.625
"1450","glenn",1450,"2021-03-29",60,11014,20,3346,37,7079,3,589,46,2949,14,4319,49,7268,"California",29348,0.147165053836718,3995,0.354,7063,0.625
"1451","glenn",1451,"2021-03-30",74,11088,42,3388,31,7110,1,590,42,2962,30,4349,43,7311,"California",29348,0.148187270001363,3995,0.354,7063,0.625
"1452","glenn",1452,"2021-03-31",125,11213,35,3423,89,7199,1,591,54,2947,70,4419,55,7366,"California",29348,0.150572441052201,3995,0.354,7063,0.625
"1453","glenn",1453,"2021-04-01",643,11856,185,3608,449,7648,9,600,231,2777,410,4829,240,7606,"California",29348,0.164542728635682,3995,0.354,7063,0.625
"1454","glenn",1454,"2021-04-02",159,12015,25,3633,122,7770,12,612,123,2876,36,4865,135,7741,"California",29348,0.165769388033256,3995,0.354,7063,0.625
"1455","glenn",1455,"2021-04-03",91,12106,4,3637,80,7850,7,619,80,2952,11,4876,87,7828,"California",29348,0.166144200626959,3995,0.354,7063,0.625
"1456","glenn",1456,"2021-04-04",8,12114,3,3640,3,7853,2,621,4,2954,4,4880,6,7834,"California",29348,0.166280496115579,3995,0.354,7063,0.625
"1457","glenn",1457,"2021-04-05",65,12179,25,3665,27,7880,13,634,28,2958,37,4917,41,7875,"California",29348,0.167541229385307,3995,0.354,7063,0.625
"1458","glenn",1458,"2021-04-06",144,12323,52,3717,53,7933,39,673,38,2929,105,5022,76,7951,"California",29348,0.171118985961565,3995,0.354,7063,0.625
"1459","glenn",1459,"2021-04-07",158,12481,46,3763,58,7991,54,727,72,2969,86,5108,126,8077,"California",29348,0.17404933896688,3995,0.354,7063,0.625
"1460","glenn",1460,"2021-04-08",640,13121,189,3952,417,8408,34,761,138,2641,500,5608,172,8249,"California",29348,0.191086275044296,3995,0.354,7063,0.625
"1461","glenn",1461,"2021-04-09",156,13277,57,4009,83,8491,16,777,100,2701,56,5664,116,8365,"California",29348,0.192994411884967,3995,0.354,7063,0.625
"1462","glenn",1462,"2021-04-10",75,13352,1,4010,63,8554,11,788,62,2762,12,5676,73,8438,"California",29348,0.193403298350825,3995,0.354,7063,0.625
"1463","glenn",1463,"2021-04-11",17,13369,8,4018,4,8558,5,793,7,2764,10,5686,12,8450,"California",29348,0.193744037072373,3995,0.354,7063,0.625
"1464","glenn",1464,"2021-04-12",114,13483,25,4043,60,8618,29,822,20,2719,94,5780,49,8499,"California",29348,0.196946981054927,3995,0.354,7063,0.625
"1465","glenn",1465,"2021-04-13",118,13601,63,4106,55,8673,0,822,31,2664,86,5866,31,8530,"California",29348,0.199877334060243,3995,0.354,7063,0.625
"1466","glenn",1466,"2021-04-14",123,13724,47,4153,76,8749,0,822,69,2679,54,5920,69,8599,"California",29348,0.201717323156604,3995,0.354,7063,0.625
"1467","glenn",1467,"2021-04-15",361,14085,275,4428,86,8835,0,822,124,2566,237,6157,124,8723,"California",29348,0.209792830857299,3995,0.354,7063,0.625
"1468","glenn",1468,"2021-04-16",164,14249,40,4468,124,8959,0,822,78,2558,86,6243,78,8801,"California",29348,0.212723183862614,3995,0.354,7063,0.625
"1469","glenn",1469,"2021-04-17",166,14415,18,4486,148,9107,0,822,36,2471,123,6366,36,8837,"California",29348,0.216914270137658,3995,0.354,7063,0.625
"1470","glenn",1470,"2021-04-18",16,14431,3,4489,13,9120,0,822,13,2481,3,6369,13,8850,"California",29348,0.217016491754123,3995,0.354,7063,0.625
"1471","glenn",1471,"2021-04-19",82,14513,17,4506,65,9185,0,822,27,2454,54,6423,27,8877,"California",29348,0.218856480850484,3995,0.354,7063,0.625
"1472","glenn",1472,"2021-04-20",125,14638,81,4587,44,9229,0,822,56,2441,69,6492,56,8933,"California",29348,0.221207578029167,3995,0.354,7063,0.625
"1473","glenn",1473,"2021-04-21",410,15048,307,4894,103,9332,0,822,284,2599,126,6618,284,9217,"California",29348,0.225500885920676,3995,0.354,7063,0.625
"1474","glenn",1474,"2021-04-22",208,15256,48,4942,160,9492,0,822,43,2478,164,6782,43,9260,"California",29348,0.231089000954068,3995,0.354,7063,0.625
"1475","glenn",1475,"2021-04-23",178,15434,24,4966,154,9646,0,822,48,2397,129,6911,48,9308,"California",29348,0.235484530462042,3995,0.354,7063,0.625
"1476","glenn",1476,"2021-04-24",179,15613,32,4998,147,9793,0,822,44,2306,135,7046,44,9352,"California",29348,0.240084503202944,3995,0.354,7063,0.625
"1477","glenn",1477,"2021-04-25",28,15641,16,5014,12,9805,0,822,21,2320,7,7053,21,9373,"California",29348,0.240323020308028,3995,0.354,7063,0.625
"1478","glenn",1478,"2021-04-26",44,15685,9,5023,35,9840,0,822,18,2312,26,7079,18,9391,"California",29348,0.241208940984053,3995,0.354,7063,0.625
"1479","glenn",1479,"2021-04-27",52,15737,39,5062,8,9848,5,827,24,2313,27,7106,28,9419,"California",29348,0.242128935532234,3995,0.354,7063,0.625
"1480","glenn",1480,"2021-04-28",255,15992,177,5239,67,9915,11,838,127,2323,128,7234,138,9557,"California",29348,0.246490391168052,3995,0.354,7063,0.625
"1481","glenn",1481,"2021-04-29",182,16174,23,5262,157,10072,2,840,44,2231,138,7372,46,9603,"California",29348,0.251192585525419,3995,0.354,7063,0.625
"1482","glenn",1482,"2021-04-30",155,16329,34,5296,119,10191,2,842,45,2168,110,7482,47,9650,"California",29348,0.254940711462451,3995,0.354,7063,0.625
"1483","glenn",1483,"2021-05-01",108,16437,13,5309,94,10285,1,843,30,2121,78,7560,31,9681,"California",29348,0.257598473490527,3995,0.354,7063,0.625
"1484","glenn",1484,"2021-05-02",30,16467,12,5321,9,10294,9,852,15,2130,15,7575,24,9705,"California",29348,0.25810958157285,3995,0.354,7063,0.625
"1485","glenn",1485,"2021-05-03",36,16503,23,5344,12,10306,1,853,14,2123,22,7597,15,9720,"California",29348,0.258859206760256,3995,0.354,7063,0.625
"1486","glenn",1486,"2021-05-04",56,16559,32,5376,19,10325,5,858,27,2126,29,7626,32,9752,"California",29348,0.259847349052746,3995,0.354,7063,0.625
"1487","glenn",1487,"2021-05-05",123,16682,35,5411,78,10403,10,868,53,2119,70,7696,63,9815,"California",29348,0.262232520103585,3995,0.354,7063,0.625
"1488","glenn",1488,"2021-05-06",105,16787,42,5453,58,10461,5,873,40,2099,65,7761,45,9860,"California",29348,0.264447321793649,3995,0.354,7063,0.625
"1489","glenn",1489,"2021-05-07",122,16909,33,5486,80,10541,9,882,33,2053,88,7849,42,9902,"California",29348,0.267445822543274,3995,0.354,7063,0.625
"1490","glenn",1490,"2021-05-08",66,16975,11,5497,51,10592,4,886,20,2032,45,7894,24,9926,"California",29348,0.268979146790241,3995,0.354,7063,0.625
"1491","humboldt",1491,"2020-12-15",2,2,2,2,0,0,0,0,2,2,0,0,2,2,"California",134098,0,44768,0.65,21770,0.316
"1492","humboldt",1492,"2020-12-16",15,17,15,17,0,0,0,0,15,17,0,0,15,17,"California",134098,0,44768,0.65,21770,0.316
"1493","humboldt",1493,"2020-12-17",117,134,117,134,0,0,0,0,117,134,0,0,117,134,"California",134098,0,44768,0.65,21770,0.316
"1494","humboldt",1494,"2020-12-18",177,311,177,311,0,0,0,0,177,311,0,0,177,311,"California",134098,0,44768,0.65,21770,0.316
"1495","humboldt",1495,"2020-12-19",10,321,10,321,0,0,0,0,10,321,0,0,10,321,"California",134098,0,44768,0.65,21770,0.316
"1496","humboldt",1496,"2020-12-20",28,349,28,349,0,0,0,0,28,349,0,0,28,349,"California",134098,0,44768,0.65,21770,0.316
"1497","humboldt",1497,"2020-12-21",166,515,166,515,0,0,0,0,166,515,0,0,166,515,"California",134098,0,44768,0.65,21770,0.316
"1498","humboldt",1498,"2020-12-22",297,812,297,812,0,0,0,0,297,812,0,0,297,812,"California",134098,0,44768,0.65,21770,0.316
"1499","humboldt",1499,"2020-12-23",310,1122,262,1074,48,48,0,0,312,1124,0,0,312,1124,"California",134098,0,44768,0.65,21770,0.316
"1500","humboldt",1500,"2020-12-24",25,1147,2,1076,23,71,0,0,25,1149,0,0,25,1149,"California",134098,0,44768,0.65,21770,0.316
"1501","humboldt",1501,"2020-12-25",2,1149,2,1078,0,71,0,0,2,1151,0,0,2,1151,"California",134098,0,44768,0.65,21770,0.316
"1502","humboldt",1502,"2020-12-26",6,1155,5,1083,1,72,0,0,6,1157,0,0,6,1157,"California",134098,0,44768,0.65,21770,0.316
"1503","humboldt",1503,"2020-12-28",157,1312,145,1228,12,84,0,0,157,1314,0,0,157,1314,"California",134098,0,44768,0.65,21770,0.316
"1504","humboldt",1504,"2020-12-29",171,1483,124,1352,47,131,0,0,171,1485,0,0,171,1485,"California",134098,0,44768,0.65,21770,0.316
"1505","humboldt",1505,"2020-12-30",223,1706,124,1476,99,230,0,0,223,1708,0,0,223,1708,"California",134098,0,44768,0.65,21770,0.316
"1506","humboldt",1506,"2020-12-31",242,1948,79,1555,163,393,0,0,242,1950,0,0,242,1950,"California",134098,0,44768,0.65,21770,0.316
"1507","humboldt",1507,"2021-01-01",2,1950,1,1556,1,394,0,0,2,1952,0,0,2,1952,"California",134098,0,44768,0.65,21770,0.316
"1508","humboldt",1508,"2021-01-02",38,1988,1,1557,37,431,0,0,38,1990,0,0,38,1990,"California",134098,0,44768,0.65,21770,0.316
"1509","humboldt",1509,"2021-01-04",217,2205,142,1699,75,506,0,0,218,2208,0,0,218,2208,"California",134098,0,44768,0.65,21770,0.316
"1510","humboldt",1510,"2021-01-05",129,2334,18,1717,111,617,0,0,128,2335,1,1,128,2336,"California",134098,7.45723277006368e-06,44768,0.65,21770,0.316
"1511","humboldt",1511,"2021-01-06",302,2636,204,1921,98,715,0,0,229,2503,61,62,229,2565,"California",134098,0.000462348431743948,44768,0.65,21770,0.316
"1512","humboldt",1512,"2021-01-07",423,3059,311,2232,112,827,0,0,309,2713,99,161,309,2874,"California",134098,0.00120061447598025,44768,0.65,21770,0.316
"1513","humboldt",1513,"2021-01-08",420,3479,281,2513,139,966,0,0,285,2867,131,292,285,3159,"California",134098,0.0021775119688586,44768,0.65,21770,0.316
"1514","humboldt",1514,"2021-01-09",69,3548,45,2558,24,990,0,0,66,2931,3,295,67,3226,"California",134098,0.00219988366716879,44768,0.65,21770,0.316
"1515","humboldt",1515,"2021-01-10",84,3632,84,2642,0,990,0,0,4,2855,80,375,4,3230,"California",134098,0.00279646228877388,44768,0.65,21770,0.316
"1516","humboldt",1516,"2021-01-11",289,3921,278,2920,11,1001,0,0,72,2714,213,588,72,3302,"California",134098,0.00438485286879745,44768,0.65,21770,0.316
"1517","humboldt",1517,"2021-01-12",482,4403,319,3239,163,1164,0,0,298,2850,162,750,298,3600,"California",134098,0.00559292457754776,44768,0.65,21770,0.316
"1518","humboldt",1518,"2021-01-13",488,4891,275,3514,213,1377,0,0,311,2988,174,924,312,3912,"California",134098,0.00689048307953884,44768,0.65,21770,0.316
"1519","humboldt",1519,"2021-01-14",521,5412,164,3678,357,1734,0,0,465,3398,56,980,466,4378,"California",134098,0.00730808811466241,44768,0.65,21770,0.316
"1520","humboldt",1520,"2021-01-15",374,5786,39,3717,335,2069,0,0,357,3738,17,997,357,4735,"California",134098,0.00743486107175349,44768,0.65,21770,0.316
"1521","humboldt",1521,"2021-01-16",170,5956,6,3723,164,2233,0,0,169,3906,1,998,169,4904,"California",134098,0.00744231830452356,44768,0.65,21770,0.316
"1522","humboldt",1522,"2021-01-17",6,5962,4,3727,2,2235,0,0,6,3912,0,998,6,4910,"California",134098,0.00744231830452356,44768,0.65,21770,0.316
"1523","humboldt",1523,"2021-01-18",294,6256,259,3986,35,2270,0,0,144,3906,150,1148,144,5054,"California",134098,0.00856090322003311,44768,0.65,21770,0.316
"1524","humboldt",1524,"2021-01-19",625,6881,372,4358,253,2523,0,0,498,4283,121,1269,498,5552,"California",134098,0.00946322838521082,44768,0.65,21770,0.316
"1525","humboldt",1525,"2021-01-20",915,7796,405,4763,510,3033,0,0,767,4912,140,1409,769,6321,"California",134098,0.0105072409730197,44768,0.65,21770,0.316
"1526","humboldt",1526,"2021-01-21",959,8755,261,5024,698,3731,0,0,917,5787,42,1451,917,7238,"California",134098,0.0108204447493624,44768,0.65,21770,0.316
"1527","humboldt",1527,"2021-01-22",676,9431,376,5400,300,4031,0,0,668,6447,8,1459,668,7906,"California",134098,0.0108801026115229,44768,0.65,21770,0.316
"1528","humboldt",1528,"2021-01-23",812,10243,272,5672,540,4571,0,0,803,7242,9,1468,804,8710,"California",134098,0.0109472177064535,44768,0.65,21770,0.316
"1529","humboldt",1529,"2021-01-24",226,10469,1,5673,225,4796,0,0,225,7466,1,1469,225,8935,"California",134098,0.0109546749392236,44768,0.65,21770,0.316
"1530","humboldt",1530,"2021-01-25",305,10774,233,5906,72,4868,0,0,149,7459,156,1625,149,9084,"California",134098,0.0121180032513535,44768,0.65,21770,0.316
"1531","humboldt",1531,"2021-01-26",526,11300,141,6047,385,5253,0,0,476,7885,50,1675,476,9560,"California",134098,0.0124908648898567,44768,0.65,21770,0.316
"1532","humboldt",1532,"2021-01-27",1260,12560,587,6634,673,5926,0,0,1194,9022,59,1734,1196,10756,"California",134098,0.0129308416232904,44768,0.65,21770,0.316
"1533","humboldt",1533,"2021-01-28",1456,14016,634,7268,822,6748,0,0,1320,10211,133,1867,1322,12078,"California",134098,0.0139226535817089,44768,0.65,21770,0.316
"1534","humboldt",1534,"2021-01-29",1131,15147,546,7814,585,7333,0,0,703,10487,428,2295,704,12782,"California",134098,0.0171143492072962,44768,0.65,21770,0.316
"1535","humboldt",1535,"2021-01-30",974,16121,457,8271,517,7850,0,0,961,11436,13,2308,962,13744,"California",134098,0.017211293233307,44768,0.65,21770,0.316
"1536","humboldt",1536,"2021-01-31",313,16434,312,8583,1,7851,0,0,312,11747,1,2309,312,14056,"California",134098,0.017218750466077,44768,0.65,21770,0.316
"1537","humboldt",1537,"2021-02-01",333,16767,192,8775,141,7992,0,0,189,11793,143,2452,189,14245,"California",134098,0.0182851347521962,44768,0.65,21770,0.316
"1538","humboldt",1538,"2021-02-02",444,17211,74,8849,370,8362,0,0,339,12032,102,2554,341,14586,"California",134098,0.0190457724947427,44768,0.65,21770,0.316
"1539","humboldt",1539,"2021-02-03",655,17866,257,9106,398,8760,0,0,505,12387,150,2704,505,15091,"California",134098,0.0201643574102522,44768,0.65,21770,0.316
"1540","humboldt",1540,"2021-02-04",638,18504,262,9368,376,9136,0,0,441,12634,194,2898,441,15532,"California",134098,0.0216110605676446,44768,0.65,21770,0.316
"1541","humboldt",1541,"2021-02-05",811,19315,94,9462,717,9853,0,0,625,13073,186,3084,625,16157,"California",134098,0.0229981058628764,44768,0.65,21770,0.316
"1542","humboldt",1542,"2021-02-06",1058,20373,446,9908,612,10465,0,0,1015,14047,42,3126,1016,17173,"California",134098,0.0233113096392191,44768,0.65,21770,0.316
"1543","humboldt",1543,"2021-02-07",379,20752,9,9917,370,10835,0,0,374,14418,4,3130,375,17548,"California",134098,0.0233411385702993,44768,0.65,21770,0.316
"1544","humboldt",1544,"2021-02-08",325,21077,142,10059,183,11018,0,0,184,14462,140,3270,184,17732,"California",134098,0.0243851511581082,44768,0.65,21770,0.316
"1545","humboldt",1545,"2021-02-09",494,21571,220,10279,274,11292,0,0,179,14326,315,3585,179,17911,"California",134098,0.0267341794806783,44768,0.65,21770,0.316
"1546","humboldt",1546,"2021-02-10",563,22134,370,10649,193,11485,0,0,232,14232,326,3911,232,18143,"California",134098,0.0291652373637191,44768,0.65,21770,0.316
"1547","humboldt",1547,"2021-02-11",1296,23430,395,11044,901,12386,0,0,503,13945,790,4701,503,18646,"California",134098,0.0350564512520694,44768,0.65,21770,0.316
"1548","humboldt",1548,"2021-02-12",1147,24577,736,11780,411,12797,0,0,707,14212,440,5141,707,19353,"California",134098,0.0383376336708974,44768,0.65,21770,0.316
"1549","humboldt",1549,"2021-02-13",1505,26082,557,12337,948,13745,0,0,916,14541,587,5728,916,20269,"California",134098,0.0427150293069248,44768,0.65,21770,0.316
"1550","humboldt",1550,"2021-02-14",112,26194,5,12342,107,13852,0,0,109,14648,2,5730,109,20378,"California",134098,0.0427299437724649,44768,0.65,21770,0.316
"1551","humboldt",1551,"2021-02-15",292,26486,78,12420,214,14066,0,0,195,14746,97,5827,195,20573,"California",134098,0.0434532953511611,44768,0.65,21770,0.316
"1552","humboldt",1552,"2021-02-16",534,27020,118,12538,416,14482,0,0,253,14719,281,6108,254,20827,"California",134098,0.045548777759549,44768,0.65,21770,0.316
"1553","humboldt",1553,"2021-02-17",453,27473,281,12819,172,14654,0,0,137,14541,315,6423,137,20964,"California",134098,0.047897806082119,44768,0.65,21770,0.316
"1554","humboldt",1554,"2021-02-18",969,28442,596,13415,373,15027,0,0,228,14030,739,7162,228,21192,"California",134098,0.0534087010991961,44768,0.65,21770,0.316
"1555","humboldt",1555,"2021-02-19",476,28918,434,13849,42,15069,0,0,89,13735,384,7546,89,21281,"California",134098,0.0562722784829006,44768,0.65,21770,0.316
"1556","humboldt",1556,"2021-02-20",1593,30511,983,14832,610,15679,0,0,475,13097,1115,8661,477,21758,"California",134098,0.0645870930215216,44768,0.65,21770,0.316
"1557","humboldt",1557,"2021-02-21",479,30990,471,15303,8,15687,0,0,183,12985,296,8957,184,21942,"California",134098,0.0667944339214604,44768,0.65,21770,0.316
"1558","humboldt",1558,"2021-02-22",127,31117,92,15395,35,15722,0,0,28,12916,97,9054,28,21970,"California",134098,0.0675177855001566,44768,0.65,21770,0.316
"1559","humboldt",1559,"2021-02-23",173,31290,70,15465,103,15825,0,0,40,12825,131,9185,40,22010,"California",134098,0.0684946829930349,44768,0.65,21770,0.316
"1560","humboldt",1560,"2021-02-24",1164,32454,705,16170,459,16284,0,0,586,12834,577,9762,586,22596,"California",134098,0.0727975063013617,44768,0.65,21770,0.316
"1561","humboldt",1561,"2021-02-25",832,33286,317,16487,515,16799,0,0,229,12462,601,10363,229,22825,"California",134098,0.07727930319617,44768,0.65,21770,0.316
"1562","humboldt",1562,"2021-02-26",2144,35430,106,16593,2038,18837,0,0,450,11225,1688,12051,451,23276,"California",134098,0.0898671121120375,44768,0.65,21770,0.316
"1563","humboldt",1563,"2021-02-27",1693,37123,1075,17668,618,19455,0,0,869,11276,822,12873,873,24149,"California",134098,0.0959969574490298,44768,0.65,21770,0.316
"1564","humboldt",1564,"2021-02-28",121,37244,11,17679,110,19565,0,0,117,11389,4,12877,117,24266,"California",134098,0.0960267863801101,44768,0.65,21770,0.316
"1565","humboldt",1565,"2021-03-01",259,37503,47,17726,212,19777,0,0,184,11498,75,12952,184,24450,"California",134098,0.0965860788378648,44768,0.65,21770,0.316
"1566","humboldt",1566,"2021-03-02",287,37790,48,17774,239,20016,0,0,157,11525,130,13082,157,24607,"California",134098,0.0975555190979731,44768,0.65,21770,0.316
"1567","humboldt",1567,"2021-03-03",1654,39444,1097,18871,557,20573,0,0,1223,12325,424,13506,1224,25831,"California",134098,0.10071738579248,44768,0.65,21770,0.316
"1568","humboldt",1568,"2021-03-04",899,40343,112,18983,787,21360,0,0,280,11988,619,14125,282,26113,"California",134098,0.10533341287715,44768,0.65,21770,0.316
"1569","humboldt",1569,"2021-03-05",943,41286,183,19166,749,22109,11,11,387,11834,552,14677,398,26511,"California",134098,0.109449805366225,44768,0.65,21770,0.316
"1570","humboldt",1570,"2021-03-06",1699,42985,841,20007,809,22918,49,60,713,11611,985,15662,762,27273,"California",134098,0.116795179644737,44768,0.65,21770,0.316
"1571","humboldt",1571,"2021-03-07",364,43349,296,20303,50,22968,18,78,157,11579,207,15869,175,27448,"California",134098,0.118338826828141,44768,0.65,21770,0.316
"1572","humboldt",1572,"2021-03-08",273,43622,7,20310,188,23156,78,156,179,11742,94,15963,257,27705,"California",134098,0.119039806708527,44768,0.65,21770,0.316
"1573","humboldt",1573,"2021-03-09",478,44100,203,20513,128,23284,147,303,230,11873,246,16209,377,28082,"California",134098,0.120874285969962,44768,0.65,21770,0.316
"1574","humboldt",1574,"2021-03-10",688,44788,466,20979,69,23353,153,456,419,12175,268,16477,570,28652,"California",134098,0.122872824352339,44768,0.65,21770,0.316
"1575","humboldt",1575,"2021-03-11",1446,46234,463,21442,884,24237,99,555,627,12084,816,17293,725,29377,"California",134098,0.128957926292711,44768,0.65,21770,0.316
"1576","humboldt",1576,"2021-03-12",1746,47980,1082,22524,442,24679,222,777,1053,12677,685,17978,1278,30655,"California",134098,0.134066130740205,44768,0.65,21770,0.316
"1577","humboldt",1577,"2021-03-13",1570,49550,1022,23546,496,25175,52,829,676,12517,888,18866,728,31383,"California",134098,0.140688153440021,44768,0.65,21770,0.316
"1578","humboldt",1578,"2021-03-14",142,49692,18,23564,115,25290,9,838,28,12440,114,18980,37,31420,"California",134098,0.141538277975809,44768,0.65,21770,0.316
"1579","humboldt",1579,"2021-03-15",275,49967,51,23615,204,25494,20,858,59,12303,216,19196,79,31499,"California",134098,0.143149040254142,44768,0.65,21770,0.316
"1580","humboldt",1580,"2021-03-16",633,50600,200,23815,173,25667,260,1118,259,12447,373,19569,517,32016,"California",134098,0.145930588077376,44768,0.65,21770,0.316
"1581","humboldt",1581,"2021-03-17",731,51331,397,24212,226,25893,108,1226,338,12501,392,19961,446,32462,"California",134098,0.148853823323241,44768,0.65,21770,0.316
"1582","humboldt",1582,"2021-03-18",1735,53066,1166,25378,526,26419,43,1269,1041,12896,689,20650,1084,33546,"California",134098,0.153991856701815,44768,0.65,21770,0.316
"1583","humboldt",1583,"2021-03-19",1073,54139,58,25436,701,27120,314,1583,439,13017,631,21281,752,34298,"California",134098,0.158697370579725,44768,0.65,21770,0.316
"1584","humboldt",1584,"2021-03-20",1375,55514,751,26187,611,27731,13,1596,428,12514,945,22226,442,34740,"California",134098,0.165744455547435,44768,0.65,21770,0.316
"1585","humboldt",1585,"2021-03-21",248,55762,33,26220,186,27917,29,1625,201,12697,47,22273,230,34970,"California",134098,0.166094945487628,44768,0.65,21770,0.316
"1586","humboldt",1586,"2021-03-22",114,55876,15,26235,49,27966,50,1675,57,12749,55,22328,107,35077,"California",134098,0.166505093289982,44768,0.65,21770,0.316
"1587","humboldt",1587,"2021-03-23",411,56287,41,26276,327,28293,43,1718,320,13023,89,22417,363,35440,"California",134098,0.167168787006518,44768,0.65,21770,0.316
"1588","humboldt",1588,"2021-03-24",1414,57701,389,26665,977,29270,48,1766,1037,13737,369,22786,1083,36523,"California",134098,0.169920505898671,44768,0.65,21770,0.316
"1589","humboldt",1589,"2021-03-25",1832,59533,1207,27872,563,29833,62,1828,946,13861,884,23670,1008,37531,"California",134098,0.176512699667407,44768,0.65,21770,0.316
"1590","humboldt",1590,"2021-03-26",2036,61569,437,28309,1543,31376,56,1884,1595,15075,436,24106,1650,39181,"California",134098,0.179764053155155,44768,0.65,21770,0.316
"1591","humboldt",1591,"2021-03-27",1939,63508,1437,29746,333,31709,169,2053,1068,15445,867,24973,1237,40418,"California",134098,0.1862294739668,44768,0.65,21770,0.316
"1592","humboldt",1592,"2021-03-28",267,63775,81,29827,115,31824,71,2124,85,15420,182,25155,157,40575,"California",134098,0.187586690330952,44768,0.65,21770,0.316
"1593","humboldt",1593,"2021-03-29",467,64242,126,29953,246,32070,95,2219,198,15444,268,25423,292,40867,"California",134098,0.189585228713329,44768,0.65,21770,0.316
"1594","humboldt",1594,"2021-03-30",939,65181,304,30257,521,32591,114,2333,564,15750,371,25794,677,41544,"California",134098,0.192351862071023,44768,0.65,21770,0.316
"1595","humboldt",1595,"2021-03-31",1853,67034,519,30776,1238,33829,96,2429,1401,16800,449,26243,1499,43043,"California",134098,0.195700159584781,44768,0.65,21770,0.316
"1596","humboldt",1596,"2021-04-01",2103,69137,703,31479,1308,35137,92,2521,1478,17753,618,26861,1571,44614,"California",134098,0.200308729436681,44768,0.65,21770,0.316
"1597","humboldt",1597,"2021-04-02",1700,70837,1099,32578,497,35634,104,2625,603,17369,1091,27952,707,45321,"California",134098,0.20844457038882,44768,0.65,21770,0.316
"1598","humboldt",1598,"2021-04-03",1654,72491,1496,34074,142,35776,16,2641,661,17063,983,28935,677,45998,"California",134098,0.215775030201793,44768,0.65,21770,0.316
"1599","humboldt",1599,"2021-04-04",480,72971,369,34443,102,35878,9,2650,404,17401,76,29011,414,46412,"California",134098,0.216341779892318,44768,0.65,21770,0.316
"1600","humboldt",1600,"2021-04-05",771,73742,456,34899,267,36145,48,2698,438,17556,331,29342,486,46898,"California",134098,0.218810123939209,44768,0.65,21770,0.316
"1601","humboldt",1601,"2021-04-06",834,74576,316,35215,384,36529,134,2832,585,18030,243,29585,717,47615,"California",134098,0.220622231502334,44768,0.65,21770,0.316
"1602","humboldt",1602,"2021-04-07",1490,76066,1058,36273,293,36822,139,2971,987,18655,501,30086,1126,48741,"California",134098,0.224358305120136,44768,0.65,21770,0.316
"1603","humboldt",1603,"2021-04-08",1724,77790,1085,37358,481,37303,158,3129,732,18555,990,31076,890,49631,"California",134098,0.231740965562499,44768,0.65,21770,0.316
"1604","humboldt",1604,"2021-04-09",1424,79214,433,37791,838,38141,153,3282,1141,19560,282,31358,1287,50918,"California",134098,0.233843905203657,44768,0.65,21770,0.316
"1605","humboldt",1605,"2021-04-10",926,80140,135,37926,616,38757,175,3457,728,20265,196,31554,901,51819,"California",134098,0.23530552282659,44768,0.65,21770,0.316
"1606","humboldt",1606,"2021-04-11",638,80778,138,38064,34,38791,466,3923,127,20346,511,32065,592,52411,"California",134098,0.239116168772092,44768,0.65,21770,0.316
"1607","humboldt",1607,"2021-04-12",431,81209,224,38288,83,38874,124,4047,275,20589,156,32221,399,52810,"California",134098,0.240279497084222,44768,0.65,21770,0.316
"1608","humboldt",1608,"2021-04-13",582,81791,322,38610,257,39131,3,4050,547,21107,31,32252,549,53359,"California",134098,0.240510671300094,44768,0.65,21770,0.316
"1609","humboldt",1609,"2021-04-14",1420,83211,1030,39640,390,39521,0,4050,1309,22306,110,32362,1309,54668,"California",134098,0.241330966904801,44768,0.65,21770,0.316
"1610","humboldt",1610,"2021-04-15",1809,85020,1194,40834,611,40132,4,4054,1242,23001,549,32911,1244,55912,"California",134098,0.245424987695566,44768,0.65,21770,0.316
"1611","humboldt",1611,"2021-04-16",1119,86139,514,41348,605,40737,0,4054,537,22959,579,33490,537,56449,"California",134098,0.249742725469433,44768,0.65,21770,0.316
"1612","humboldt",1612,"2021-04-17",1600,87739,1277,42625,323,41060,0,4054,1013,23391,581,34071,1013,57462,"California",134098,0.25407537770884,44768,0.65,21770,0.316
"1613","humboldt",1613,"2021-04-18",537,88276,342,42967,195,41255,0,4054,93,23044,440,34511,93,57555,"California",134098,0.257356560127668,44768,0.65,21770,0.316
"1614","humboldt",1614,"2021-04-19",186,88462,83,43050,103,41358,0,4054,71,23002,113,34624,71,57626,"California",134098,0.258199227430685,44768,0.65,21770,0.316
"1615","humboldt",1615,"2021-04-20",476,88938,133,43183,343,41701,0,4054,234,22995,241,34865,234,57860,"California",134098,0.25999642052827,44768,0.65,21770,0.316
"1616","humboldt",1616,"2021-04-21",1080,90018,374,43557,706,42407,0,4054,426,22778,644,35509,427,58287,"California",134098,0.264798878432191,44768,0.65,21770,0.316
"1617","humboldt",1617,"2021-04-22",872,90890,520,44077,350,42757,2,4056,439,22786,431,35940,439,58726,"California",134098,0.268012945756089,44768,0.65,21770,0.316
"1618","humboldt",1618,"2021-04-23",2147,93037,299,44376,1848,44605,0,4056,315,21272,1829,37769,315,59041,"California",134098,0.281652224492535,44768,0.65,21770,0.316
"1619","humboldt",1619,"2021-04-24",1014,94051,875,45251,134,44739,5,4061,349,20963,663,38432,354,59395,"California",134098,0.286596369819088,44768,0.65,21770,0.316
"1620","humboldt",1620,"2021-04-25",373,94424,238,45489,135,44874,0,4061,193,20979,177,38609,193,59588,"California",134098,0.287916300019389,44768,0.65,21770,0.316
"1621","humboldt",1621,"2021-04-26",265,94689,186,45675,76,44950,3,4064,79,20875,184,38793,80,59668,"California",134098,0.289288430849081,44768,0.65,21770,0.316
"1622","humboldt",1622,"2021-04-27",635,95324,192,45867,425,45375,18,4082,126,20512,507,39300,144,59812,"California",134098,0.293069247863503,44768,0.65,21770,0.316
"1623","humboldt",1623,"2021-04-28",1521,96845,789,46656,688,46063,44,4126,393,19823,1126,40426,437,60249,"California",134098,0.301466091962594,44768,0.65,21770,0.316
"1624","humboldt",1624,"2021-04-29",1712,98557,569,47225,1105,47168,38,4164,268,18689,1440,41866,306,60555,"California",134098,0.312204507151486,44768,0.65,21770,0.316
"1625","humboldt",1625,"2021-04-30",1229,99786,385,47610,811,47979,33,4197,194,17885,1029,42895,225,60780,"California",134098,0.319877999671882,44768,0.65,21770,0.316
"1626","humboldt",1626,"2021-05-01",457,100243,378,47988,57,48036,22,4219,284,18019,172,43067,306,61086,"California",134098,0.321160643708333,44768,0.65,21770,0.316
"1627","humboldt",1627,"2021-05-02",227,100470,182,48170,36,48072,9,4228,113,18029,113,43180,123,61209,"California",134098,0.32200331101135,44768,0.65,21770,0.316
"1628","humboldt",1628,"2021-05-03",602,101072,373,48543,206,48278,23,4251,95,17642,505,43685,118,61327,"California",134098,0.325769213560232,44768,0.65,21770,0.316
"1629","humboldt",1629,"2021-05-04",797,101869,476,49019,279,48557,42,4293,241,17371,553,44238,282,61609,"California",134098,0.329893063282077,44768,0.65,21770,0.316
"1630","humboldt",1630,"2021-05-05",1685,103554,1083,50102,545,49102,57,4350,180,16108,1498,45736,235,61844,"California",134098,0.341063997971633,44768,0.65,21770,0.316
"1631","humboldt",1631,"2021-05-06",1629,105183,1044,51146,339,49441,246,4596,127,14982,1499,47235,373,62217,"California",134098,0.352242389893958,44768,0.65,21770,0.316
"1632","humboldt",1632,"2021-05-07",1407,106590,303,51449,1048,50489,56,4652,233,14097,1172,48407,287,62504,"California",134098,0.360982266700473,44768,0.65,21770,0.316
"1633","humboldt",1633,"2021-05-08",694,107284,105,51554,568,51057,21,4673,84,13593,609,49016,105,62609,"California",134098,0.365523721457442,44768,0.65,21770,0.316
"1634","imperial",1634,"2020-12-16",1,1,1,1,0,0,0,0,1,1,0,0,1,1,"California",191649,0,34678,0.611,20847,0.368
"1635","imperial",1635,"2020-12-17",4,5,4,5,0,0,0,0,4,5,0,0,4,5,"California",191649,0,34678,0.611,20847,0.368
"1636","imperial",1636,"2020-12-18",12,17,12,17,0,0,0,0,12,17,0,0,12,17,"California",191649,0,34678,0.611,20847,0.368
"1637","imperial",1637,"2020-12-20",2,19,2,19,0,0,0,0,2,19,0,0,2,19,"California",191649,0,34678,0.611,20847,0.368
"1638","imperial",1638,"2020-12-21",186,205,186,205,0,0,0,0,186,205,0,0,186,205,"California",191649,0,34678,0.611,20847,0.368
"1639","imperial",1639,"2020-12-22",241,446,239,444,2,2,0,0,241,446,0,0,241,446,"California",191649,0,34678,0.611,20847,0.368
"1640","imperial",1640,"2020-12-23",210,656,209,653,1,3,0,0,209,655,0,0,209,655,"California",191649,0,34678,0.611,20847,0.368
"1641","imperial",1641,"2020-12-24",5,661,5,658,0,3,0,0,5,660,0,0,5,660,"California",191649,0,34678,0.611,20847,0.368
"1642","imperial",1642,"2020-12-26",1,662,0,658,1,4,0,0,1,661,0,0,1,661,"California",191649,0,34678,0.611,20847,0.368
"1643","imperial",1643,"2020-12-27",62,724,0,658,62,66,0,0,62,723,0,0,62,723,"California",191649,0,34678,0.611,20847,0.368
"1644","imperial",1644,"2020-12-28",214,938,114,772,100,166,0,0,214,937,0,0,214,937,"California",191649,0,34678,0.611,20847,0.368
"1645","imperial",1645,"2020-12-29",189,1127,36,808,153,319,0,0,189,1126,0,0,189,1126,"California",191649,0,34678,0.611,20847,0.368
"1646","imperial",1646,"2020-12-30",366,1493,50,858,316,635,0,0,366,1492,0,0,366,1492,"California",191649,0,34678,0.611,20847,0.368
"1647","imperial",1647,"2020-12-31",197,1690,26,884,171,806,0,0,197,1689,0,0,197,1689,"California",191649,0,34678,0.611,20847,0.368
"1648","imperial",1648,"2021-01-01",47,1737,5,889,42,848,0,0,47,1736,0,0,47,1736,"California",191649,0,34678,0.611,20847,0.368
"1649","imperial",1649,"2021-01-02",4,1741,0,889,4,852,0,0,4,1740,0,0,4,1740,"California",191649,0,34678,0.611,20847,0.368
"1650","imperial",1650,"2021-01-03",90,1831,0,889,90,942,0,0,90,1830,0,0,90,1830,"California",191649,0,34678,0.611,20847,0.368
"1651","imperial",1651,"2021-01-04",85,1916,5,894,80,1022,0,0,85,1915,0,0,85,1915,"California",191649,0,34678,0.611,20847,0.368
"1652","imperial",1652,"2021-01-05",173,2089,14,908,159,1181,0,0,173,2088,0,0,173,2088,"California",191649,0,34678,0.611,20847,0.368
"1653","imperial",1653,"2021-01-06",190,2279,25,933,165,1346,0,0,189,2276,1,1,189,2277,"California",191649,5.21787225605143e-06,34678,0.611,20847,0.368
"1654","imperial",1654,"2021-01-07",319,2598,9,942,310,1656,0,0,316,2589,3,4,316,2593,"California",191649,2.08714890242057e-05,34678,0.611,20847,0.368
"1655","imperial",1655,"2021-01-08",192,2790,52,994,140,1796,0,0,182,2761,10,14,182,2775,"California",191649,7.305021158472e-05,34678,0.611,20847,0.368
"1656","imperial",1656,"2021-01-09",24,2814,21,1015,3,1799,0,0,24,2785,0,14,24,2799,"California",191649,7.305021158472e-05,34678,0.611,20847,0.368
"1657","imperial",1657,"2021-01-10",1,2815,0,1015,1,1800,0,0,1,2786,0,14,1,2800,"California",191649,7.305021158472e-05,34678,0.611,20847,0.368
"1658","imperial",1658,"2021-01-11",402,3217,243,1258,159,1959,0,0,174,2732,228,242,174,2974,"California",191649,0.00126272508596445,34678,0.611,20847,0.368
"1659","imperial",1659,"2021-01-12",404,3621,302,1560,102,2061,0,0,142,2613,261,503,142,3116,"California",191649,0.00262458974479387,34678,0.611,20847,0.368
"1660","imperial",1660,"2021-01-13",379,4000,132,1692,247,2308,0,0,280,2794,99,602,280,3396,"California",191649,0.00314115909814296,34678,0.611,20847,0.368
"1661","imperial",1661,"2021-01-14",260,4260,151,1843,109,2417,0,0,254,3043,5,607,254,3650,"California",191649,0.00316724845942322,34678,0.611,20847,0.368
"1662","imperial",1662,"2021-01-15",241,4501,182,2025,59,2476,0,0,234,3270,7,614,234,3884,"California",191649,0.00320377356521558,34678,0.611,20847,0.368
"1663","imperial",1663,"2021-01-16",77,4578,73,2098,4,2480,0,0,76,3345,1,615,76,3960,"California",191649,0.00320899143747163,34678,0.611,20847,0.368
"1664","imperial",1664,"2021-01-17",10,4588,2,2100,8,2488,0,0,10,3355,0,615,10,3970,"California",191649,0.00320899143747163,34678,0.611,20847,0.368
"1665","imperial",1665,"2021-01-18",1053,5641,399,2499,654,3142,0,0,955,4213,98,713,956,4926,"California",191649,0.00372034291856467,34678,0.611,20847,0.368
"1666","imperial",1666,"2021-01-19",165,5806,129,2628,36,3178,0,0,118,4284,47,760,118,5044,"California",191649,0.00396558291459908,34678,0.611,20847,0.368
"1667","imperial",1667,"2021-01-20",292,6098,195,2823,97,3275,0,0,254,4500,38,798,254,5298,"California",191649,0.00416386206032904,34678,0.611,20847,0.368
"1668","imperial",1668,"2021-01-21",415,6513,183,3006,232,3507,0,0,395,4875,20,818,395,5693,"California",191649,0.00426821950545007,34678,0.611,20847,0.368
"1669","imperial",1669,"2021-01-22",457,6970,189,3195,268,3775,0,0,448,5314,9,827,448,6141,"California",191649,0.00431518035575453,34678,0.611,20847,0.368
"1670","imperial",1670,"2021-01-23",1041,8011,290,3485,751,4526,0,0,1040,6353,1,828,1040,7181,"California",191649,0.00432039822801058,34678,0.611,20847,0.368
"1671","imperial",1671,"2021-01-24",11,8022,4,3489,7,4533,0,0,11,6364,0,828,11,7192,"California",191649,0.00432039822801058,34678,0.611,20847,0.368
"1672","imperial",1672,"2021-01-25",213,8235,5,3494,208,4741,0,0,34,6220,178,1006,34,7226,"California",191649,0.00524917948958774,34678,0.611,20847,0.368
"1673","imperial",1673,"2021-01-26",360,8595,185,3679,175,4916,0,0,217,6294,143,1149,217,7443,"California",191649,0.00599533522220309,34678,0.611,20847,0.368
"1674","imperial",1674,"2021-01-27",570,9165,162,3841,408,5324,0,0,237,6198,333,1482,237,7680,"California",191649,0.00773288668346822,34678,0.611,20847,0.368
"1675","imperial",1675,"2021-01-28",632,9797,159,4000,473,5797,0,0,525,6616,107,1589,525,8205,"California",191649,0.00829119901486572,34678,0.611,20847,0.368
"1676","imperial",1676,"2021-01-29",424,10221,296,4296,128,5925,0,0,374,6940,50,1639,374,8579,"California",191649,0.00855209262766829,34678,0.611,20847,0.368
"1677","imperial",1677,"2021-01-30",56,10277,31,4327,25,5950,0,0,39,6962,17,1656,39,8618,"California",191649,0.00864079645602116,34678,0.611,20847,0.368
"1678","imperial",1678,"2021-01-31",17,10294,7,4334,10,5960,0,0,16,6977,1,1657,16,8634,"California",191649,0.00864601432827721,34678,0.611,20847,0.368
"1679","imperial",1679,"2021-02-01",420,10714,54,4388,366,6326,0,0,209,6977,209,1866,209,8843,"California",191649,0.00973654962979196,34678,0.611,20847,0.368
"1680","imperial",1680,"2021-02-02",680,11394,54,4442,626,6952,0,0,499,7295,181,2047,499,9342,"California",191649,0.0106809845081373,34678,0.611,20847,0.368
"1681","imperial",1681,"2021-02-03",457,11851,48,4490,409,7361,0,0,264,7367,192,2239,264,9606,"California",191649,0.0116828159812991,34678,0.611,20847,0.368
"1682","imperial",1682,"2021-02-04",1723,13574,1203,5693,520,7881,0,0,1408,8462,313,2552,1408,11014,"California",191649,0.0133160099974432,34678,0.611,20847,0.368
"1683","imperial",1683,"2021-02-05",389,13963,241,5934,148,8029,0,0,152,8379,235,2787,152,11166,"California",191649,0.0145422099776153,34678,0.611,20847,0.368
"1684","imperial",1684,"2021-02-06",861,14824,838,6772,23,8052,0,0,824,9167,36,2823,824,11990,"California",191649,0.0147300533788332,34678,0.611,20847,0.368
"1685","imperial",1685,"2021-02-07",21,14845,9,6781,12,8064,0,0,20,9186,1,2824,20,12010,"California",191649,0.0147352712510892,34678,0.611,20847,0.368
"1686","imperial",1686,"2021-02-08",250,15095,42,6823,208,8272,0,0,182,9300,68,2892,182,12192,"California",191649,0.0150900865645007,34678,0.611,20847,0.368
"1687","imperial",1687,"2021-02-09",462,15557,146,6969,316,8588,0,0,304,9446,158,3050,304,12496,"California",191649,0.0159145103809569,34678,0.611,20847,0.368
"1688","imperial",1688,"2021-02-10",385,15942,56,7025,329,8917,0,0,95,9252,290,3340,96,12592,"California",191649,0.0174276933352118,34678,0.611,20847,0.368
"1689","imperial",1689,"2021-02-11",465,16407,259,7284,206,9123,0,0,89,8965,376,3716,89,12681,"California",191649,0.0193896133034871,34678,0.611,20847,0.368
"1690","imperial",1690,"2021-02-12",2130,18537,1411,8695,719,9842,0,0,1778,10392,351,4067,1778,14459,"California",191649,0.0212210864653612,34678,0.611,20847,0.368
"1691","imperial",1691,"2021-02-13",42,18579,18,8713,24,9866,0,0,34,10419,8,4075,35,14494,"California",191649,0.0212628294434096,34678,0.611,20847,0.368
"1692","imperial",1692,"2021-02-14",24,18603,12,8725,12,9878,0,0,21,10437,3,4078,21,14515,"California",191649,0.0212784830601777,34678,0.611,20847,0.368
"1693","imperial",1693,"2021-02-15",30,18633,10,8735,20,9898,0,0,23,10453,7,4085,23,14538,"California",191649,0.0213150081659701,34678,0.611,20847,0.368
"1694","imperial",1694,"2021-02-16",514,19147,267,9002,247,10145,0,0,293,10525,221,4306,293,14831,"California",191649,0.0224681579345574,34678,0.611,20847,0.368
"1695","imperial",1695,"2021-02-17",439,19586,285,9287,154,10299,0,0,83,10252,356,4662,83,14914,"California",191649,0.0243257204577118,34678,0.611,20847,0.368
"1696","imperial",1696,"2021-02-18",646,20232,308,9595,338,10637,0,0,140,9888,504,5166,140,15054,"California",191649,0.0269555280747617,34678,0.611,20847,0.368
"1697","imperial",1697,"2021-02-19",767,20999,382,9977,385,11022,0,0,192,9506,574,5740,192,15246,"California",191649,0.0299505867497352,34678,0.611,20847,0.368
"1698","imperial",1698,"2021-02-20",1039,22038,191,10168,848,11870,0,0,325,9120,713,6453,327,15573,"California",191649,0.0336709296682999,34678,0.611,20847,0.368
"1699","imperial",1699,"2021-02-21",588,22626,554,10722,34,11904,0,0,577,9687,10,6463,577,16150,"California",191649,0.0337231083908604,34678,0.611,20847,0.368
"1700","imperial",1700,"2021-02-22",807,23433,567,11289,240,12144,0,0,758,10396,49,6512,758,16908,"California",191649,0.0339787841314069,34678,0.611,20847,0.368
"1701","imperial",1701,"2021-02-23",960,24393,395,11684,565,12709,0,0,907,11250,53,6565,907,17815,"California",191649,0.0342553313609776,34678,0.611,20847,0.368
"1702","imperial",1702,"2021-02-24",700,25093,285,11969,415,13124,0,0,603,11757,96,6661,603,18418,"California",191649,0.0347562470975586,34678,0.611,20847,0.368
"1703","imperial",1703,"2021-02-25",818,25911,339,12308,479,13603,0,0,452,11849,365,7026,457,18875,"California",191649,0.0366607704710173,34678,0.611,20847,0.368
"1704","imperial",1704,"2021-02-26",1745,27656,1351,13659,394,13997,0,0,1570,13247,173,7199,1571,20446,"California",191649,0.0375634623713142,34678,0.611,20847,0.368
"1705","imperial",1705,"2021-02-27",860,28516,811,14470,49,14046,0,0,121,12630,739,7938,122,20568,"California",191649,0.0414194699685362,34678,0.611,20847,0.368
"1706","imperial",1706,"2021-02-28",31,28547,20,14490,11,14057,0,0,21,12641,10,7948,21,20589,"California",191649,0.0414716486910967,34678,0.611,20847,0.368
"1707","imperial",1707,"2021-03-01",495,29042,295,14785,199,14256,1,1,429,13008,64,8012,431,21020,"California",191649,0.041805592515484,34678,0.611,20847,0.368
"1708","imperial",1708,"2021-03-02",675,29717,247,15032,428,14684,0,1,385,13106,289,8301,387,21407,"California",191649,0.0433135575974829,34678,0.611,20847,0.368
"1709","imperial",1709,"2021-03-03",927,30644,49,15081,877,15561,1,2,558,13310,366,8667,570,21977,"California",191649,0.0452232988431977,34678,0.611,20847,0.368
"1710","imperial",1710,"2021-03-04",746,31390,76,15157,669,16230,1,3,485,13566,259,8926,515,22492,"California",191649,0.046574727757515,34678,0.611,20847,0.368
"1711","imperial",1711,"2021-03-05",2573,33963,1939,17096,634,16864,0,3,1248,13494,1322,10248,1250,23742,"California",191649,0.053472754880015,34678,0.611,20847,0.368
"1712","imperial",1712,"2021-03-06",690,34653,238,17334,452,17316,0,3,649,14109,38,10286,653,24395,"California",191649,0.053671034025745,34678,0.611,20847,0.368
"1713","imperial",1713,"2021-03-07",75,34728,41,17375,34,17350,0,3,54,14143,21,10307,55,24450,"California",191649,0.0537806093431221,34678,0.611,20847,0.368
"1714","imperial",1714,"2021-03-08",415,35143,331,17706,49,17399,35,38,362,14488,52,10359,397,24847,"California",191649,0.0540519387004367,34678,0.611,20847,0.368
"1715","imperial",1715,"2021-03-09",681,35824,310,18016,125,17524,246,284,398,14848,283,10642,643,25490,"California",191649,0.0555285965488993,34678,0.611,20847,0.368
"1716","imperial",1716,"2021-03-10",684,36508,313,18329,267,17791,104,388,320,14910,363,11005,425,25915,"California",191649,0.057422684177846,34678,0.611,20847,0.368
"1717","imperial",1717,"2021-03-11",1786,38294,477,18806,1117,18908,192,580,1184,15696,601,11606,1387,27302,"California",191649,0.0605586254037329,34678,0.611,20847,0.368
"1718","imperial",1718,"2021-03-12",3704,41998,2540,21346,978,19886,186,766,2105,16390,1597,13203,2291,29593,"California",191649,0.068891567396647,34678,0.611,20847,0.368
"1719","imperial",1719,"2021-03-13",1143,43141,92,21438,828,20714,223,989,857,17189,284,13487,1083,30676,"California",191649,0.0703734431173656,34678,0.611,20847,0.368
"1720","imperial",1720,"2021-03-14",169,43310,31,21469,126,20840,12,1001,139,17311,30,13517,152,30828,"California",191649,0.0705299792850471,34678,0.611,20847,0.368
"1721","imperial",1721,"2021-03-15",671,43981,214,21683,198,21038,259,1260,374,17649,295,13812,633,31461,"California",191649,0.0720692516005823,34678,0.611,20847,0.368
"1722","imperial",1722,"2021-03-16",1070,45051,275,21958,341,21379,454,1714,534,18101,534,14346,986,32447,"California",191649,0.0748555953853138,34678,0.611,20847,0.368
"1723","imperial",1723,"2021-03-17",1571,46622,689,22647,745,22124,137,1851,992,18655,576,14922,1130,33577,"California",191649,0.0778610898047994,34678,0.611,20847,0.368
"1724","imperial",1724,"2021-03-18",1780,48402,1177,23824,543,22667,60,1911,1251,19441,527,15449,1313,34890,"California",191649,0.0806109084837385,34678,0.611,20847,0.368
"1725","imperial",1725,"2021-03-19",3338,51740,2446,26270,888,23555,4,1915,1501,19118,1829,17278,1506,36396,"California",191649,0.0901543968400566,34678,0.611,20847,0.368
"1726","imperial",1726,"2021-03-20",864,52604,550,26820,309,23864,5,1920,420,19109,440,17718,431,36827,"California",191649,0.0924502606327192,34678,0.611,20847,0.368
"1727","imperial",1727,"2021-03-21",217,52821,35,26855,178,24042,4,1924,159,19218,58,17776,167,36994,"California",191649,0.0927528972235702,34678,0.611,20847,0.368
"1728","imperial",1728,"2021-03-22",1046,53867,339,27194,700,24742,7,1931,622,19426,423,18199,631,37625,"California",191649,0.0949600571878799,34678,0.611,20847,0.368
"1729","imperial",1729,"2021-03-23",1390,55257,411,27605,972,25714,7,1938,890,19828,497,18696,899,38524,"California",191649,0.0975533396991375,34678,0.611,20847,0.368
"1730","imperial",1730,"2021-03-24",1870,57127,542,28147,901,26615,427,2365,899,20185,968,19664,1325,39849,"California",191649,0.102604240042995,34678,0.611,20847,0.368
"1731","imperial",1731,"2021-03-25",2915,60042,506,28653,884,27499,1525,3890,1018,20827,1893,21557,2535,42384,"California",191649,0.112481672223701,34678,0.611,20847,0.368
"1732","imperial",1732,"2021-03-26",2488,62530,881,29534,736,28235,871,4761,776,20770,1705,23262,1648,44032,"California",191649,0.121378144420268,34678,0.611,20847,0.368
"1733","imperial",1733,"2021-03-27",596,63126,282,29816,262,28497,52,4813,436,21101,157,23419,488,44520,"California",191649,0.122197350364468,34678,0.611,20847,0.368
"1734","imperial",1734,"2021-03-28",209,63335,51,29867,156,28653,2,4815,171,21237,37,23456,173,44693,"California",191649,0.122390411637942,34678,0.611,20847,0.368
"1735","imperial",1735,"2021-03-29",1214,64549,348,30215,391,29044,475,5290,317,21135,895,24351,793,45486,"California",191649,0.127060407307108,34678,0.611,20847,0.368
"1736","imperial",1736,"2021-03-30",1819,66368,675,30890,592,29636,552,5842,675,21219,1144,25495,1228,46714,"California",191649,0.133029653168031,34678,0.611,20847,0.368
"1737","imperial",1737,"2021-03-31",1522,67890,712,31602,805,30441,5,5847,1005,21713,515,26010,1009,47723,"California",191649,0.135716857379898,34678,0.611,20847,0.368
"1738","imperial",1738,"2021-04-01",1913,69803,399,32001,1272,31713,242,6089,833,21713,1074,27084,1074,48797,"California",191649,0.141320852182897,34678,0.611,20847,0.368
"1739","imperial",1739,"2021-04-02",1266,71069,450,32451,742,32455,74,6163,749,22021,514,27598,822,49619,"California",191649,0.144002838522507,34678,0.611,20847,0.368
"1740","imperial",1740,"2021-04-03",1495,72564,408,32859,1008,33463,79,6242,687,21982,805,28403,766,50385,"California",191649,0.148203225688629,34678,0.611,20847,0.368
"1741","imperial",1741,"2021-04-04",84,72648,40,32899,28,33491,16,6258,25,21964,59,28462,41,50426,"California",191649,0.148511080151736,34678,0.611,20847,0.368
"1742","imperial",1742,"2021-04-05",2115,74763,1283,34182,765,34256,67,6325,403,20732,1704,30166,472,50898,"California",191649,0.157402334476047,34678,0.611,20847,0.368
"1743","imperial",1743,"2021-04-06",1294,76057,526,34708,579,34835,189,6514,681,20993,610,30776,871,51769,"California",191649,0.160585236552239,34678,0.611,20847,0.368
"1744","imperial",1744,"2021-04-07",2148,78205,549,35257,1223,36058,376,6890,1538,22300,607,31383,1914,53683,"California",191649,0.163752485011662,34678,0.611,20847,0.368
"1745","imperial",1745,"2021-04-08",2185,80390,1070,36327,821,36879,294,7184,1077,22564,1105,32488,1369,55052,"California",191649,0.169518233854599,34678,0.611,20847,0.368
"1746","imperial",1746,"2021-04-09",2147,82537,634,36961,897,37776,616,7800,837,22709,1306,33794,1451,56503,"California",191649,0.176332775021002,34678,0.611,20847,0.368
"1747","imperial",1747,"2021-04-10",1276,83813,184,37145,821,38597,271,8071,215,22134,1059,34853,484,56987,"California",191649,0.18185850174016,34678,0.611,20847,0.368
"1748","imperial",1748,"2021-04-11",218,84031,30,37175,156,38753,32,8103,75,22098,143,34996,107,57094,"California",191649,0.182604657472776,34678,0.611,20847,0.368
"1749","imperial",1749,"2021-04-12",1409,85440,762,37937,431,39184,216,8319,794,22499,611,35607,1012,58106,"California",191649,0.185792777421223,34678,0.611,20847,0.368
"1750","imperial",1750,"2021-04-13",2725,88165,1872,39809,851,40035,2,8321,2019,23816,702,36309,2019,60125,"California",191649,0.189455723744971,34678,0.611,20847,0.368
"1751","imperial",1751,"2021-04-14",2010,90175,940,40749,1070,41105,0,8321,1422,24656,583,36892,1423,61548,"California",191649,0.192497743270249,34678,0.611,20847,0.368
"1752","imperial",1752,"2021-04-15",1968,92143,908,41657,1060,42165,0,8321,1380,25454,584,37476,1382,62930,"California",191649,0.195544980667783,34678,0.611,20847,0.368
"1753","imperial",1753,"2021-04-16",2343,94486,1181,42838,1162,43327,0,8321,1425,25969,910,38386,1425,64355,"California",191649,0.20029324442079,34678,0.611,20847,0.368
"1754","imperial",1754,"2021-04-17",1807,96293,926,43764,879,44206,2,8323,1424,27018,378,38764,1427,65782,"California",191649,0.202265600133578,34678,0.611,20847,0.368
"1755","imperial",1755,"2021-04-18",251,96544,70,43834,181,44387,0,8323,91,26950,159,38923,91,65873,"California",191649,0.20309524182229,34678,0.611,20847,0.368
"1756","imperial",1756,"2021-04-19",825,97369,263,44097,562,44949,0,8323,486,27102,338,39261,490,66363,"California",191649,0.204858882644835,34678,0.611,20847,0.368
"1757","imperial",1757,"2021-04-20",1308,98677,515,44612,793,45742,0,8323,768,27333,537,39798,768,67131,"California",191649,0.207660880046335,34678,0.611,20847,0.368
"1758","imperial",1758,"2021-04-21",1361,100038,334,44946,1027,46769,0,8323,821,27617,537,40335,821,67952,"California",191649,0.210462877447834,34678,0.611,20847,0.368
"1759","imperial",1759,"2021-04-22",2034,102072,782,45728,1252,48021,0,8323,1431,28455,595,40930,1433,69385,"California",191649,0.213567511440185,34678,0.611,20847,0.368
"1760","imperial",1760,"2021-04-23",1667,103739,408,46136,1259,49280,0,8323,872,28560,771,41701,876,70261,"California",191649,0.217590490949601,34678,0.611,20847,0.368
"1761","imperial",1761,"2021-04-24",533,104272,314,46450,219,49499,0,8323,205,28439,326,42027,205,70466,"California",191649,0.219291517305073,34678,0.611,20847,0.368
"1762","imperial",1762,"2021-04-25",263,104535,96,46546,167,49666,0,8323,135,28447,127,42154,135,70601,"California",191649,0.219954187081592,34678,0.611,20847,0.368
"1763","imperial",1763,"2021-04-26",1047,105582,443,46989,601,50267,3,8326,671,28746,375,42529,674,71275,"California",191649,0.221910889177611,34678,0.611,20847,0.368
"1764","imperial",1764,"2021-04-27",939,106521,338,47327,593,50860,8,8334,476,28768,462,42991,484,71759,"California",191649,0.224321546159907,34678,0.611,20847,0.368
"1765","imperial",1765,"2021-04-28",1303,107824,595,47922,682,51542,26,8360,628,28751,671,43662,654,72413,"California",191649,0.227822738443717,34678,0.611,20847,0.368
"1766","imperial",1766,"2021-04-29",1738,109562,845,48767,846,52388,47,8407,791,28650,940,44602,839,73252,"California",191649,0.232727538364406,34678,0.611,20847,0.368
"1767","imperial",1767,"2021-04-30",1420,110982,728,49495,662,53050,30,8437,1022,29309,393,44995,1052,74304,"California",191649,0.234778162161034,34678,0.611,20847,0.368
"1768","imperial",1768,"2021-05-01",302,111284,116,49611,184,53234,2,8439,154,29318,148,45143,157,74461,"California",191649,0.23555040725493,34678,0.611,20847,0.368
"1769","imperial",1769,"2021-05-02",83,111367,25,49636,56,53290,2,8441,53,29344,30,45173,56,74517,"California",191649,0.235706943422611,34678,0.611,20847,0.368
"1770","imperial",1770,"2021-05-03",1558,112925,546,50182,965,54255,47,8488,355,28551,1196,46369,403,74920,"California",191649,0.241947518640849,34678,0.611,20847,0.368
"1771","imperial",1771,"2021-05-04",1599,114524,859,51041,718,54973,22,8510,474,27927,1121,47490,497,75417,"California",191649,0.247796753439882,34678,0.611,20847,0.368
"1772","imperial",1772,"2021-05-05",1463,115987,885,51926,558,55531,20,8530,430,27354,1024,48514,451,75868,"California",191649,0.253139854630079,34678,0.611,20847,0.368
"1773","imperial",1773,"2021-05-06",1568,117555,1108,53034,432,55963,28,8558,508,26836,1054,49568,536,76404,"California",191649,0.258639491987957,34678,0.611,20847,0.368
"1774","imperial",1774,"2021-05-07",1484,119039,906,53940,541,56504,37,8595,606,26607,872,50440,643,77047,"California",191649,0.263189476595234,34678,0.611,20847,0.368
"1775","imperial",1775,"2021-05-08",367,119406,236,54176,123,56627,8,8603,136,26526,225,50665,144,77191,"California",191649,0.264363497852846,34678,0.611,20847,0.368
"1776","inyo",1776,"2020-12-19",85,85,85,85,0,0,0,0,85,85,0,0,85,85,"California",18453,0,4634,0.489,4620,0.487
"1777","inyo",1777,"2020-12-20",58,143,58,143,0,0,0,0,58,143,0,0,58,143,"California",18453,0,4634,0.489,4620,0.487
"1778","inyo",1778,"2020-12-21",88,231,85,228,3,3,0,0,88,231,0,0,88,231,"California",18453,0,4634,0.489,4620,0.487
"1779","inyo",1779,"2020-12-22",105,336,105,333,0,3,0,0,105,336,0,0,105,336,"California",18453,0,4634,0.489,4620,0.487
"1780","inyo",1780,"2020-12-23",70,406,67,400,3,6,0,0,70,406,0,0,70,406,"California",18453,0,4634,0.489,4620,0.487
"1781","inyo",1781,"2020-12-24",16,422,16,416,0,6,0,0,16,422,0,0,16,422,"California",18453,0,4634,0.489,4620,0.487
"1782","inyo",1782,"2020-12-25",1,423,0,416,1,7,0,0,1,423,0,0,1,423,"California",18453,0,4634,0.489,4620,0.487
"1783","inyo",1783,"2020-12-26",74,497,74,490,0,7,0,0,74,497,0,0,74,497,"California",18453,0,4634,0.489,4620,0.487
"1784","inyo",1784,"2020-12-28",48,545,36,526,12,19,0,0,48,545,0,0,48,545,"California",18453,0,4634,0.489,4620,0.487
"1785","inyo",1785,"2020-12-29",19,564,19,545,0,19,0,0,19,564,0,0,19,564,"California",18453,0,4634,0.489,4620,0.487
"1786","inyo",1786,"2020-12-30",56,620,54,599,2,21,0,0,56,620,0,0,56,620,"California",18453,0,4634,0.489,4620,0.487
"1787","inyo",1787,"2020-12-31",29,649,0,599,29,50,0,0,29,649,0,0,29,649,"California",18453,0,4634,0.489,4620,0.487
"1788","inyo",1788,"2021-01-01",1,650,0,599,1,51,0,0,1,650,0,0,1,650,"California",18453,0,4634,0.489,4620,0.487
"1789","inyo",1789,"2021-01-03",1,651,0,599,1,52,0,0,1,651,0,0,1,651,"California",18453,0,4634,0.489,4620,0.487
"1790","inyo",1790,"2021-01-04",2,653,1,600,1,53,0,0,2,653,0,0,2,653,"California",18453,0,4634,0.489,4620,0.487
"1791","inyo",1791,"2021-01-05",34,687,0,600,34,87,0,0,34,687,0,0,34,687,"California",18453,0,4634,0.489,4620,0.487
"1792","inyo",1792,"2021-01-06",68,755,0,600,68,155,0,0,68,755,0,0,68,755,"California",18453,0,4634,0.489,4620,0.487
"1793","inyo",1793,"2021-01-07",31,786,1,601,30,185,0,0,31,786,0,0,31,786,"California",18453,0,4634,0.489,4620,0.487
"1794","inyo",1794,"2021-01-08",9,795,8,609,1,186,0,0,4,786,5,5,5,791,"California",18453,0.000270958651709749,4634,0.489,4620,0.487
"1795","inyo",1795,"2021-01-09",87,882,86,695,1,187,0,0,1,701,86,91,1,792,"California",18453,0.00493144746111743,4634,0.489,4620,0.487
"1796","inyo",1796,"2021-01-10",52,934,52,747,0,187,0,0,0,649,52,143,0,792,"California",18453,0.00774941743889882,4634,0.489,4620,0.487
"1797","inyo",1797,"2021-01-11",97,1031,82,829,15,202,0,0,16,584,81,224,16,808,"California",18453,0.0121389475965968,4634,0.489,4620,0.487
"1798","inyo",1798,"2021-01-12",139,1170,118,947,21,223,0,0,28,501,111,335,28,836,"California",18453,0.0181542296645532,4634,0.489,4620,0.487
"1799","inyo",1799,"2021-01-13",86,1256,68,1015,18,241,0,0,21,458,65,400,22,858,"California",18453,0.0216766921367799,4634,0.489,4620,0.487
"1800","inyo",1800,"2021-01-14",59,1315,13,1028,46,287,0,0,49,497,10,410,49,907,"California",18453,0.0222186094401994,4634,0.489,4620,0.487
"1801","inyo",1801,"2021-01-15",163,1478,28,1056,135,422,0,0,163,660,0,410,163,1070,"California",18453,0.0222186094401994,4634,0.489,4620,0.487
"1802","inyo",1802,"2021-01-16",74,1552,73,1129,1,423,0,0,1,588,73,483,1,1071,"California",18453,0.0261746057551618,4634,0.489,4620,0.487
"1803","inyo",1803,"2021-01-18",58,1610,36,1165,22,445,0,0,19,568,39,522,19,1090,"California",18453,0.0282880832384978,4634,0.489,4620,0.487
"1804","inyo",1804,"2021-01-19",115,1725,72,1237,43,488,0,0,98,649,17,539,98,1188,"California",18453,0.029209342654311,4634,0.489,4620,0.487
"1805","inyo",1805,"2021-01-20",147,1872,71,1308,76,564,0,0,93,688,54,593,93,1281,"California",18453,0.0321356960927762,4634,0.489,4620,0.487
"1806","inyo",1806,"2021-01-21",121,1993,57,1365,64,628,0,0,120,807,1,594,120,1401,"California",18453,0.0321898878231182,4634,0.489,4620,0.487
"1807","inyo",1807,"2021-01-22",62,2055,0,1365,62,690,0,0,61,867,1,595,61,1462,"California",18453,0.0322440795534601,4634,0.489,4620,0.487
"1808","inyo",1808,"2021-01-23",52,2107,52,1417,0,690,0,0,52,919,0,595,52,1514,"California",18453,0.0322440795534601,4634,0.489,4620,0.487
"1809","inyo",1809,"2021-01-25",49,2156,6,1423,43,733,0,0,37,944,12,607,37,1551,"California",18453,0.0328943803175635,4634,0.489,4620,0.487
"1810","inyo",1810,"2021-01-26",135,2291,54,1477,81,814,0,0,129,1067,6,613,129,1680,"California",18453,0.0332195306996152,4634,0.489,4620,0.487
"1811","inyo",1811,"2021-01-27",24,2315,2,1479,22,836,0,0,23,1089,1,614,23,1703,"California",18453,0.0332737224299572,4634,0.489,4620,0.487
"1812","inyo",1812,"2021-01-28",92,2407,2,1481,90,926,0,0,63,1123,29,643,63,1766,"California",18453,0.0348452826098737,4634,0.489,4620,0.487
"1813","inyo",1813,"2021-01-29",25,2432,3,1484,22,948,0,0,23,1144,2,645,23,1789,"California",18453,0.0349536660705576,4634,0.489,4620,0.487
"1814","inyo",1814,"2021-01-30",11,2443,1,1485,10,958,0,0,11,1155,0,645,11,1800,"California",18453,0.0349536660705576,4634,0.489,4620,0.487
"1815","inyo",1815,"2021-01-31",32,2475,4,1489,28,986,0,0,4,1131,28,673,4,1804,"California",18453,0.0364710345201322,4634,0.489,4620,0.487
"1816","inyo",1816,"2021-02-01",11,2486,9,1498,2,988,0,0,1,1122,10,683,1,1805,"California",18453,0.0370129518235517,4634,0.489,4620,0.487
"1817","inyo",1817,"2021-02-02",130,2616,14,1512,116,1104,0,0,104,1200,26,709,104,1909,"California",18453,0.0384219368124424,4634,0.489,4620,0.487
"1818","inyo",1818,"2021-02-03",116,2732,0,1512,116,1220,0,0,74,1232,42,751,74,1983,"California",18453,0.0406979894868043,4634,0.489,4620,0.487
"1819","inyo",1819,"2021-02-04",149,2881,31,1543,118,1338,0,0,90,1263,59,810,90,2073,"California",18453,0.0438953015769794,4634,0.489,4620,0.487
"1820","inyo",1820,"2021-02-05",118,2999,62,1605,56,1394,0,0,116,1377,2,812,116,2189,"California",18453,0.0440036850376633,4634,0.489,4620,0.487
"1821","inyo",1821,"2021-02-06",4,3003,2,1607,2,1396,0,0,3,1379,1,813,3,2192,"California",18453,0.0440578767680052,4634,0.489,4620,0.487
"1822","inyo",1822,"2021-02-07",4,3007,2,1609,2,1398,0,0,4,1383,0,813,4,2196,"California",18453,0.0440578767680052,4634,0.489,4620,0.487
"1823","inyo",1823,"2021-02-08",117,3124,7,1616,110,1508,0,0,97,1460,20,833,97,2293,"California",18453,0.0451417113748442,4634,0.489,4620,0.487
"1824","inyo",1824,"2021-02-09",195,3319,52,1668,143,1651,0,0,124,1513,71,904,124,2417,"California",18453,0.0489893242291226,4634,0.489,4620,0.487
"1825","inyo",1825,"2021-02-10",143,3462,18,1686,125,1776,0,0,109,1588,34,938,109,2526,"California",18453,0.0508318430607489,4634,0.489,4620,0.487
"1826","inyo",1826,"2021-02-11",220,3682,56,1742,164,1940,0,0,126,1620,94,1032,126,2652,"California",18453,0.0559258657128922,4634,0.489,4620,0.487
"1827","inyo",1827,"2021-02-12",299,3981,51,1793,248,2188,0,0,167,1655,132,1164,167,2819,"California",18453,0.0630791741180296,4634,0.489,4620,0.487
"1828","inyo",1828,"2021-02-13",60,4041,55,1848,5,2193,0,0,8,1611,52,1216,8,2827,"California",18453,0.065897144095811,4634,0.489,4620,0.487
"1829","inyo",1829,"2021-02-14",1,4042,0,1848,1,2194,0,0,1,1612,0,1216,1,2828,"California",18453,0.065897144095811,4634,0.489,4620,0.487
"1830","inyo",1830,"2021-02-15",29,4071,9,1857,20,2214,0,0,5,1593,24,1240,5,2833,"California",18453,0.0671977456240178,4634,0.489,4620,0.487
"1831","inyo",1831,"2021-02-16",180,4251,50,1907,130,2344,0,0,92,1598,87,1327,92,2925,"California",18453,0.0719124261637674,4634,0.489,4620,0.487
"1832","inyo",1832,"2021-02-17",38,4289,4,1911,34,2378,0,0,8,1576,30,1357,8,2933,"California",18453,0.0735381780740259,4634,0.489,4620,0.487
"1833","inyo",1833,"2021-02-18",123,4412,6,1917,117,2495,0,0,79,1611,44,1401,79,3012,"California",18453,0.0759226142090717,4634,0.489,4620,0.487
"1834","inyo",1834,"2021-02-19",52,4464,4,1921,48,2543,0,0,9,1577,43,1444,9,3021,"California",18453,0.0782528586137755,4634,0.489,4620,0.487
"1835","inyo",1835,"2021-02-20",504,4968,500,2421,4,2547,0,0,502,2077,2,1446,502,3523,"California",18453,0.0783612420744594,4634,0.489,4620,0.487
"1836","inyo",1836,"2021-02-21",267,5235,267,2688,0,2547,0,0,267,2344,0,1446,267,3790,"California",18453,0.0783612420744594,4634,0.489,4620,0.487
"1837","inyo",1837,"2021-02-22",61,5296,19,2707,42,2589,0,0,27,2337,34,1480,27,3817,"California",18453,0.0802037609060857,4634,0.489,4620,0.487
"1838","inyo",1838,"2021-02-23",198,5494,20,2727,178,2767,0,0,94,2328,103,1583,94,3911,"California",18453,0.0857855091313066,4634,0.489,4620,0.487
"1839","inyo",1839,"2021-02-24",118,5612,0,2727,118,2885,0,0,57,2324,61,1644,57,3968,"California",18453,0.0890912046821655,4634,0.489,4620,0.487
"1840","inyo",1840,"2021-02-25",130,5742,3,2730,127,3012,0,0,62,2318,68,1712,62,4030,"California",18453,0.0927762423454181,4634,0.489,4620,0.487
"1841","inyo",1841,"2021-02-26",104,5846,61,2791,43,3055,0,0,19,2252,85,1797,19,4049,"California",18453,0.0973825394244838,4634,0.489,4620,0.487
"1842","inyo",1842,"2021-02-27",15,5861,4,2795,11,3066,0,0,3,2243,12,1809,3,4052,"California",18453,0.0980328401885872,4634,0.489,4620,0.487
"1843","inyo",1843,"2021-02-28",3,5864,1,2796,2,3068,0,0,2,2244,1,1810,2,4054,"California",18453,0.0980870319189292,4634,0.489,4620,0.487
"1844","inyo",1844,"2021-03-01",20,5884,2,2798,18,3086,0,0,17,2258,3,1813,17,4071,"California",18453,0.098249607109955,4634,0.489,4620,0.487
"1845","inyo",1845,"2021-03-02",196,6080,1,2799,195,3281,0,0,111,2284,85,1898,111,4182,"California",18453,0.102855904189021,4634,0.489,4620,0.487
"1846","inyo",1846,"2021-03-03",83,6163,2,2801,81,3362,0,0,40,2281,43,1941,40,4222,"California",18453,0.105186148593725,4634,0.489,4620,0.487
"1847","inyo",1847,"2021-03-04",128,6291,4,2805,124,3486,0,0,46,2245,82,2023,46,4268,"California",18453,0.109629870481764,4634,0.489,4620,0.487
"1848","inyo",1848,"2021-03-05",141,6432,56,2861,85,3571,0,0,38,2180,103,2126,38,4306,"California",18453,0.115211618706985,4634,0.489,4620,0.487
"1849","inyo",1849,"2021-03-06",31,6463,1,2862,30,3601,0,0,30,2209,1,2127,30,4336,"California",18453,0.115265810437327,4634,0.489,4620,0.487
"1850","inyo",1850,"2021-03-07",7,6470,4,2866,3,3604,0,0,5,2212,2,2129,5,4341,"California",18453,0.115374193898011,4634,0.489,4620,0.487
"1851","inyo",1851,"2021-03-08",182,6652,5,2871,177,3781,0,0,91,2212,91,2220,91,4432,"California",18453,0.120305641359129,4634,0.489,4620,0.487
"1852","inyo",1852,"2021-03-09",187,6839,2,2873,185,3966,0,0,71,2167,116,2336,71,4503,"California",18453,0.126591882078795,4634,0.489,4620,0.487
"1853","inyo",1853,"2021-03-10",70,6909,8,2881,61,4027,1,1,30,2158,40,2376,31,4534,"California",18453,0.128759551292473,4634,0.489,4620,0.487
"1854","inyo",1854,"2021-03-11",204,7113,1,2882,198,4225,5,6,74,2107,130,2506,79,4613,"California",18453,0.135804476236926,4634,0.489,4620,0.487
"1855","inyo",1855,"2021-03-12",175,7288,4,2886,166,4391,5,11,77,2091,98,2604,82,4695,"California",18453,0.141115265810437,4634,0.489,4620,0.487
"1856","inyo",1856,"2021-03-13",576,7864,541,3427,25,4416,10,21,77,1680,498,3102,87,4782,"California",18453,0.168102747520728,4634,0.489,4620,0.487
"1857","inyo",1857,"2021-03-14",431,8295,430,3857,1,4417,0,21,168,1586,262,3364,168,4950,"California",18453,0.182300980870319,4634,0.489,4620,0.487
"1858","inyo",1858,"2021-03-15",51,8346,15,3872,34,4451,2,23,30,1597,21,3385,32,4982,"California",18453,0.1834390072075,4634,0.489,4620,0.487
"1859","inyo",1859,"2021-03-16",163,8509,4,3876,153,4604,6,29,63,1567,99,3484,69,5051,"California",18453,0.188803988511353,4634,0.489,4620,0.487
"1860","inyo",1860,"2021-03-17",108,8617,3,3879,98,4702,7,36,92,1650,16,3500,99,5150,"California",18453,0.189671056196824,4634,0.489,4620,0.487
"1861","inyo",1861,"2021-03-18",184,8801,15,3894,162,4864,7,43,103,1679,81,3581,110,5260,"California",18453,0.194060586354522,4634,0.489,4620,0.487
"1862","inyo",1862,"2021-03-19",46,8847,4,3898,38,4902,4,47,36,1709,10,3591,40,5300,"California",18453,0.194602503657942,4634,0.489,4620,0.487
"1863","inyo",1863,"2021-03-20",20,8867,1,3899,10,4912,9,56,1,1700,19,3610,10,5310,"California",18453,0.195632146534439,4634,0.489,4620,0.487
"1864","inyo",1864,"2021-03-22",59,8926,2,3901,52,4964,5,61,39,1724,20,3630,44,5354,"California",18453,0.196715981141278,4634,0.489,4620,0.487
"1865","inyo",1865,"2021-03-23",194,9120,4,3905,186,5150,4,65,104,1742,90,3720,108,5462,"California",18453,0.201593236872053,4634,0.489,4620,0.487
"1866","inyo",1866,"2021-03-24",140,9260,3,3908,133,5283,4,69,87,1780,53,3773,91,5553,"California",18453,0.204465398580177,4634,0.489,4620,0.487
"1867","inyo",1867,"2021-03-25",325,9585,104,4012,217,5500,4,73,259,1977,66,3839,263,5816,"California",18453,0.208042052782745,4634,0.489,4620,0.487
"1868","inyo",1868,"2021-03-26",91,9676,3,4015,84,5584,4,77,71,2032,20,3859,75,5891,"California",18453,0.209125887389584,4634,0.489,4620,0.487
"1869","inyo",1869,"2021-03-27",52,9728,44,4059,5,5589,3,80,46,2075,6,3865,49,5940,"California",18453,0.209451037771636,4634,0.489,4620,0.487
"1870","inyo",1870,"2021-03-28",4,9732,1,4060,2,5591,1,81,1,2074,3,3868,2,5942,"California",18453,0.209613612962662,4634,0.489,4620,0.487
"1871","inyo",1871,"2021-03-29",109,9841,2,4062,102,5693,5,86,82,2135,26,3894,87,6029,"California",18453,0.211022597951553,4634,0.489,4620,0.487
"1872","inyo",1872,"2021-03-30",212,10053,2,4064,205,5898,5,91,101,2130,111,4005,106,6135,"California",18453,0.217037880019509,4634,0.489,4620,0.487
"1873","inyo",1873,"2021-03-31",148,10201,4,4068,139,6037,5,96,107,2201,41,4046,112,6247,"California",18453,0.219259740963529,4634,0.489,4620,0.487
"1874","inyo",1874,"2021-04-01",164,10365,4,4072,159,6196,1,97,115,2268,49,4095,116,6363,"California",18453,0.221915135750285,4634,0.489,4620,0.487
"1875","inyo",1875,"2021-04-02",80,10445,1,4073,77,6273,2,99,51,2292,29,4124,53,6416,"California",18453,0.223486695930201,4634,0.489,4620,0.487
"1876","inyo",1876,"2021-04-03",94,10539,47,4120,33,6306,14,113,6,2225,86,4210,19,6435,"California",18453,0.228147184739609,4634,0.489,4620,0.487
"1877","inyo",1877,"2021-04-04",5,10544,4,4124,0,6306,1,114,1,2223,4,4214,2,6437,"California",18453,0.228363951660977,4634,0.489,4620,0.487
"1878","inyo",1878,"2021-04-05",117,10661,1,4125,112,6418,4,118,29,2168,88,4302,33,6470,"California",18453,0.233132823931068,4634,0.489,4620,0.487
"1879","inyo",1879,"2021-04-06",236,10897,6,4131,167,6585,63,181,105,2205,131,4433,168,6638,"California",18453,0.240231940605864,4634,0.489,4620,0.487
"1880","inyo",1880,"2021-04-07",200,11097,2,4133,72,6657,126,307,45,2220,156,4589,171,6809,"California",18453,0.248685850539208,4634,0.489,4620,0.487
"1881","inyo",1881,"2021-04-08",178,11275,15,4148,146,6803,17,324,80,2219,98,4687,97,6906,"California",18453,0.253996640112719,4634,0.489,4620,0.487
"1882","inyo",1882,"2021-04-09",125,11400,7,4155,95,6898,23,347,38,2194,86,4773,61,6967,"California",18453,0.258657128922127,4634,0.489,4620,0.487
"1883","inyo",1883,"2021-04-10",42,11442,1,4156,24,6922,17,364,3,2175,39,4812,20,6987,"California",18453,0.260770606405463,4634,0.489,4620,0.487
"1884","inyo",1884,"2021-04-11",1,11443,0,4156,1,6923,0,364,1,2176,0,4812,1,6988,"California",18453,0.260770606405463,4634,0.489,4620,0.487
"1885","inyo",1885,"2021-04-12",80,11523,0,4156,75,6998,5,369,41,2183,39,4851,46,7034,"California",18453,0.262884083888799,4634,0.489,4620,0.487
"1886","inyo",1886,"2021-04-13",119,11642,3,4159,113,7111,3,372,61,2190,57,4908,64,7098,"California",18453,0.26597301251829,4634,0.489,4620,0.487
"1887","inyo",1887,"2021-04-14",124,11766,1,4160,123,7234,0,372,40,2146,84,4992,40,7138,"California",18453,0.270525117867013,4634,0.489,4620,0.487
"1888","inyo",1888,"2021-04-15",273,12039,114,4274,159,7393,0,372,83,2039,190,5182,83,7221,"California",18453,0.280821546631984,4634,0.489,4620,0.487
"1889","inyo",1889,"2021-04-16",49,12088,6,4280,43,7436,0,372,21,2032,28,5210,21,7242,"California",18453,0.282338915081559,4634,0.489,4620,0.487
"1890","inyo",1890,"2021-04-17",2,12090,1,4281,1,7437,0,372,1,2032,1,5211,1,7243,"California",18453,0.2823931068119,4634,0.489,4620,0.487
"1891","inyo",1891,"2021-04-19",130,12220,43,4324,87,7524,0,372,44,1990,86,5297,44,7287,"California",18453,0.287053595621308,4634,0.489,4620,0.487
"1892","inyo",1892,"2021-04-20",164,12384,3,4327,161,7685,0,372,81,1988,83,5380,81,7368,"California",18453,0.29155150923969,4634,0.489,4620,0.487
"1893","inyo",1893,"2021-04-21",113,12497,4,4331,109,7794,0,372,32,1939,81,5461,32,7400,"California",18453,0.295941039397388,4634,0.489,4620,0.487
"1894","inyo",1894,"2021-04-22",196,12693,1,4332,195,7989,0,372,52,1847,144,5605,52,7452,"California",18453,0.303744648566629,4634,0.489,4620,0.487
"1895","inyo",1895,"2021-04-23",95,12788,4,4336,91,8080,0,372,22,1796,73,5678,22,7474,"California",18453,0.307700644881591,4634,0.489,4620,0.487
"1896","inyo",1896,"2021-04-24",310,13098,309,4645,1,8081,0,372,305,2096,5,5683,305,7779,"California",18453,0.307971603533301,4634,0.489,4620,0.487
"1897","inyo",1897,"2021-04-25",136,13234,135,4780,1,8082,0,372,136,2232,0,5683,136,7915,"California",18453,0.307971603533301,4634,0.489,4620,0.487
"1898","inyo",1898,"2021-04-26",67,13301,0,4780,66,8148,1,373,8,2182,59,5742,9,7924,"California",18453,0.311168915623476,4634,0.489,4620,0.487
"1899","inyo",1899,"2021-04-27",163,13464,7,4787,151,8299,5,378,47,2118,116,5858,52,7976,"California",18453,0.317455156343142,4634,0.489,4620,0.487
"1900","inyo",1900,"2021-04-28",121,13585,2,4789,117,8416,2,380,20,2039,101,5959,22,7998,"California",18453,0.322928521107679,4634,0.489,4620,0.487
"1901","inyo",1901,"2021-04-29",172,13757,56,4845,116,8532,0,380,79,2026,92,6051,79,8077,"California",18453,0.327914160299138,4634,0.489,4620,0.487
"1902","inyo",1902,"2021-04-30",85,13842,5,4850,79,8611,1,381,24,1990,61,6112,25,8102,"California",18453,0.331219855849997,4634,0.489,4620,0.487
"1903","inyo",1903,"2021-05-01",11,13853,3,4853,8,8619,0,381,9,1997,2,6114,9,8111,"California",18453,0.331328239310681,4634,0.489,4620,0.487
"1904","inyo",1904,"2021-05-02",7,13860,3,4856,2,8621,2,383,4,2000,3,6117,6,8117,"California",18453,0.331490814501707,4634,0.489,4620,0.487
"1905","inyo",1905,"2021-05-03",38,13898,1,4857,33,8654,4,387,5,1976,33,6150,9,8126,"California",18453,0.333279141602991,4634,0.489,4620,0.487
"1906","inyo",1906,"2021-05-04",123,14021,2,4859,115,8769,6,393,23,1905,100,6250,29,8155,"California",18453,0.338698314637186,4634,0.489,4620,0.487
"1907","inyo",1907,"2021-05-05",34,14055,0,4859,32,8801,2,395,11,1895,23,6273,13,8168,"California",18453,0.339944724435051,4634,0.489,4620,0.487
"1908","inyo",1908,"2021-05-06",93,14148,6,4865,78,8879,9,404,12,1835,81,6354,21,8189,"California",18453,0.344334254592749,4634,0.489,4620,0.487
"1909","inyo",1909,"2021-05-07",46,14194,3,4868,35,8914,8,412,21,1840,24,6378,29,8218,"California",18453,0.345634856120956,4634,0.489,4620,0.487
"1910","inyo",1910,"2021-05-08",14,14208,3,4871,6,8920,5,417,7,1845,7,6385,12,8230,"California",18453,0.34601419823335,4634,0.489,4620,0.487
"1911","kern",1911,"2020-12-15",1,1,1,1,0,0,0,0,1,1,0,0,1,1,"California",927251,0,133366,0.437,164484,0.539
"1912","kern",1912,"2020-12-16",18,19,18,19,0,0,0,0,18,19,0,0,18,19,"California",927251,0,133366,0.437,164484,0.539
"1913","kern",1913,"2020-12-17",163,182,163,182,0,0,0,0,163,182,0,0,163,182,"California",927251,0,133366,0.437,164484,0.539
"1914","kern",1914,"2020-12-18",322,504,322,504,0,0,0,0,322,504,0,0,322,504,"California",927251,0,133366,0.437,164484,0.539
"1915","kern",1915,"2020-12-19",98,602,98,602,0,0,0,0,99,603,0,0,99,603,"California",927251,0,133366,0.437,164484,0.539
"1916","kern",1916,"2020-12-20",61,663,61,663,0,0,0,0,61,664,0,0,61,664,"California",927251,0,133366,0.437,164484,0.539
"1917","kern",1917,"2020-12-21",671,1334,670,1333,1,1,0,0,671,1335,0,0,671,1335,"California",927251,0,133366,0.437,164484,0.539
"1918","kern",1918,"2020-12-22",531,1865,528,1861,3,4,0,0,531,1866,0,0,531,1866,"California",927251,0,133366,0.437,164484,0.539
"1919","kern",1919,"2020-12-23",556,2421,418,2279,138,142,0,0,556,2422,0,0,556,2422,"California",927251,0,133366,0.437,164484,0.539
"1920","kern",1920,"2020-12-24",122,2543,43,2322,79,221,0,0,122,2544,0,0,122,2544,"California",927251,0,133366,0.437,164484,0.539
"1921","kern",1921,"2020-12-25",1,2544,1,2323,0,221,0,0,1,2545,0,0,1,2545,"California",927251,0,133366,0.437,164484,0.539
"1922","kern",1922,"2020-12-26",33,2577,1,2324,32,253,0,0,33,2578,0,0,33,2578,"California",927251,0,133366,0.437,164484,0.539
"1923","kern",1923,"2020-12-27",35,2612,3,2327,32,285,0,0,35,2613,0,0,35,2613,"California",927251,0,133366,0.437,164484,0.539
"1924","kern",1924,"2020-12-28",826,3438,662,2989,164,449,0,0,826,3439,0,0,826,3439,"California",927251,0,133366,0.437,164484,0.539
"1925","kern",1925,"2020-12-29",745,4183,452,3441,293,742,0,0,744,4182,1,1,744,4183,"California",927251,1.07845664226838e-06,133366,0.437,164484,0.539
"1926","kern",1926,"2020-12-30",1203,5386,910,4351,293,1035,0,0,1203,5385,0,1,1203,5386,"California",927251,1.07845664226838e-06,133366,0.437,164484,0.539
"1927","kern",1927,"2020-12-31",277,5663,99,4450,178,1213,0,0,277,5662,0,1,277,5663,"California",927251,1.07845664226838e-06,133366,0.437,164484,0.539
"1928","kern",1928,"2021-01-01",13,5676,6,4456,7,1220,0,0,13,5675,0,1,13,5676,"California",927251,1.07845664226838e-06,133366,0.437,164484,0.539
"1929","kern",1929,"2021-01-02",78,5754,18,4474,60,1280,0,0,78,5753,0,1,78,5754,"California",927251,1.07845664226838e-06,133366,0.437,164484,0.539
"1930","kern",1930,"2021-01-03",23,5777,4,4478,19,1299,0,0,23,5776,0,1,23,5777,"California",927251,1.07845664226838e-06,133366,0.437,164484,0.539
"1931","kern",1931,"2021-01-04",554,6331,360,4838,194,1493,0,0,554,6330,0,1,554,6331,"California",927251,1.07845664226838e-06,133366,0.437,164484,0.539
"1932","kern",1932,"2021-01-05",1134,7465,739,5577,395,1888,0,0,1122,7440,12,13,1122,7453,"California",927251,1.4019936349489e-05,133366,0.437,164484,0.539
"1933","kern",1933,"2021-01-06",1167,8632,456,6033,711,2599,0,0,1137,8547,30,43,1137,8590,"California",927251,4.63736356175405e-05,133366,0.437,164484,0.539
"1934","kern",1934,"2021-01-07",1406,10038,493,6526,913,3512,0,0,1238,9618,167,210,1238,9828,"California",927251,0.00022647589487636,133366,0.437,164484,0.539
"1935","kern",1935,"2021-01-08",1628,11666,768,7294,860,4372,0,0,1330,10650,299,509,1331,11159,"California",927251,0.000548934430914607,133366,0.437,164484,0.539
"1936","kern",1936,"2021-01-09",226,11892,77,7371,149,4521,0,0,192,10808,34,543,192,11351,"California",927251,0.000585601956751732,133366,0.437,164484,0.539
"1937","kern",1937,"2021-01-10",195,12087,148,7519,47,4568,0,0,154,10921,41,584,154,11505,"California",927251,0.000629818679084735,133366,0.437,164484,0.539
"1938","kern",1938,"2021-01-11",1556,13643,984,8503,572,5140,0,0,1001,11367,555,1139,1001,12506,"California",927251,0.00122836211554369,133366,0.437,164484,0.539
"1939","kern",1939,"2021-01-12",1868,15511,810,9313,1058,6198,0,0,1357,12213,511,1650,1357,13863,"California",927251,0.00177945345974283,133366,0.437,164484,0.539
"1940","kern",1940,"2021-01-13",1853,17364,870,10183,983,7181,0,0,1432,13224,421,2071,1432,15295,"California",927251,0.00223348370613782,133366,0.437,164484,0.539
"1941","kern",1941,"2021-01-14",2184,19548,645,10828,1539,8720,0,0,2139,15317,46,2117,2139,17434,"California",927251,0.00228309271168217,133366,0.437,164484,0.539
"1942","kern",1942,"2021-01-15",2706,22254,858,11686,1848,10568,0,0,2609,17832,95,2212,2610,20044,"California",927251,0.00238554609269766,133366,0.437,164484,0.539
"1943","kern",1943,"2021-01-16",671,22925,213,11899,458,11026,0,0,636,18433,35,2247,636,20680,"California",927251,0.00242329207517706,133366,0.437,164484,0.539
"1944","kern",1944,"2021-01-17",73,22998,7,11906,66,11092,0,0,71,18502,2,2249,71,20751,"California",927251,0.00242544898846159,133366,0.437,164484,0.539
"1945","kern",1945,"2021-01-18",1645,24643,659,12565,986,12078,0,0,1477,19811,168,2417,1477,22228,"California",927251,0.00260662970436268,133366,0.437,164484,0.539
"1946","kern",1946,"2021-01-19",1853,26496,1034,13599,819,12897,0,0,1386,20731,467,2884,1387,23615,"California",927251,0.00311026895630202,133366,0.437,164484,0.539
"1947","kern",1947,"2021-01-20",2555,29051,1620,15219,935,13832,0,0,1854,21891,696,3580,1856,25471,"California",927251,0.00386087477932081,133366,0.437,164484,0.539
"1948","kern",1948,"2021-01-21",2168,31219,922,16141,1246,15078,0,0,1972,23668,195,3775,1972,27443,"California",927251,0.00407117382456314,133366,0.437,164484,0.539
"1949","kern",1949,"2021-01-22",2712,33931,1293,17434,1419,16497,0,0,2434,25825,277,4052,2434,29877,"California",927251,0.00436990631447149,133366,0.437,164484,0.539
"1950","kern",1950,"2021-01-23",1245,35176,535,17969,710,17207,0,0,1199,26978,46,4098,1199,31076,"California",927251,0.00441951532001583,133366,0.437,164484,0.539
"1951","kern",1951,"2021-01-24",160,35336,18,17987,142,17349,0,0,154,27126,6,4104,154,31230,"California",927251,0.00442598605986944,133366,0.437,164484,0.539
"1952","kern",1952,"2021-01-25",2385,37721,1086,19073,1299,18648,0,0,1901,28545,483,4587,1902,33132,"California",927251,0.00494688061808507,133366,0.437,164484,0.539
"1953","kern",1953,"2021-01-26",2769,40490,1128,20201,1641,20289,0,0,1911,29599,857,5444,1911,35043,"California",927251,0.00587111796050907,133366,0.437,164484,0.539
"1954","kern",1954,"2021-01-27",3558,44048,1901,22102,1657,21946,0,0,2858,31760,697,6141,2858,37901,"California",927251,0.00662280224017014,133366,0.437,164484,0.539
"1955","kern",1955,"2021-01-28",2863,46911,1353,23455,1510,23456,0,0,2430,33765,428,6569,2433,40334,"California",927251,0.00708438168306101,133366,0.437,164484,0.539
"1956","kern",1956,"2021-01-29",3771,50682,1805,25260,1966,25422,0,0,3227,36451,541,7110,3227,43561,"California",927251,0.0076678267265282,133366,0.437,164484,0.539
"1957","kern",1957,"2021-01-30",1325,52007,497,25757,828,26250,0,0,1277,37682,46,7156,1277,44838,"California",927251,0.00771743573207255,133366,0.437,164484,0.539
"1958","kern",1958,"2021-01-31",403,52410,276,26033,127,26377,0,0,268,37815,135,7291,268,45106,"California",927251,0.00786302737877878,133366,0.437,164484,0.539
"1959","kern",1959,"2021-02-01",2409,54819,818,26851,1591,27968,0,0,1858,39126,548,7839,1859,46965,"California",927251,0.00845402161874185,133366,0.437,164484,0.539
"1960","kern",1960,"2021-02-02",2923,57742,973,27824,1950,29918,0,0,2060,40324,863,8702,2061,49026,"California",927251,0.00938472970101946,133366,0.437,164484,0.539
"1961","kern",1961,"2021-02-03",3657,61399,1548,29372,2109,32027,0,0,2688,42050,962,9664,2688,51714,"California",927251,0.0104222049908816,133366,0.437,164484,0.539
"1962","kern",1962,"2021-02-04",3803,65202,1452,30824,2351,34378,0,0,2588,43434,1204,10868,2588,54302,"California",927251,0.0117206667881728,133366,0.437,164484,0.539
"1963","kern",1963,"2021-02-05",4847,70049,1988,32812,2859,37237,0,0,3088,44782,1740,12608,3088,57390,"California",927251,0.0135971813457198,133366,0.437,164484,0.539
"1964","kern",1964,"2021-02-06",1734,71783,766,33578,968,38205,0,0,1510,46071,221,12829,1510,58900,"California",927251,0.0138355202636611,133366,0.437,164484,0.539
"1965","kern",1965,"2021-02-07",283,72066,151,33729,132,38337,0,0,267,46324,14,12843,267,59167,"California",927251,0.0138506186566528,133366,0.437,164484,0.539
"1966","kern",1966,"2021-02-08",2562,74628,788,34517,1774,40111,0,0,1253,46287,1291,14134,1254,60421,"California",927251,0.0152429061818213,133366,0.437,164484,0.539
"1967","kern",1967,"2021-02-09",3040,77668,988,35505,2052,42163,0,0,1468,46191,1564,15698,1468,61889,"California",927251,0.0169296123703291,133366,0.437,164484,0.539
"1968","kern",1968,"2021-02-10",3784,81452,1657,37162,2127,44290,0,0,1870,46164,1898,17596,1871,63760,"California",927251,0.0189765230773545,133366,0.437,164484,0.539
"1969","kern",1969,"2021-02-11",4259,85711,1536,38698,2723,47013,0,0,2224,46367,2022,19618,2225,65985,"California",927251,0.0211571624080211,133366,0.437,164484,0.539
"1970","kern",1970,"2021-02-12",4951,90662,1892,40590,3059,50072,0,0,2478,46386,2459,22077,2478,68463,"California",927251,0.0238090872913591,133366,0.437,164484,0.539
"1971","kern",1971,"2021-02-13",2010,92672,728,41318,1282,51354,0,0,1165,46708,843,22920,1165,69628,"California",927251,0.0247182262407913,133366,0.437,164484,0.539
"1972","kern",1972,"2021-02-14",351,93023,12,41330,339,51693,0,0,270,46898,80,23000,270,69898,"California",927251,0.0248045027721728,133366,0.437,164484,0.539
"1973","kern",1973,"2021-02-15",2736,95759,889,42219,1847,53540,0,0,1204,46579,1523,24523,1204,71102,"California",927251,0.0264469922383475,133366,0.437,164484,0.539
"1974","kern",1974,"2021-02-16",2944,98703,720,42939,2224,55764,0,0,1655,46956,1279,25802,1656,72758,"California",927251,0.0278263382838088,133366,0.437,164484,0.539
"1975","kern",1975,"2021-02-17",4068,102771,2077,45016,1991,57755,0,0,1928,46750,2135,27937,1929,74687,"California",927251,0.0301288432150518,133366,0.437,164484,0.539
"1976","kern",1976,"2021-02-18",3751,106522,1481,46497,2270,60025,0,0,1616,46244,2122,30059,1616,76303,"California",927251,0.0324173282099453,133366,0.437,164484,0.539
"1977","kern",1977,"2021-02-19",4197,110719,1916,48413,2281,62306,0,0,1737,45529,2452,32511,1737,78040,"California",927251,0.0350617038967874,133366,0.437,164484,0.539
"1978","kern",1978,"2021-02-20",2570,113289,967,49380,1603,63909,0,0,1339,45640,1228,33739,1339,79379,"California",927251,0.036386048653493,133366,0.437,164484,0.539
"1979","kern",1979,"2021-02-21",249,113538,143,49523,106,64015,0,0,86,45565,161,33900,86,79465,"California",927251,0.0365596801728982,133366,0.437,164484,0.539
"1980","kern",1980,"2021-02-22",2657,116195,1148,50671,1509,65524,0,0,1424,45761,1228,35128,1424,80889,"California",927251,0.0378840249296037,133366,0.437,164484,0.539
"1981","kern",1981,"2021-02-23",3542,119737,1121,51792,2421,67945,0,0,1975,46172,1565,36693,1976,82865,"California",927251,0.0395718095747538,133366,0.437,164484,0.539
"1982","kern",1982,"2021-02-24",5165,124902,2268,54060,2897,70842,0,0,3079,47169,2082,38775,3079,85944,"California",927251,0.0418171563039565,133366,0.437,164484,0.539
"1983","kern",1983,"2021-02-25",5358,130260,2450,56510,2908,73750,0,0,3179,48188,2160,40935,3179,89123,"California",927251,0.0441466226512562,133366,0.437,164484,0.539
"1984","kern",1984,"2021-02-26",6885,137145,3519,60029,3366,77116,0,0,4359,50029,2519,43454,4360,93483,"California",927251,0.0468632549331303,133366,0.437,164484,0.539
"1985","kern",1985,"2021-02-27",3855,141000,1895,61924,1960,79076,0,0,2519,51219,1329,44783,2519,96002,"California",927251,0.048296523810705,133366,0.437,164484,0.539
"1986","kern",1986,"2021-02-28",908,141908,498,62422,409,79485,1,1,689,51692,217,45000,690,96692,"California",927251,0.0485305489020772,133366,0.437,164484,0.539
"1987","kern",1987,"2021-03-01",3992,145900,1809,64231,2180,81665,3,4,2693,53097,1291,46291,2696,99388,"California",927251,0.0499228364272457,133366,0.437,164484,0.539
"1988","kern",1988,"2021-03-02",4374,150274,1376,65607,2997,84662,1,5,2868,54470,1495,47786,2868,102256,"California",927251,0.0515351291074369,133366,0.437,164484,0.539
"1989","kern",1989,"2021-03-03",5803,156077,2700,68307,3103,87765,0,5,3716,56115,2073,49859,3718,105974,"California",927251,0.0537707697268593,133366,0.437,164484,0.539
"1990","kern",1990,"2021-03-04",5553,161630,2161,70468,3389,91154,3,8,3558,57694,1981,51840,3560,109534,"California",927251,0.055907192335193,133366,0.437,164484,0.539
"1991","kern",1991,"2021-03-05",6468,168098,2669,73137,3781,94935,18,26,4043,59338,2417,54257,4061,113595,"California",927251,0.0585138220395556,133366,0.437,164484,0.539
"1992","kern",1992,"2021-03-06",4714,172812,1912,75049,2701,97636,101,127,3446,61624,1260,55517,3546,117141,"California",927251,0.0598726774088138,133366,0.437,164484,0.539
"1993","kern",1993,"2021-03-07",2045,174857,1585,76634,411,98047,49,176,1854,63337,190,55707,1903,119044,"California",927251,0.0600775841708448,133366,0.437,164484,0.539
"1994","kern",1994,"2021-03-08",2815,177672,856,77490,1746,99793,213,389,1470,63676,1342,57049,1681,120725,"California",927251,0.061524872984769,133366,0.437,164484,0.539
"1995","kern",1995,"2021-03-09",3633,181305,789,78279,2461,102254,383,772,2239,64908,1388,58437,2620,123345,"California",927251,0.0630217708042375,133366,0.437,164484,0.539
"1996","kern",1996,"2021-03-10",6026,187331,2468,80747,2488,104742,1070,1842,3505,66973,2509,60946,4574,127919,"California",927251,0.0657276185196888,133366,0.437,164484,0.539
"1997","kern",1997,"2021-03-11",6288,193619,2410,83157,2852,107594,1026,2868,3732,69184,2545,63491,4756,132675,"California",927251,0.0684722906742619,133366,0.437,164484,0.539
"1998","kern",1998,"2021-03-12",7666,201285,2924,86081,3390,110984,1352,4220,4158,71190,3495,66986,5501,138176,"California",927251,0.0722414966389899,133366,0.437,164484,0.539
"1999","kern",1999,"2021-03-13",4429,205714,2303,88384,1791,112775,335,4555,3011,73118,1412,68398,3340,141516,"California",927251,0.0737642774178728,133366,0.437,164484,0.539
"2000","kern",2000,"2021-03-14",2185,207899,1412,89796,534,113309,239,4794,1670,74510,515,68913,1907,143423,"California",927251,0.0743196825886411,133366,0.437,164484,0.539
"2001","kern",2001,"2021-03-15",4247,212146,1088,90884,2446,115755,713,5507,2183,75347,2053,70966,2890,146313,"California",927251,0.076533754075218,133366,0.437,164484,0.539
"2002","kern",2002,"2021-03-16",4332,216478,1008,91892,2796,118551,528,6035,2331,76211,1992,72958,2856,149169,"California",927251,0.0786820397066166,133366,0.437,164484,0.539
"2003","kern",2003,"2021-03-17",7235,223713,3805,95697,2874,121425,556,6591,4299,78140,2925,75883,4854,154023,"California",927251,0.0818365253852517,133366,0.437,164484,0.539
"2004","kern",2004,"2021-03-18",6989,230702,3407,99104,3002,124427,580,7171,4160,80067,2809,78692,4736,158759,"California",927251,0.0848659100933836,133366,0.437,164484,0.539
"2005","kern",2005,"2021-03-19",8749,239451,4770,103874,3331,127758,648,7819,4549,81073,4186,82878,5192,163951,"California",927251,0.089380329597919,133366,0.437,164484,0.539
"2006","kern",2006,"2021-03-20",5938,245389,3593,107467,2171,129929,174,7993,3814,82947,2115,84993,3989,167940,"California",927251,0.0916612653963166,133366,0.437,164484,0.539
"2007","kern",2007,"2021-03-21",2865,248254,1752,109219,236,130165,877,8870,1683,84330,1176,86169,2559,170499,"California",927251,0.0929295304076243,133366,0.437,164484,0.539
"2008","kern",2008,"2021-03-22",3947,252201,1545,110764,2046,132211,356,9226,1921,84591,2015,88184,2276,172775,"California",927251,0.0951026205417951,133366,0.437,164484,0.539
"2009","kern",2009,"2021-03-23",4699,256900,1654,112418,2847,135058,198,9424,2493,85102,2178,90362,2689,175464,"California",927251,0.0974514991086556,133366,0.437,164484,0.539
"2010","kern",2010,"2021-03-24",6998,263898,3509,115927,3017,138075,472,9896,3668,85925,3316,93678,4139,179603,"California",927251,0.101027661334418,133366,0.437,164484,0.539
"2011","kern",2011,"2021-03-25",6632,270530,2883,118810,3419,141494,330,10226,3266,86170,3348,97026,3593,183196,"California",927251,0.104638334172732,133366,0.437,164484,0.539
"2012","kern",2012,"2021-03-26",9595,280125,4152,122962,4189,145683,1254,11480,4748,87339,4831,101857,6000,189196,"California",927251,0.109848358211531,133366,0.437,164484,0.539
"2013","kern",2013,"2021-03-27",5439,285564,3742,126704,1569,147252,128,11608,3302,88633,2135,103992,3429,192625,"California",927251,0.112150863142774,133366,0.437,164484,0.539
"2014","kern",2014,"2021-03-28",4336,289900,3849,130553,473,147725,14,11622,2768,89848,1567,105559,2782,195407,"California",927251,0.113840804701208,133366,0.437,164484,0.539
"2015","kern",2015,"2021-03-29",4202,294102,1636,132189,2288,150013,278,11900,2616,91164,1575,107134,2891,198298,"California",927251,0.115539373912781,133366,0.437,164484,0.539
"2016","kern",2016,"2021-03-30",5536,299638,1826,134015,3325,153338,385,12285,3080,92175,2452,109586,3463,201761,"California",927251,0.118183749599623,133366,0.437,164484,0.539
"2017","kern",2017,"2021-03-31",8122,307760,4281,138296,3196,156534,645,12930,4290,93288,3821,113407,4934,206695,"California",927251,0.12230453242973,133366,0.437,164484,0.539
"2018","kern",2018,"2021-04-01",7612,315372,3638,141934,3677,160211,297,13227,4104,94192,3493,116900,4397,211092,"California",927251,0.126071581481174,133366,0.437,164484,0.539
"2019","kern",2019,"2021-04-02",8139,323511,4188,146122,3348,163559,603,13830,4079,94824,4045,120945,4677,215769,"California",927251,0.13043393859915,133366,0.437,164484,0.539
"2020","kern",2020,"2021-04-03",5684,329195,3394,149516,2108,165667,182,14012,2596,94520,3081,124026,2777,218546,"California",927251,0.133756663513978,133366,0.437,164484,0.539
"2021","kern",2021,"2021-04-04",1328,330523,866,150382,378,166045,84,14096,545,94369,781,124807,630,219176,"California",927251,0.13459893815159,133366,0.437,164484,0.539
"2022","kern",2022,"2021-04-05",5328,335851,2194,152576,2366,168411,768,14864,2887,95568,2431,127238,3630,222806,"California",927251,0.137220666248944,133366,0.437,164484,0.539
"2023","kern",2023,"2021-04-06",7031,342882,2455,155031,3232,171643,1344,16208,3603,97105,3407,130645,4944,227750,"California",927251,0.140894968029153,133366,0.437,164484,0.539
"2024","kern",2024,"2021-04-07",9281,352163,5402,160433,2924,174567,955,17163,4675,98145,4589,135234,5629,233379,"California",927251,0.145844005560522,133366,0.437,164484,0.539
"2025","kern",2025,"2021-04-08",8588,360751,4752,165185,2934,177501,902,18065,3930,98337,4635,139869,4827,238206,"California",927251,0.150842652097436,133366,0.437,164484,0.539
"2026","kern",2026,"2021-04-09",10128,370879,5091,170276,4056,181557,981,19046,4456,98122,5649,145518,5434,243640,"California",927251,0.15693485366961,133366,0.437,164484,0.539
"2027","kern",2027,"2021-04-10",6517,377396,3423,173699,1855,183412,1239,20285,2289,97424,4219,149737,3521,247161,"California",927251,0.161484862243341,133366,0.437,164484,0.539
"2028","kern",2028,"2021-04-11",3762,381158,2886,176585,358,183770,518,20803,1430,97048,2321,152058,1945,249106,"California",927251,0.163987960110046,133366,0.437,164484,0.539
"2029","kern",2029,"2021-04-12",4368,385526,980,177565,2418,186188,970,21773,1570,96803,2783,154841,2538,251644,"California",927251,0.166989304945479,133366,0.437,164484,0.539
"2030","kern",2030,"2021-04-13",4272,389798,1411,178976,2836,189024,25,21798,2128,96824,2133,156974,2154,253798,"California",927251,0.169289652963437,133366,0.437,164484,0.539
"2031","kern",2031,"2021-04-14",6037,395835,2967,181943,3048,192072,22,21820,3076,96975,2946,159920,3097,256895,"California",927251,0.17246678623156,133366,0.437,164484,0.539
"2032","kern",2032,"2021-04-15",5248,401083,2469,184412,2777,194849,2,21822,2528,96801,2704,162624,2530,259425,"California",927251,0.175382932992253,133366,0.437,164484,0.539
"2033","kern",2033,"2021-04-16",7237,408320,3435,187847,3801,198650,1,21823,3081,95749,4135,166759,3083,262508,"California",927251,0.179842351208033,133366,0.437,164484,0.539
"2034","kern",2034,"2021-04-17",5886,414206,3846,191693,2040,200690,0,21823,2248,94372,3626,170385,2249,264757,"California",927251,0.183752834992898,133366,0.437,164484,0.539
"2035","kern",2035,"2021-04-18",3678,417884,3441,195134,237,200927,0,21823,1068,92837,2603,172988,1068,265825,"California",927251,0.186560057632723,133366,0.437,164484,0.539
"2036","kern",2036,"2021-04-19",3796,421680,1723,196857,2072,202999,1,21824,1439,91938,2338,175326,1439,267264,"California",927251,0.189081489262346,133366,0.437,164484,0.539
"2037","kern",2037,"2021-04-20",4300,425980,1538,198395,2761,205760,1,21825,1660,90971,2629,177955,1662,268926,"California",927251,0.19191675177487,133366,0.437,164484,0.539
"2038","kern",2038,"2021-04-21",5853,431833,3123,201518,2725,208485,5,21830,2251,89643,3583,181538,2255,271181,"California",927251,0.195780861924118,133366,0.437,164484,0.539
"2039","kern",2039,"2021-04-22",4780,436613,2311,203829,2469,210954,0,21830,1770,88426,2988,184526,1771,272952,"California",927251,0.199003290371216,133366,0.437,164484,0.539
"2040","kern",2040,"2021-04-23",6048,442661,2940,206769,3107,214061,1,21831,2003,86420,4011,188537,2005,274957,"California",927251,0.203328979963354,133366,0.437,164484,0.539
"2041","kern",2041,"2021-04-24",3931,446592,2732,209501,1189,215250,10,21841,1483,85480,2433,190970,1493,276450,"California",927251,0.205952864973993,133366,0.437,164484,0.539
"2042","kern",2042,"2021-04-25",1341,447933,1063,210564,278,215528,0,21841,772,85688,564,191534,772,277222,"California",927251,0.206561114520232,133366,0.437,164484,0.539
"2043","kern",2043,"2021-04-26",3648,451581,1751,212315,1845,217373,52,21893,1006,84115,2632,194166,1059,278281,"California",927251,0.209399612402683,133366,0.437,164484,0.539
"2044","kern",2044,"2021-04-27",4500,456081,2183,214498,2216,219589,101,21994,1351,82428,3136,197302,1449,279730,"California",927251,0.212781652432836,133366,0.437,164484,0.539
"2045","kern",2045,"2021-04-28",6246,462327,3673,218171,2450,222039,123,22117,1783,79880,4451,201753,1903,281633,"California",927251,0.217581862947573,133366,0.437,164484,0.539
"2046","kern",2046,"2021-04-29",5501,467828,3057,221228,2344,224383,100,22217,1633,77766,3848,205601,1734,283367,"California",927251,0.221731764107022,133366,0.437,164484,0.539
"2047","kern",2047,"2021-04-30",5573,473401,3120,224348,2295,226678,158,22375,1621,75606,3938,209539,1778,285145,"California",927251,0.225978726364275,133366,0.437,164484,0.539
"2048","kern",2048,"2021-05-01",2571,475972,1798,226146,714,227392,59,22434,959,75017,1606,211145,1017,286162,"California",927251,0.227710727731758,133366,0.437,164484,0.539
"2049","kern",2049,"2021-05-02",1887,477859,1602,227748,263,227655,22,22456,696,74549,1186,212331,718,286880,"California",927251,0.228989777309488,133366,0.437,164484,0.539
"2050","kern",2050,"2021-05-03",2424,480283,949,228697,1345,229000,130,22586,749,73770,1660,213991,881,287761,"California",927251,0.230780015335653,133366,0.437,164484,0.539
"2051","kern",2051,"2021-05-04",3537,483820,1236,229933,2192,231192,109,22695,1237,72831,2282,216273,1343,289104,"California",927251,0.23324105339331,133366,0.437,164484,0.539
"2052","kern",2052,"2021-05-05",3880,487700,2108,232041,1625,232817,147,22842,1263,71639,2601,218874,1409,290513,"California",927251,0.23604611911985,133366,0.437,164484,0.539
"2053","kern",2053,"2021-05-06",3245,490945,1562,233603,1554,234371,129,22971,1010,70562,2215,221089,1138,291651,"California",927251,0.238434900582474,133366,0.437,164484,0.539
"2054","kern",2054,"2021-05-07",4233,495178,2259,235862,1807,236178,167,23138,1175,68866,3033,224122,1337,292988,"California",927251,0.241705859578474,133366,0.437,164484,0.539
"2055","kern",2055,"2021-05-08",2799,497977,1763,237625,926,237104,110,23248,871,67930,1917,226039,981,293969,"California",927251,0.243773260961703,133366,0.437,164484,0.539
"2056","kings",2056,"2020-12-16",1,1,1,1,0,0,0,0,1,1,0,0,1,1,"California",156444,0,18699,0.426,24072,0.549
"2057","kings",2057,"2020-12-17",8,9,8,9,0,0,0,0,8,9,0,0,8,9,"California",156444,0,18699,0.426,24072,0.549
"2058","kings",2058,"2020-12-18",12,21,12,21,0,0,0,0,12,21,0,0,12,21,"California",156444,0,18699,0.426,24072,0.549
"2059","kings",2059,"2020-12-19",11,32,11,32,0,0,0,0,11,32,0,0,11,32,"California",156444,0,18699,0.426,24072,0.549
"2060","kings",2060,"2020-12-20",13,45,13,45,0,0,0,0,13,45,0,0,13,45,"California",156444,0,18699,0.426,24072,0.549
"2061","kings",2061,"2020-12-21",156,201,156,201,0,0,0,0,269,314,0,0,269,314,"California",156444,0,18699,0.426,24072,0.549
"2062","kings",2062,"2020-12-22",143,344,143,344,0,0,0,0,140,454,0,0,140,454,"California",156444,0,18699,0.426,24072,0.549
"2063","kings",2063,"2020-12-23",135,479,123,467,12,12,0,0,136,590,0,0,136,590,"California",156444,0,18699,0.426,24072,0.549
"2064","kings",2064,"2020-12-24",11,490,9,476,2,14,0,0,11,601,0,0,11,601,"California",156444,0,18699,0.426,24072,0.549
"2065","kings",2065,"2020-12-26",7,497,4,480,3,17,0,0,7,608,0,0,7,608,"California",156444,0,18699,0.426,24072,0.549
"2066","kings",2066,"2020-12-27",4,501,4,484,0,17,0,0,4,612,0,0,4,612,"California",156444,0,18699,0.426,24072,0.549
"2067","kings",2067,"2020-12-28",131,632,103,587,28,45,0,0,132,744,0,0,132,744,"California",156444,0,18699,0.426,24072,0.549
"2068","kings",2068,"2020-12-29",78,710,51,638,27,72,0,0,79,823,0,0,79,823,"California",156444,0,18699,0.426,24072,0.549
"2069","kings",2069,"2020-12-30",148,858,109,747,39,111,0,0,148,971,0,0,148,971,"California",156444,0,18699,0.426,24072,0.549
"2070","kings",2070,"2020-12-31",45,903,6,753,39,150,0,0,45,1016,0,0,45,1016,"California",156444,0,18699,0.426,24072,0.549
"2071","kings",2071,"2021-01-01",1,904,0,753,1,151,0,0,1,1017,0,0,1,1017,"California",156444,0,18699,0.426,24072,0.549
"2072","kings",2072,"2021-01-02",10,914,9,762,1,152,0,0,10,1027,0,0,10,1027,"California",156444,0,18699,0.426,24072,0.549
"2073","kings",2073,"2021-01-04",112,1026,42,804,70,222,0,0,112,1139,0,0,112,1139,"California",156444,0,18699,0.426,24072,0.549
"2074","kings",2074,"2021-01-05",196,1222,39,843,157,379,0,0,196,1335,0,0,196,1335,"California",156444,0,18699,0.426,24072,0.549
"2075","kings",2075,"2021-01-06",277,1499,178,1021,99,478,0,0,274,1606,3,3,274,1609,"California",156444,1.91761908414513e-05,18699,0.426,24072,0.549
"2076","kings",2076,"2021-01-07",178,1677,81,1102,97,575,0,0,170,1768,8,11,170,1779,"California",156444,7.03126997519879e-05,18699,0.426,24072,0.549
"2077","kings",2077,"2021-01-08",247,1924,54,1156,193,768,0,0,228,1977,19,30,228,2007,"California",156444,0.000191761908414513,18699,0.426,24072,0.549
"2078","kings",2078,"2021-01-09",63,1987,9,1165,54,822,0,0,55,2024,8,38,55,2062,"California",156444,0.000242898417325049,18699,0.426,24072,0.549
"2079","kings",2079,"2021-01-10",15,2002,3,1168,12,834,0,0,12,2033,3,41,12,2074,"California",156444,0.0002620746081665,18699,0.426,24072,0.549
"2080","kings",2080,"2021-01-11",518,2520,354,1522,164,998,0,0,276,2068,242,283,277,2351,"California",156444,0.00180895400271024,18699,0.426,24072,0.549
"2081","kings",2081,"2021-01-12",350,2870,253,1775,97,1095,0,0,216,2153,131,414,216,2567,"California",156444,0.00264631433612027,18699,0.426,24072,0.549
"2082","kings",2082,"2021-01-13",415,3285,268,2043,147,1242,0,0,323,2384,92,506,323,2890,"California",156444,0.00323438418859144,18699,0.426,24072,0.549
"2083","kings",2083,"2021-01-14",209,3494,31,2074,178,1420,0,0,199,2563,21,527,200,3090,"California",156444,0.0033686175244816,18699,0.426,24072,0.549
"2084","kings",2084,"2021-01-15",417,3911,29,2103,388,1808,0,0,405,2956,12,539,405,3495,"California",156444,0.00344532228784741,18699,0.426,24072,0.549
"2085","kings",2085,"2021-01-16",31,3942,12,2115,19,1827,0,0,30,2985,1,540,30,3525,"California",156444,0.00345171435146123,18699,0.426,24072,0.549
"2086","kings",2086,"2021-01-17",9,3951,6,2121,3,1830,0,0,7,2990,2,542,7,3532,"California",156444,0.00346449847868886,18699,0.426,24072,0.549
"2087","kings",2087,"2021-01-18",172,4123,40,2161,132,1962,0,0,146,3110,26,568,146,3678,"California",156444,0.0036306921326481,18699,0.426,24072,0.549
"2088","kings",2088,"2021-01-19",377,4500,158,2319,219,2181,0,0,249,3231,128,696,249,3927,"California",156444,0.00444887627521669,18699,0.426,24072,0.549
"2089","kings",2089,"2021-01-20",236,4736,145,2464,91,2272,0,0,126,3252,105,801,126,4053,"California",156444,0.00512004295466748,18699,0.426,24072,0.549
"2090","kings",2090,"2021-01-21",190,4926,35,2499,155,2427,0,0,174,3408,18,819,174,4227,"California",156444,0.00523510009971619,18699,0.426,24072,0.549
"2091","kings",2091,"2021-01-22",126,5052,40,2539,86,2513,0,0,126,3529,5,824,126,4353,"California",156444,0.00526706041778528,18699,0.426,24072,0.549
"2092","kings",2092,"2021-01-23",26,5078,14,2553,12,2525,0,0,20,3543,6,830,20,4373,"California",156444,0.00530541279946818,18699,0.426,24072,0.549
"2093","kings",2093,"2021-01-24",4,5082,4,2557,0,2525,0,0,2,3543,2,832,2,4375,"California",156444,0.00531819692669581,18699,0.426,24072,0.549
"2094","kings",2094,"2021-01-25",124,5206,26,2583,98,2623,0,0,90,3599,34,866,90,4465,"California",156444,0.0055355270895656,18699,0.426,24072,0.549
"2095","kings",2095,"2021-01-26",154,5360,35,2618,119,2742,0,0,115,3675,39,905,115,4580,"California",156444,0.00578481757050446,18699,0.426,24072,0.549
"2096","kings",2096,"2021-01-27",319,5679,34,2652,285,3027,0,0,249,3855,69,974,249,4829,"California",156444,0.00622586995985784,18699,0.426,24072,0.549
"2097","kings",2097,"2021-01-28",326,6005,46,2698,280,3307,0,0,271,4071,55,1029,271,5100,"California",156444,0.00657743345861778,18699,0.426,24072,0.549
"2098","kings",2098,"2021-01-29",86,6091,26,2724,60,3367,0,0,69,4123,17,1046,69,5169,"California",156444,0.00668609854005267,18699,0.426,24072,0.549
"2099","kings",2099,"2021-01-30",1556,7647,31,2755,1525,4892,0,0,1553,5675,3,1049,1555,6724,"California",156444,0.00670527473089412,18699,0.426,24072,0.549
"2100","kings",2100,"2021-02-01",199,7846,64,2819,135,5027,0,0,72,5622,125,1174,72,6796,"California",156444,0.00750428268262126,18699,0.426,24072,0.549
"2101","kings",2101,"2021-02-02",232,8078,14,2833,218,5245,0,0,82,5555,149,1323,82,6878,"California",156444,0.00845670016108,18699,0.426,24072,0.549
"2102","kings",2102,"2021-02-03",357,8435,191,3024,166,5411,0,0,203,5605,153,1476,203,7081,"California",156444,0.00943468589399402,18699,0.426,24072,0.549
"2103","kings",2103,"2021-02-04",395,8830,98,3122,297,5708,0,0,198,5607,196,1672,198,7279,"California",156444,0.0106875303623022,18699,0.426,24072,0.549
"2104","kings",2104,"2021-02-05",257,9087,14,3136,243,5951,0,0,101,5554,154,1826,101,7380,"California",156444,0.01167190815883,18699,0.426,24072,0.549
"2105","kings",2105,"2021-02-06",61,9148,10,3146,51,6002,0,0,28,5549,33,1859,28,7408,"California",156444,0.011882846258086,18699,0.426,24072,0.549
"2106","kings",2106,"2021-02-07",5,9153,3,3149,2,6004,0,0,3,5550,2,1861,3,7411,"California",156444,0.0118956303853136,18699,0.426,24072,0.549
"2107","kings",2107,"2021-02-08",171,9324,29,3178,142,6146,0,0,68,5515,103,1964,68,7479,"California",156444,0.0125540129375368,18699,0.426,24072,0.549
"2108","kings",2108,"2021-02-09",253,9577,57,3235,196,6342,0,0,110,5484,141,2105,110,7589,"California",156444,0.013455293907085,18699,0.426,24072,0.549
"2109","kings",2109,"2021-02-10",285,9862,112,3347,173,6515,0,0,169,5537,116,2221,169,7758,"California",156444,0.0141967732862877,18699,0.426,24072,0.549
"2110","kings",2110,"2021-02-11",430,10292,65,3412,365,6880,0,0,316,5740,113,2334,316,8074,"California",156444,0.0149190764746491,18699,0.426,24072,0.549
"2111","kings",2111,"2021-02-12",623,10915,36,3448,587,7467,0,0,347,5812,275,2609,347,8421,"California",156444,0.0166768939684488,18699,0.426,24072,0.549
"2112","kings",2112,"2021-02-13",104,11019,6,3454,98,7565,0,0,78,5864,26,2635,78,8499,"California",156444,0.016843087622408,18699,0.426,24072,0.549
"2113","kings",2113,"2021-02-14",102,11121,4,3458,98,7663,0,0,94,5950,8,2643,94,8593,"California",156444,0.0168942241313186,18699,0.426,24072,0.549
"2114","kings",2114,"2021-02-15",246,11367,5,3463,241,7904,0,0,137,5979,108,2751,137,8730,"California",156444,0.0175845670016108,18699,0.426,24072,0.549
"2115","kings",2115,"2021-02-16",486,11853,33,3496,453,8357,0,0,251,5996,234,2985,251,8981,"California",156444,0.019080309887244,18699,0.426,24072,0.549
"2116","kings",2116,"2021-02-17",380,12233,23,3519,357,8714,0,0,243,6103,137,3122,244,9225,"California",156444,0.0199560226023369,18699,0.426,24072,0.549
"2117","kings",2117,"2021-02-18",155,12388,23,3542,132,8846,0,0,98,6144,57,3179,98,9323,"California",156444,0.0203203702283245,18699,0.426,24072,0.549
"2118","kings",2118,"2021-02-19",158,12546,23,3565,135,8981,0,0,102,6193,53,3232,102,9425,"California",156444,0.0206591495998568,18699,0.426,24072,0.549
"2119","kings",2119,"2021-02-20",171,12717,40,3605,131,9112,0,0,134,6290,37,3269,134,9559,"California",156444,0.020895655953568,18699,0.426,24072,0.549
"2120","kings",2120,"2021-02-21",3,12720,2,3607,1,9113,0,0,3,6293,0,3269,3,9562,"California",156444,0.020895655953568,18699,0.426,24072,0.549
"2121","kings",2121,"2021-02-22",110,12830,19,3626,91,9204,0,0,51,6285,59,3328,51,9613,"California",156444,0.0212727877067833,18699,0.426,24072,0.549
"2122","kings",2122,"2021-02-23",296,13126,69,3695,227,9431,0,0,179,6347,117,3445,179,9792,"California",156444,0.0220206591495999,18699,0.426,24072,0.549
"2123","kings",2123,"2021-02-24",592,13718,154,3849,438,9869,0,0,380,6515,212,3657,380,10172,"California",156444,0.0233757766357291,18699,0.426,24072,0.549
"2124","kings",2124,"2021-02-25",667,14385,115,3964,552,10421,0,0,449,6748,216,3873,449,10621,"California",156444,0.0247564623763136,18699,0.426,24072,0.549
"2125","kings",2125,"2021-02-26",657,15042,129,4093,528,10949,0,0,594,7280,62,3935,594,11215,"California",156444,0.0251527703203702,18699,0.426,24072,0.549
"2126","kings",2126,"2021-02-27",1498,16540,62,4155,1436,12385,0,0,564,6911,933,4868,564,11779,"California",156444,0.0311165656720616,18699,0.426,24072,0.549
"2127","kings",2127,"2021-02-28",1172,17712,597,4752,575,12960,0,0,674,7090,495,5363,674,12453,"California",156444,0.034280637160901,18699,0.426,24072,0.549
"2128","kings",2128,"2021-03-01",259,17971,79,4831,180,13140,0,0,214,7259,45,5408,214,12667,"California",156444,0.0345682800235228,18699,0.426,24072,0.549
"2129","kings",2129,"2021-03-02",474,18445,207,5038,267,13407,0,0,423,7632,51,5459,424,13091,"California",156444,0.0348942752678275,18699,0.426,24072,0.549
"2130","kings",2130,"2021-03-03",629,19074,304,5342,325,13732,0,0,439,7883,188,5647,439,13530,"California",156444,0.0360959832272251,18699,0.426,24072,0.549
"2131","kings",2131,"2021-03-04",718,19792,343,5685,375,14107,0,0,622,8410,96,5743,623,14153,"California",156444,0.0367096213341515,18699,0.426,24072,0.549
"2132","kings",2132,"2021-03-05",1059,20851,349,6034,701,14808,9,9,942,9246,116,5859,952,15105,"California",156444,0.0374511007133543,18699,0.426,24072,0.549
"2133","kings",2133,"2021-03-06",511,21362,184,6218,314,15122,13,22,481,9710,30,5889,494,15599,"California",156444,0.0376428626217688,18699,0.426,24072,0.549
"2134","kings",2134,"2021-03-07",366,21728,225,6443,137,15259,4,26,358,10064,8,5897,362,15961,"California",156444,0.0376939991306793,18699,0.426,24072,0.549
"2135","kings",2135,"2021-03-08",369,22097,96,6539,220,15479,53,79,261,10269,108,6005,313,16274,"California",156444,0.0383843420009716,18699,0.426,24072,0.549
"2136","kings",2136,"2021-03-09",524,22621,239,6778,230,15709,55,134,417,10636,106,6111,473,16747,"California",156444,0.0390619007440362,18699,0.426,24072,0.549
"2137","kings",2137,"2021-03-10",506,23127,125,6903,290,15999,91,225,322,10865,183,6294,412,17159,"California",156444,0.0402316483853647,18699,0.426,24072,0.549
"2138","kings",2138,"2021-03-11",1023,24150,305,7208,608,16607,110,335,618,11190,403,6697,728,17887,"California",156444,0.042807650021733,18699,0.426,24072,0.549
"2139","kings",2139,"2021-03-12",1355,25505,438,7646,823,17430,94,429,954,11840,400,7097,1050,18937,"California",156444,0.0453644754672599,18699,0.426,24072,0.549
"2140","kings",2140,"2021-03-13",671,26176,332,7978,295,17725,44,473,545,12304,126,7223,590,19527,"California",156444,0.0461698754826008,18699,0.426,24072,0.549
"2141","kings",2141,"2021-03-14",671,26847,101,8079,184,17909,386,859,200,12419,471,7694,586,20113,"California",156444,0.0491805374447086,18699,0.426,24072,0.549
"2142","kings",2142,"2021-03-15",701,27548,264,8343,322,18231,115,974,465,12766,235,7929,582,20695,"California",156444,0.0506826723939557,18699,0.426,24072,0.549
"2143","kings",2143,"2021-03-16",1040,28588,438,8781,541,18772,61,1035,703,13194,336,8265,764,21459,"California",156444,0.0528304057681982,18699,0.426,24072,0.549
"2144","kings",2144,"2021-03-17",1089,29677,417,9198,611,19383,61,1096,770,13713,319,8584,838,22297,"California",156444,0.0548694740610059,18699,0.426,24072,0.549
"2145","kings",2145,"2021-03-18",1101,30778,467,9665,412,19795,222,1318,769,14376,331,8915,994,23291,"California",156444,0.0569852471171793,18699,0.426,24072,0.549
"2146","kings",2146,"2021-03-19",949,31727,468,10133,396,20191,85,1403,732,14989,217,9132,830,24121,"California",156444,0.0583723249213776,18699,0.426,24072,0.549
"2147","kings",2147,"2021-03-20",624,32351,255,10388,338,20529,31,1434,450,15305,172,9304,488,24609,"California",156444,0.0594717598629542,18699,0.426,24072,0.549
"2148","kings",2148,"2021-03-21",1400,33751,1085,11473,304,20833,11,1445,846,15608,554,9858,857,25466,"California",156444,0.0630129631050088,18699,0.426,24072,0.549
"2149","kings",2149,"2021-03-22",450,34201,203,11676,164,20997,83,1528,277,15799,173,10031,364,25830,"California",156444,0.0641187901101992,18699,0.426,24072,0.549
"2150","kings",2150,"2021-03-23",900,35101,493,12169,344,21341,63,1591,576,16119,322,10353,642,26472,"California",156444,0.0661770345938483,18699,0.426,24072,0.549
"2151","kings",2151,"2021-03-24",923,36024,479,12648,421,21762,23,1614,512,16247,409,10762,537,27009,"California",156444,0.0687913886118995,18699,0.426,24072,0.549
"2152","kings",2152,"2021-03-25",894,36918,446,13094,422,22184,26,1640,446,16273,446,11208,472,27481,"California",156444,0.0716422489836619,18699,0.426,24072,0.549
"2153","kings",2153,"2021-03-26",1281,38199,373,13467,823,23007,85,1725,529,16139,747,11955,613,28094,"California",156444,0.0764171205031833,18699,0.426,24072,0.549
"2154","kings",2154,"2021-03-27",616,38815,245,13712,359,23366,12,1737,169,15875,445,12400,181,28275,"California",156444,0.0792615888113319,18699,0.426,24072,0.549
"2155","kings",2155,"2021-03-28",548,39363,477,14189,64,23430,7,1744,342,16026,206,12606,357,28632,"California",156444,0.0805783539157782,18699,0.426,24072,0.549
"2156","kings",2156,"2021-03-29",458,39821,201,14390,196,23626,61,1805,251,16132,205,12811,311,28943,"California",156444,0.0818887269566107,18699,0.426,24072,0.549
"2157","kings",2157,"2021-03-30",843,40664,463,14853,342,23968,38,1843,422,16172,420,13231,460,29403,"California",156444,0.0845733936744138,18699,0.426,24072,0.549
"2158","kings",2158,"2021-03-31",724,41388,374,15227,286,24254,64,1907,415,16349,302,13533,479,29882,"California",156444,0.0865037968857866,18699,0.426,24072,0.549
"2159","kings",2159,"2021-04-01",758,42146,381,15608,294,24548,83,1990,343,16366,409,13942,426,30308,"California",156444,0.0891181509038378,18699,0.426,24072,0.549
"2160","kings",2160,"2021-04-02",983,43129,428,16036,433,24981,122,2112,388,16285,590,14532,509,30817,"California",156444,0.0928894684359899,18699,0.426,24072,0.549
"2161","kings",2161,"2021-04-03",475,43604,330,16366,137,25118,8,2120,161,16148,308,14840,171,30988,"California",156444,0.0948582240290455,18699,0.426,24072,0.549
"2162","kings",2162,"2021-04-04",156,43760,82,16448,68,25186,6,2126,43,16085,112,14952,49,31037,"California",156444,0.0955741351537931,18699,0.426,24072,0.549
"2163","kings",2163,"2021-04-05",1047,44807,323,16771,474,25660,250,2376,234,15757,811,15763,483,31520,"California",156444,0.100758098744599,18699,0.426,24072,0.549
"2164","kings",2164,"2021-04-06",1186,45993,447,17218,432,26092,307,2683,293,15466,890,16653,599,32119,"California",156444,0.106447035360896,18699,0.426,24072,0.549
"2165","kings",2165,"2021-04-07",1341,47334,640,17858,514,26606,187,2870,413,15141,925,17578,600,32719,"California",156444,0.112359694203677,18699,0.426,24072,0.549
"2166","kings",2166,"2021-04-08",1593,48927,628,18486,714,27320,251,3121,363,14532,1223,18801,614,33333,"California",156444,0.120177188003375,18699,0.426,24072,0.549
"2167","kings",2167,"2021-04-09",1111,50038,522,19008,413,27733,176,3297,242,14080,867,19668,415,33748,"California",156444,0.125719107156554,18699,0.426,24072,0.549
"2168","kings",2168,"2021-04-10",593,50631,329,19337,162,27895,102,3399,181,13952,411,20079,283,34031,"California",156444,0.128346245301833,18699,0.426,24072,0.549
"2169","kings",2169,"2021-04-11",328,50959,74,19411,248,28143,6,3405,196,14022,132,20211,202,34233,"California",156444,0.129189997698857,18699,0.426,24072,0.549
"2170","kings",2170,"2021-04-12",697,51656,311,19722,186,28329,200,3605,190,13906,506,20717,390,34623,"California",156444,0.132424381887449,18699,0.426,24072,0.549
"2171","kings",2171,"2021-04-13",888,52544,508,20230,380,28709,0,3605,288,13600,599,21316,293,34916,"California",156444,0.136253227992125,18699,0.426,24072,0.549
"2172","kings",2172,"2021-04-14",1023,53567,565,20795,458,29167,0,3605,372,13322,651,21967,373,35289,"California",156444,0.14041446140472,18699,0.426,24072,0.549
"2173","kings",2173,"2021-04-15",1050,54617,519,21314,530,29697,1,3606,468,13210,581,22548,469,35758,"California",156444,0.144128250364348,18699,0.426,24072,0.549
"2174","kings",2174,"2021-04-16",765,55382,360,21674,405,30102,0,3606,267,12980,497,23045,267,36025,"California",156444,0.147305105980415,18699,0.426,24072,0.549
"2175","kings",2175,"2021-04-17",455,55837,242,21916,213,30315,0,3606,198,12922,256,23301,198,36223,"California",156444,0.148941474265552,18699,0.426,24072,0.549
"2176","kings",2176,"2021-04-18",552,56389,239,22155,313,30628,0,3606,71,12512,481,23782,71,36294,"California",156444,0.152016056863798,18699,0.426,24072,0.549
"2177","kings",2177,"2021-04-19",524,56913,287,22442,237,30865,0,3606,285,12560,237,24019,285,36579,"California",156444,0.153530975940273,18699,0.426,24072,0.549
"2178","kings",2178,"2021-04-20",733,57646,443,22885,290,31155,0,3606,246,12320,486,24505,246,36825,"California",156444,0.156637518856588,18699,0.426,24072,0.549
"2179","kings",2179,"2021-04-21",636,58282,305,23190,331,31486,0,3606,220,12131,409,24914,220,37045,"California",156444,0.159251872874639,18699,0.426,24072,0.549
"2180","kings",2180,"2021-04-22",550,58832,275,23465,275,31761,0,3606,201,11988,345,25259,202,37247,"California",156444,0.161457134821406,18699,0.426,24072,0.549
"2181","kings",2181,"2021-04-23",662,59494,290,23755,372,32133,0,3606,328,11985,331,25590,328,37575,"California",156444,0.163572907877579,18699,0.426,24072,0.549
"2182","kings",2182,"2021-04-24",244,59738,178,23933,65,32198,1,3607,120,11983,123,25713,121,37696,"California",156444,0.164359131702079,18699,0.426,24072,0.549
"2183","kings",2183,"2021-04-25",195,59933,176,24109,19,32217,0,3607,159,12106,36,25749,159,37855,"California",156444,0.164589245992176,18699,0.426,24072,0.549
"2184","kings",2184,"2021-04-26",289,60222,147,24256,139,32356,3,3610,180,12181,108,25857,183,38038,"California",156444,0.165279588862468,18699,0.426,24072,0.549
"2185","kings",2185,"2021-04-27",395,60617,174,24430,202,32558,19,3629,164,12134,230,26087,183,38221,"California",156444,0.166749763493646,18699,0.426,24072,0.549
"2186","kings",2186,"2021-04-28",504,61121,254,24684,230,32788,20,3649,264,12178,240,26327,284,38505,"California",156444,0.168283858760962,18699,0.426,24072,0.549
"2187","kings",2187,"2021-04-29",285,61406,112,24796,162,32950,11,3660,133,12172,150,26477,144,38649,"California",156444,0.169242668303035,18699,0.426,24072,0.549
"2188","kings",2188,"2021-04-30",365,61771,163,24959,185,33135,17,3677,151,12129,211,26688,168,38817,"California",156444,0.17059139372555,18699,0.426,24072,0.549
"2189","kings",2189,"2021-05-01",229,62000,166,25125,53,33188,10,3687,74,12060,153,26841,84,38901,"California",156444,0.171569379458464,18699,0.426,24072,0.549
"2190","kings",2190,"2021-05-02",167,62167,145,25270,22,33210,0,3687,125,12143,42,26883,125,39026,"California",156444,0.171837846130245,18699,0.426,24072,0.549
"2191","kings",2191,"2021-05-03",473,62640,254,25524,205,33415,14,3701,123,11931,349,27232,137,39163,"California",156444,0.174068676331467,18699,0.426,24072,0.549
"2192","kings",2192,"2021-05-04",516,63156,258,25782,237,33652,21,3722,161,11759,354,27586,182,39345,"California",156444,0.176331466850758,18699,0.426,24072,0.549
"2193","kings",2193,"2021-05-05",539,63695,277,26059,239,33891,23,3745,138,11519,401,27987,161,39506,"California",156444,0.178894684359899,18699,0.426,24072,0.549
"2194","kings",2194,"2021-05-06",533,64228,267,26326,243,34134,23,3768,123,11257,408,28395,146,39652,"California",156444,0.181502646314336,18699,0.426,24072,0.549
"2195","kings",2195,"2021-05-07",367,64595,212,26538,142,34276,13,3781,150,11205,215,28610,163,39815,"California",156444,0.182876939991307,18699,0.426,24072,0.549
"2196","kings",2196,"2021-05-08",229,64824,167,26705,52,34328,10,3791,74,11134,155,28765,84,39899,"California",156444,0.183867709851448,18699,0.426,24072,0.549
"2197","lake",2197,"2020-12-17",4,4,4,4,0,0,0,0,4,4,0,0,4,4,"California",64871,0,14941,0.519,13123,0.456
"2198","lake",2198,"2020-12-18",51,55,51,55,0,0,0,0,51,55,0,0,51,55,"California",64871,0,14941,0.519,13123,0.456
"2199","lake",2199,"2020-12-19",3,58,3,58,0,0,0,0,3,58,0,0,3,58,"California",64871,0,14941,0.519,13123,0.456
"2200","lake",2200,"2020-12-20",6,64,6,64,0,0,0,0,6,64,0,0,6,64,"California",64871,0,14941,0.519,13123,0.456
"2201","lake",2201,"2020-12-21",86,150,86,150,0,0,0,0,86,150,0,0,86,150,"California",64871,0,14941,0.519,13123,0.456
"2202","lake",2202,"2020-12-22",63,213,60,210,3,3,0,0,63,213,0,0,63,213,"California",64871,0,14941,0.519,13123,0.456
"2203","lake",2203,"2020-12-23",123,336,114,324,9,12,0,0,123,336,0,0,123,336,"California",64871,0,14941,0.519,13123,0.456
"2204","lake",2204,"2020-12-24",2,338,0,324,2,14,0,0,2,338,0,0,2,338,"California",64871,0,14941,0.519,13123,0.456
"2205","lake",2205,"2020-12-26",2,340,2,326,0,14,0,0,2,340,0,0,2,340,"California",64871,0,14941,0.519,13123,0.456
"2206","lake",2206,"2020-12-27",2,342,2,328,0,14,0,0,2,342,0,0,2,342,"California",64871,0,14941,0.519,13123,0.456
"2207","lake",2207,"2020-12-28",52,394,43,371,9,23,0,0,52,394,0,0,52,394,"California",64871,0,14941,0.519,13123,0.456
"2208","lake",2208,"2020-12-29",50,444,45,416,5,28,0,0,50,444,0,0,50,444,"California",64871,0,14941,0.519,13123,0.456
"2209","lake",2209,"2020-12-30",125,569,118,534,7,35,0,0,125,569,0,0,125,569,"California",64871,0,14941,0.519,13123,0.456
"2210","lake",2210,"2020-12-31",67,636,64,598,3,38,0,0,67,636,0,0,67,636,"California",64871,0,14941,0.519,13123,0.456
"2211","lake",2211,"2021-01-01",1,637,0,598,1,39,0,0,1,637,0,0,1,637,"California",64871,0,14941,0.519,13123,0.456
"2212","lake",2212,"2021-01-02",2,639,1,599,1,40,0,0,2,639,0,0,2,639,"California",64871,0,14941,0.519,13123,0.456
"2213","lake",2213,"2021-01-04",87,726,21,620,66,106,0,0,87,726,0,0,87,726,"California",64871,0,14941,0.519,13123,0.456
"2214","lake",2214,"2021-01-05",120,846,59,679,61,167,0,0,118,842,2,2,118,844,"California",64871,3.0830417289698e-05,14941,0.519,13123,0.456
"2215","lake",2215,"2021-01-06",105,951,65,744,40,207,0,0,103,943,2,4,103,947,"California",64871,6.1660834579396e-05,14941,0.519,13123,0.456
"2216","lake",2216,"2021-01-07",108,1059,85,829,23,230,0,0,99,1033,9,13,99,1046,"California",64871,0.000200397712383037,14941,0.519,13123,0.456
"2217","lake",2217,"2021-01-08",152,1211,124,953,28,258,0,0,100,1081,52,65,100,1146,"California",64871,0.00100198856191519,14941,0.519,13123,0.456
"2218","lake",2218,"2021-01-09",63,1274,61,1014,2,260,0,0,59,1136,4,69,59,1205,"California",64871,0.00106364939649458,14941,0.519,13123,0.456
"2219","lake",2219,"2021-01-10",3,1277,3,1017,0,260,0,0,0,1133,3,72,0,1205,"California",64871,0.00110989502242913,14941,0.519,13123,0.456
"2220","lake",2220,"2021-01-11",192,1469,151,1168,41,301,0,0,112,1165,80,152,112,1317,"California",64871,0.00234311171401705,14941,0.519,13123,0.456
"2221","lake",2221,"2021-01-12",81,1550,48,1216,33,334,0,0,57,1198,24,176,57,1374,"California",64871,0.00271307672149343,14941,0.519,13123,0.456
"2222","lake",2222,"2021-01-13",164,1714,112,1328,52,386,0,0,107,1248,57,233,107,1481,"California",64871,0.00359174361424982,14941,0.519,13123,0.456
"2223","lake",2223,"2021-01-14",147,1861,46,1374,101,487,0,0,125,1351,22,255,125,1606,"California",64871,0.0039308782044365,14941,0.519,13123,0.456
"2224","lake",2224,"2021-01-15",215,2076,92,1466,123,610,0,0,188,1512,27,282,188,1794,"California",64871,0.00434708883784742,14941,0.519,13123,0.456
"2225","lake",2225,"2021-01-16",134,2210,81,1547,53,663,0,0,132,1642,2,284,132,1926,"California",64871,0.00437791925513712,14941,0.519,13123,0.456
"2226","lake",2226,"2021-01-17",18,2228,6,1553,12,675,0,0,12,1648,6,290,12,1938,"California",64871,0.00447041050700621,14941,0.519,13123,0.456
"2227","lake",2227,"2021-01-18",246,2474,226,1779,20,695,0,0,126,1654,120,410,126,2064,"California",64871,0.00632023554438809,14941,0.519,13123,0.456
"2228","lake",2228,"2021-01-19",311,2785,117,1896,194,889,0,0,266,1876,45,455,267,2331,"California",64871,0.0070139199334063,14941,0.519,13123,0.456
"2229","lake",2229,"2021-01-20",422,3207,80,1976,342,1231,0,0,358,2171,63,518,358,2689,"California",64871,0.00798507807803179,14941,0.519,13123,0.456
"2230","lake",2230,"2021-01-21",433,3640,49,2025,384,1615,0,0,398,2534,35,553,398,3087,"California",64871,0.0085246103806015,14941,0.519,13123,0.456
"2231","lake",2231,"2021-01-22",318,3958,46,2071,272,1887,0,0,282,2780,36,589,282,3369,"California",64871,0.00907955789181607,14941,0.519,13123,0.456
"2232","lake",2232,"2021-01-23",122,4080,5,2076,117,2004,0,0,121,2900,1,590,121,3490,"California",64871,0.00909497310046091,14941,0.519,13123,0.456
"2233","lake",2233,"2021-01-24",5,4085,2,2078,3,2007,0,0,5,2905,0,590,5,3495,"California",64871,0.00909497310046091,14941,0.519,13123,0.456
"2234","lake",2234,"2021-01-25",257,4342,95,2173,162,2169,0,0,176,3000,81,671,176,3671,"California",64871,0.0103436050006937,14941,0.519,13123,0.456
"2235","lake",2235,"2021-01-26",428,4770,36,2209,392,2561,0,0,405,3382,23,694,405,4076,"California",64871,0.0106981547995252,14941,0.519,13123,0.456
"2236","lake",2236,"2021-01-27",359,5129,41,2250,318,2879,0,0,331,3686,28,722,332,4408,"California",64871,0.011129780641581,14941,0.519,13123,0.456
"2237","lake",2237,"2021-01-28",498,5627,161,2411,337,3216,0,0,368,3924,130,852,368,4776,"California",64871,0.0131337577654114,14941,0.519,13123,0.456
"2238","lake",2238,"2021-01-29",636,6263,83,2494,553,3769,0,0,576,4440,60,912,576,5352,"California",64871,0.0140586702841023,14941,0.519,13123,0.456
"2239","lake",2239,"2021-01-30",555,6818,44,2538,511,4280,0,0,549,4983,6,918,549,5901,"California",64871,0.0141511615359714,14941,0.519,13123,0.456
"2240","lake",2240,"2021-01-31",14,6832,8,2546,6,4286,0,0,12,4993,2,920,12,5913,"California",64871,0.0141819919532611,14941,0.519,13123,0.456
"2241","lake",2241,"2021-02-01",179,7011,18,2564,161,4447,0,0,166,5146,13,933,166,6079,"California",64871,0.0143823896656441,14941,0.519,13123,0.456
"2242","lake",2242,"2021-02-02",564,7575,151,2715,413,4860,0,0,398,5378,166,1099,398,6477,"California",64871,0.0169413143006891,14941,0.519,13123,0.456
"2243","lake",2243,"2021-02-03",445,8020,33,2748,412,5272,0,0,340,5613,105,1204,340,6817,"California",64871,0.0185599112083982,14941,0.519,13123,0.456
"2244","lake",2244,"2021-02-04",120,8140,69,2817,51,5323,0,0,73,5639,47,1251,73,6890,"California",64871,0.0192844260147061,14941,0.519,13123,0.456
"2245","lake",2245,"2021-02-05",379,8519,70,2887,309,5632,0,0,288,5838,89,1340,288,7178,"California",64871,0.0206563795840977,14941,0.519,13123,0.456
"2246","lake",2246,"2021-02-06",276,8795,41,2928,235,5867,0,0,265,6092,11,1351,265,7443,"California",64871,0.020825946879191,14941,0.519,13123,0.456
"2247","lake",2247,"2021-02-07",2,8797,1,2929,1,5868,0,0,2,6094,0,1351,2,7445,"California",64871,0.020825946879191,14941,0.519,13123,0.456
"2248","lake",2248,"2021-02-08",278,9075,206,3135,72,5940,0,0,159,6134,119,1470,159,7604,"California",64871,0.022660356707928,14941,0.519,13123,0.456
"2249","lake",2249,"2021-02-09",345,9420,25,3160,320,6260,0,0,301,6392,43,1513,301,7905,"California",64871,0.0233232106796566,14941,0.519,13123,0.456
"2250","lake",2250,"2021-02-10",351,9771,54,3214,297,6557,0,0,274,6589,77,1590,274,8179,"California",64871,0.0245101817453099,14941,0.519,13123,0.456
"2251","lake",2251,"2021-02-11",169,9940,18,3232,151,6708,0,0,56,6532,113,1703,56,8235,"California",64871,0.0262521003221779,14941,0.519,13123,0.456
"2252","lake",2252,"2021-02-12",376,10316,29,3261,347,7055,0,0,289,6735,86,1789,289,8524,"California",64871,0.0275778082656349,14941,0.519,13123,0.456
"2253","lake",2253,"2021-02-13",247,10563,7,3268,240,7295,0,0,236,6960,11,1800,236,8760,"California",64871,0.0277473755607282,14941,0.519,13123,0.456
"2254","lake",2254,"2021-02-14",20,10583,5,3273,15,7310,0,0,6,6952,14,1814,6,8766,"California",64871,0.0279631884817561,14941,0.519,13123,0.456
"2255","lake",2255,"2021-02-15",172,10755,13,3286,159,7469,0,0,8,6797,163,1977,8,8774,"California",64871,0.0304758674908665,14941,0.519,13123,0.456
"2256","lake",2256,"2021-02-16",423,11178,23,3309,400,7869,0,0,176,6726,247,2224,176,8950,"California",64871,0.0342834240261442,14941,0.519,13123,0.456
"2257","lake",2257,"2021-02-17",351,11529,54,3363,297,8166,0,0,70,6516,280,2504,70,9020,"California",64871,0.0385996824467019,14941,0.519,13123,0.456
"2258","lake",2258,"2021-02-18",458,11987,69,3432,389,8555,0,0,114,6286,344,2848,114,9134,"California",64871,0.04390251422053,14941,0.519,13123,0.456
"2259","lake",2259,"2021-02-19",418,12405,25,3457,393,8948,0,0,93,6054,325,3173,93,9227,"California",64871,0.0489124570301059,14941,0.519,13123,0.456
"2260","lake",2260,"2021-02-20",294,12699,60,3517,234,9182,0,0,251,6263,42,3215,251,9478,"California",64871,0.0495598957931896,14941,0.519,13123,0.456
"2261","lake",2261,"2021-02-21",6,12705,6,3523,0,9182,0,0,0,6257,6,3221,0,9478,"California",64871,0.0496523870450587,14941,0.519,13123,0.456
"2262","lake",2262,"2021-02-22",140,12845,23,3546,117,9299,0,0,43,6203,97,3318,43,9521,"California",64871,0.051147662283609,14941,0.519,13123,0.456
"2263","lake",2263,"2021-02-23",213,13058,14,3560,199,9498,0,0,28,6046,185,3503,28,9549,"California",64871,0.0539994758829061,14941,0.519,13123,0.456
"2264","lake",2264,"2021-02-24",955,14013,377,3937,578,10076,0,0,416,5924,538,4041,416,9965,"California",64871,0.0622928581338348,14941,0.519,13123,0.456
"2265","lake",2265,"2021-02-25",731,14744,464,4401,267,10343,0,0,472,6139,257,4298,472,10437,"California",64871,0.066254566755561,14941,0.519,13123,0.456
"2266","lake",2266,"2021-02-26",995,15739,304,4705,691,11034,0,0,350,5847,642,4940,350,10787,"California",64871,0.0761511307055541,14941,0.519,13123,0.456
"2267","lake",2267,"2021-02-27",411,16150,98,4803,313,11347,0,0,328,6092,83,5023,328,11115,"California",64871,0.0774305930230766,14941,0.519,13123,0.456
"2268","lake",2268,"2021-02-28",18,16168,12,4815,6,11353,0,0,10,6094,8,5031,10,11125,"California",64871,0.0775539146922354,14941,0.519,13123,0.456
"2269","lake",2269,"2021-03-01",596,16764,53,4868,543,11896,0,0,443,6384,153,5184,443,11568,"California",64871,0.0799124416148973,14941,0.519,13123,0.456
"2270","lake",2270,"2021-03-02",746,17510,18,4886,728,12624,0,0,289,6216,457,5641,289,11857,"California",64871,0.0869571919655932,14941,0.519,13123,0.456
"2271","lake",2271,"2021-03-03",359,17869,196,5082,163,12787,0,0,135,6127,224,5865,135,11992,"California",64871,0.0904101987020394,14941,0.519,13123,0.456
"2272","lake",2272,"2021-03-04",579,18448,510,5592,69,12856,0,0,562,6672,17,5882,562,12554,"California",64871,0.0906722572490019,14941,0.519,13123,0.456
"2273","lake",2273,"2021-03-05",1037,19485,40,5632,997,13853,0,0,174,5987,859,6741,174,12728,"California",64871,0.103913921474927,14941,0.519,13123,0.456
"2274","lake",2274,"2021-03-06",34,19519,9,5641,24,13877,1,1,21,5996,13,6754,22,12750,"California",64871,0.10411431918731,14941,0.519,13123,0.456
"2275","lake",2275,"2021-03-07",7,19526,5,5646,2,13879,0,1,4,5997,3,6757,4,12754,"California",64871,0.104160564813245,14941,0.519,13123,0.456
"2276","lake",2276,"2021-03-08",339,19865,267,5913,63,13942,9,10,299,6265,40,6797,308,13062,"California",64871,0.104777173159039,14941,0.519,13123,0.456
"2277","lake",2277,"2021-03-09",915,20780,29,5942,869,14811,17,27,393,6154,521,7318,410,13472,"California",64871,0.112808496863005,14941,0.519,13123,0.456
"2278","lake",2278,"2021-03-10",203,20983,60,6002,130,14941,13,40,135,6234,68,7386,148,13620,"California",64871,0.113856731050855,14941,0.519,13123,0.456
"2279","lake",2279,"2021-03-11",583,21566,47,6049,62,15003,474,514,48,6221,535,7921,522,14142,"California",64871,0.122103867675849,14941,0.519,13123,0.456
"2280","lake",2280,"2021-03-12",853,22419,203,6252,626,15629,24,538,363,6119,489,8410,387,14529,"California",64871,0.12964190470318,14941,0.519,13123,0.456
"2281","lake",2281,"2021-03-13",277,22696,21,6273,20,15649,236,774,16,6110,260,8670,251,14780,"California",64871,0.133649858950841,14941,0.519,13123,0.456
"2282","lake",2282,"2021-03-14",11,22707,2,6275,9,15658,0,774,7,6113,4,8674,7,14787,"California",64871,0.13371151978542,14941,0.519,13123,0.456
"2283","lake",2283,"2021-03-15",642,23349,14,6289,611,16269,17,791,483,6454,159,8833,500,15287,"California",64871,0.136162537959951,14941,0.519,13123,0.456
"2284","lake",2284,"2021-03-16",1113,24462,834,7123,262,16531,17,808,446,6253,663,9496,462,15749,"California",64871,0.146382821291486,14941,0.519,13123,0.456
"2285","lake",2285,"2021-03-17",246,24708,121,7244,103,16634,22,830,90,6209,156,9652,112,15861,"California",64871,0.148787593840083,14941,0.519,13123,0.456
"2286","lake",2286,"2021-03-18",748,25456,373,7617,338,16972,37,867,372,6242,375,10027,408,16269,"California",64871,0.154568297081901,14941,0.519,13123,0.456
"2287","lake",2287,"2021-03-19",580,26036,313,7930,247,17219,20,887,473,6629,106,10133,493,16762,"California",64871,0.156202309198255,14941,0.519,13123,0.456
"2288","lake",2288,"2021-03-20",248,26284,8,7938,237,17456,3,890,29,6444,217,10350,32,16794,"California",64871,0.159547409474187,14941,0.519,13123,0.456
"2289","lake",2289,"2021-03-21",16,26300,11,7949,4,17460,1,891,11,6451,5,10355,12,16806,"California",64871,0.159624485517411,14941,0.519,13123,0.456
"2290","lake",2290,"2021-03-22",324,26624,244,8193,66,17526,14,905,238,6617,86,10441,252,17058,"California",64871,0.160950193460869,14941,0.519,13123,0.456
"2291","lake",2291,"2021-03-23",418,27042,20,8213,385,17911,13,918,353,6919,64,10505,366,17424,"California",64871,0.161936766814139,14941,0.519,13123,0.456
"2292","lake",2292,"2021-03-24",413,27455,61,8274,344,18255,8,926,317,7150,95,10600,326,17750,"California",64871,0.163401211635399,14941,0.519,13123,0.456
"2293","lake",2293,"2021-03-25",659,28114,470,8744,183,18438,6,932,174,6845,485,11085,180,17930,"California",64871,0.170877587828151,14941,0.519,13123,0.456
"2294","lake",2294,"2021-03-26",69,28183,33,8777,35,18473,1,933,45,6867,24,11109,46,17976,"California",64871,0.171247552835628,14941,0.519,13123,0.456
"2295","lake",2295,"2021-03-27",309,28492,7,8784,299,18772,3,936,17,6597,290,11399,20,17996,"California",64871,0.175717963342634,14941,0.519,13123,0.456
"2296","lake",2296,"2021-03-28",17,28509,8,8792,9,18781,0,936,11,6602,6,11405,11,18007,"California",64871,0.175810454594503,14941,0.519,13123,0.456
"2297","lake",2297,"2021-03-29",900,29409,268,9060,630,19411,2,938,194,6094,704,12109,196,18203,"California",64871,0.186662761480477,14941,0.519,13123,0.456
"2298","lake",2298,"2021-03-30",454,29863,304,9364,148,19559,2,940,368,6379,85,12194,370,18573,"California",64871,0.187973054215289,14941,0.519,13123,0.456
"2299","lake",2299,"2021-03-31",583,30446,60,9424,523,20082,0,940,418,6640,157,12351,418,18991,"California",64871,0.19039324197253,14941,0.519,13123,0.456
"2300","lake",2300,"2021-04-01",423,30869,219,9643,192,20274,12,952,178,6588,242,12593,190,19181,"California",64871,0.194123722464584,14941,0.519,13123,0.456
"2301","lake",2301,"2021-04-02",220,31089,40,9683,152,20426,28,980,97,6590,123,12716,125,19306,"California",64871,0.1960197931279,14941,0.519,13123,0.456
"2302","lake",2302,"2021-04-03",32,31121,6,9689,23,20449,3,983,13,6587,19,12735,16,19322,"California",64871,0.196312682092152,14941,0.519,13123,0.456
"2303","lake",2303,"2021-04-04",20,31141,11,9700,7,20456,2,985,15,6599,5,12740,17,19339,"California",64871,0.196389758135376,14941,0.519,13123,0.456
"2304","lake",2304,"2021-04-05",638,31779,70,9770,549,21005,19,1004,399,6780,236,12976,417,19756,"California",64871,0.200027747375561,14941,0.519,13123,0.456
"2305","lake",2305,"2021-04-06",473,32252,16,9786,431,21436,26,1030,300,6934,172,13148,326,20082,"California",64871,0.202679163262475,14941,0.519,13123,0.456
"2306","lake",2306,"2021-04-07",517,32769,55,9841,411,21847,51,1081,350,7170,165,13313,401,20483,"California",64871,0.205222672688875,14941,0.519,13123,0.456
"2307","lake",2307,"2021-04-08",599,33368,486,10327,46,21893,67,1148,103,6847,493,13806,170,20653,"California",64871,0.212822370550785,14941,0.519,13123,0.456
"2308","lake",2308,"2021-04-09",279,33647,39,10366,172,22065,68,1216,46,6731,230,14036,114,20767,"California",64871,0.216367868539101,14941,0.519,13123,0.456
"2309","lake",2309,"2021-04-10",253,33900,15,10381,14,22079,224,1440,11,6724,242,14278,235,21002,"California",64871,0.220098349031154,14941,0.519,13123,0.456
"2310","lake",2310,"2021-04-11",22,33922,17,10398,3,22082,2,1442,7,6718,15,14293,9,21011,"California",64871,0.220329577160827,14941,0.519,13123,0.456
"2311","lake",2311,"2021-04-12",1068,34990,231,10629,804,22886,33,1475,248,6180,819,15112,281,21292,"California",64871,0.232954633040958,14941,0.519,13123,0.456
"2312","lake",2312,"2021-04-13",180,35170,110,10739,70,22956,0,1475,54,6108,126,15238,54,21346,"California",64871,0.234896949330209,14941,0.519,13123,0.456
"2313","lake",2313,"2021-04-14",609,35779,37,10776,572,23528,0,1475,548,6595,61,15299,548,21894,"California",64871,0.235837277057545,14941,0.519,13123,0.456
"2314","lake",2314,"2021-04-15",641,36420,193,10969,448,23976,0,1475,332,6618,309,15608,332,22226,"California",64871,0.240600576528803,14941,0.519,13123,0.456
"2315","lake",2315,"2021-04-16",259,36679,25,10994,233,24209,1,1476,69,6499,189,15797,70,22296,"California",64871,0.24351405096268,14941,0.519,13123,0.456
"2316","lake",2316,"2021-04-17",40,36719,11,11005,29,24238,0,1476,30,6519,10,15807,30,22326,"California",64871,0.243668203049128,14941,0.519,13123,0.456
"2317","lake",2317,"2021-04-18",8,36727,5,11010,3,24241,0,1476,0,6511,8,15815,0,22326,"California",64871,0.243791524718287,14941,0.519,13123,0.456
"2318","lake",2318,"2021-04-19",295,37022,39,11049,256,24497,0,1476,245,6706,50,15865,245,22571,"California",64871,0.24456228515053,14941,0.519,13123,0.456
"2319","lake",2319,"2021-04-20",692,37714,278,11327,414,24911,0,1476,113,6242,578,16443,114,22685,"California",64871,0.253472275747252,14941,0.519,13123,0.456
"2320","lake",2320,"2021-04-21",532,38246,64,11391,468,25379,0,1476,204,6118,328,16771,204,22889,"California",64871,0.258528464182763,14941,0.519,13123,0.456
"2321","lake",2321,"2021-04-22",461,38707,50,11441,411,25790,0,1476,314,6286,146,16917,314,23203,"California",64871,0.260779084644911,14941,0.519,13123,0.456
"2322","lake",2322,"2021-04-23",114,38821,58,11499,56,25846,0,1476,67,6306,47,16964,67,23270,"California",64871,0.261503599451219,14941,0.519,13123,0.456
"2323","lake",2323,"2021-04-24",53,38874,9,11508,44,25890,0,1476,39,6331,14,16978,39,23309,"California",64871,0.261719412372246,14941,0.519,13123,0.456
"2324","lake",2324,"2021-04-25",36,38910,19,11527,17,25907,0,1476,23,6341,13,16991,23,23332,"California",64871,0.26191981008463,14941,0.519,13123,0.456
"2325","lake",2325,"2021-04-26",279,39189,74,11601,204,26111,1,1477,81,6225,198,17189,82,23414,"California",64871,0.26497202139631,14941,0.519,13123,0.456
"2326","lake",2326,"2021-04-27",239,39428,21,11622,200,26311,18,1495,80,6164,159,17348,98,23512,"California",64871,0.267423039570841,14941,0.519,13123,0.456
"2327","lake",2327,"2021-04-28",506,39934,46,11668,445,26756,15,1510,117,5908,387,17735,131,23643,"California",64871,0.273388725316397,14941,0.519,13123,0.456
"2328","lake",2328,"2021-04-29",210,40144,81,11749,113,26869,16,1526,113,5940,97,17832,129,23772,"California",64871,0.274884000554947,14941,0.519,13123,0.456
"2329","lake",2329,"2021-04-30",287,40431,46,11795,210,27079,31,1557,148,5980,139,17971,179,23951,"California",64871,0.277026714556582,14941,0.519,13123,0.456
"2330","lake",2330,"2021-05-01",48,40479,26,11821,20,27099,2,1559,33,6000,15,17986,35,23986,"California",64871,0.277257942686254,14941,0.519,13123,0.456
"2331","lake",2331,"2021-05-02",18,40497,9,11830,8,27107,1,1560,9,6001,9,17995,10,23996,"California",64871,0.277396679564058,14941,0.519,13123,0.456
"2332","lake",2332,"2021-05-03",411,40908,27,11857,348,27455,36,1596,64,5755,346,18341,100,24096,"California",64871,0.282730341755176,14941,0.519,13123,0.456
"2333","lake",2333,"2021-05-04",407,41315,217,12074,142,27597,48,1644,126,5649,280,18621,174,24270,"California",64871,0.287046600175733,14941,0.519,13123,0.456
"2334","lake",2334,"2021-05-05",633,41948,49,12123,574,28171,10,1654,92,5211,539,19160,101,24371,"California",64871,0.295355397635307,14941,0.519,13123,0.456
"2335","lake",2335,"2021-05-06",143,42091,20,12143,92,28263,31,1685,71,5240,72,19232,101,24472,"California",64871,0.296465292657736,14941,0.519,13123,0.456
"2336","lake",2336,"2021-05-07",164,42255,25,12168,119,28382,20,1705,106,5311,55,19287,126,24598,"California",64871,0.297313129133203,14941,0.519,13123,0.456
"2337","lake",2337,"2021-05-08",43,42298,8,12176,34,28416,1,1706,34,5337,9,19296,35,24633,"California",64871,0.297451866011006,14941,0.519,13123,0.456
"2338","lassen",2338,"2020-12-16",8,8,8,8,0,0,0,0,8,8,0,0,8,8,"California",30065,0,2799,0.234,8970,0.748
"2339","lassen",2339,"2020-12-17",6,14,6,14,0,0,0,0,6,14,0,0,6,14,"California",30065,0,2799,0.234,8970,0.748
"2340","lassen",2340,"2020-12-18",1,15,1,15,0,0,0,0,1,15,0,0,1,15,"California",30065,0,2799,0.234,8970,0.748
"2341","lassen",2341,"2020-12-19",5,20,5,20,0,0,0,0,5,20,0,0,5,20,"California",30065,0,2799,0.234,8970,0.748
"2342","lassen",2342,"2020-12-20",2,22,2,22,0,0,0,0,2,22,0,0,2,22,"California",30065,0,2799,0.234,8970,0.748
"2343","lassen",2343,"2020-12-21",11,33,11,33,0,0,0,0,11,33,0,0,11,33,"California",30065,0,2799,0.234,8970,0.748
"2344","lassen",2344,"2020-12-22",23,56,23,56,0,0,0,0,23,56,0,0,23,56,"California",30065,0,2799,0.234,8970,0.748
"2345","lassen",2345,"2020-12-23",6,62,6,62,0,0,0,0,6,62,0,0,6,62,"California",30065,0,2799,0.234,8970,0.748
"2346","lassen",2346,"2020-12-24",11,73,11,73,0,0,0,0,11,73,0,0,11,73,"California",30065,0,2799,0.234,8970,0.748
"2347","lassen",2347,"2020-12-28",3,76,2,75,1,1,0,0,3,76,0,0,3,76,"California",30065,0,2799,0.234,8970,0.748
"2348","lassen",2348,"2020-12-29",35,111,35,110,0,1,0,0,35,111,0,0,35,111,"California",30065,0,2799,0.234,8970,0.748
"2349","lassen",2349,"2020-12-30",37,148,36,146,1,2,0,0,37,148,0,0,37,148,"California",30065,0,2799,0.234,8970,0.748
"2350","lassen",2350,"2020-12-31",49,197,42,188,7,9,0,0,49,197,0,0,49,197,"California",30065,0,2799,0.234,8970,0.748
"2351","lassen",2351,"2021-01-02",1,198,0,188,1,10,0,0,1,198,0,0,1,198,"California",30065,0,2799,0.234,8970,0.748
"2352","lassen",2352,"2021-01-04",15,213,1,189,14,24,0,0,15,213,0,0,15,213,"California",30065,0,2799,0.234,8970,0.748
"2353","lassen",2353,"2021-01-05",194,407,53,242,141,165,0,0,194,407,0,0,194,407,"California",30065,0,2799,0.234,8970,0.748
"2354","lassen",2354,"2021-01-06",95,502,44,286,51,216,0,0,87,487,8,8,88,495,"California",30065,0.000266090138034259,2799,0.234,8970,0.748
"2355","lassen",2355,"2021-01-07",43,545,7,293,36,252,0,0,37,518,6,14,37,532,"California",30065,0.000465657741559953,2799,0.234,8970,0.748
"2356","lassen",2356,"2021-01-08",50,595,2,295,48,300,0,0,50,568,0,14,50,582,"California",30065,0.000465657741559953,2799,0.234,8970,0.748
"2357","lassen",2357,"2021-01-09",12,607,6,301,6,306,0,0,12,580,0,14,12,594,"California",30065,0.000465657741559953,2799,0.234,8970,0.748
"2358","lassen",2358,"2021-01-11",27,634,5,306,22,328,0,0,27,607,0,14,27,621,"California",30065,0.000465657741559953,2799,0.234,8970,0.748
"2359","lassen",2359,"2021-01-12",49,683,29,335,20,348,0,0,30,618,19,33,30,651,"California",30065,0.00109762181939132,2799,0.234,8970,0.748
"2360","lassen",2360,"2021-01-13",161,844,18,353,143,491,0,0,146,749,15,48,146,797,"California",30065,0.00159654082820555,2799,0.234,8970,0.748
"2361","lassen",2361,"2021-01-14",163,1007,18,371,145,636,0,0,151,888,12,60,151,948,"California",30065,0.00199567603525694,2799,0.234,8970,0.748
"2362","lassen",2362,"2021-01-15",33,1040,6,377,27,663,0,0,33,921,0,60,33,981,"California",30065,0.00199567603525694,2799,0.234,8970,0.748
"2363","lassen",2363,"2021-01-16",34,1074,33,410,1,664,0,0,34,955,0,60,34,1015,"California",30065,0.00199567603525694,2799,0.234,8970,0.748
"2364","lassen",2364,"2021-01-17",1,1075,0,410,1,665,0,0,1,956,0,60,1,1016,"California",30065,0.00199567603525694,2799,0.234,8970,0.748
"2365","lassen",2365,"2021-01-18",5,1080,2,412,3,668,0,0,4,959,1,61,4,1020,"California",30065,0.00202893730251123,2799,0.234,8970,0.748
"2366","lassen",2366,"2021-01-19",185,1265,36,448,149,817,0,0,157,1088,28,89,157,1177,"California",30065,0.00296025278563113,2799,0.234,8970,0.748
"2367","lassen",2367,"2021-01-20",189,1454,101,549,88,905,0,0,105,1124,69,158,105,1282,"California",30065,0.00525528022617662,2799,0.234,8970,0.748
"2368","lassen",2368,"2021-01-21",145,1599,93,642,52,957,0,0,121,1227,18,176,121,1403,"California",30065,0.0058539830367537,2799,0.234,8970,0.748
"2369","lassen",2369,"2021-01-22",31,1630,18,660,13,970,0,0,21,1238,10,186,21,1424,"California",30065,0.00618659570929652,2799,0.234,8970,0.748
"2370","lassen",2370,"2021-01-23",2,1632,0,660,2,972,0,0,2,1240,0,186,2,1426,"California",30065,0.00618659570929652,2799,0.234,8970,0.748
"2371","lassen",2371,"2021-01-24",1,1633,0,660,1,973,0,0,1,1241,0,186,1,1427,"California",30065,0.00618659570929652,2799,0.234,8970,0.748
"2372","lassen",2372,"2021-01-25",11,1644,0,660,11,984,0,0,11,1252,0,186,11,1438,"California",30065,0.00618659570929652,2799,0.234,8970,0.748
"2373","lassen",2373,"2021-01-26",126,1770,12,672,114,1098,0,0,122,1370,4,190,122,1560,"California",30065,0.00631964077831365,2799,0.234,8970,0.748
"2374","lassen",2374,"2021-01-27",87,1857,35,707,52,1150,0,0,69,1421,18,208,69,1629,"California",30065,0.00691834358889074,2799,0.234,8970,0.748
"2375","lassen",2375,"2021-01-28",86,1943,15,722,71,1221,0,0,85,1505,1,209,85,1714,"California",30065,0.00695160485614502,2799,0.234,8970,0.748
"2376","lassen",2376,"2021-01-29",23,1966,7,729,16,1237,0,0,22,1526,1,210,22,1736,"California",30065,0.0069848661233993,2799,0.234,8970,0.748
"2377","lassen",2377,"2021-02-01",62,2028,4,733,58,1295,0,0,36,1536,26,236,36,1772,"California",30065,0.00784965907201064,2799,0.234,8970,0.748
"2378","lassen",2378,"2021-02-02",177,2205,12,745,165,1460,0,0,44,1447,133,369,44,1816,"California",30065,0.0122734076168302,2799,0.234,8970,0.748
"2379","lassen",2379,"2021-02-03",96,2301,21,766,75,1535,0,0,51,1453,45,414,51,1867,"California",30065,0.0137701646432729,2799,0.234,8970,0.748
"2380","lassen",2380,"2021-02-04",112,2413,15,781,97,1632,0,0,63,1467,49,463,63,1930,"California",30065,0.0153999667387327,2799,0.234,8970,0.748
"2381","lassen",2381,"2021-02-05",65,2478,12,793,53,1685,0,0,23,1448,42,505,23,1953,"California",30065,0.0167969399634126,2799,0.234,8970,0.748
"2382","lassen",2382,"2021-02-06",69,2547,34,827,35,1720,0,0,36,1452,32,537,36,1989,"California",30065,0.0178613005155496,2799,0.234,8970,0.748
"2383","lassen",2383,"2021-02-07",2,2549,2,829,0,1720,0,0,2,1454,0,537,2,1991,"California",30065,0.0178613005155496,2799,0.234,8970,0.748
"2384","lassen",2384,"2021-02-08",44,2593,4,833,40,1760,0,0,18,1446,26,563,18,2009,"California",30065,0.018726093464161,2799,0.234,8970,0.748
"2385","lassen",2385,"2021-02-09",129,2722,8,841,121,1881,0,0,50,1417,79,642,50,2059,"California",30065,0.0213537335772493,2799,0.234,8970,0.748
"2386","lassen",2386,"2021-02-10",184,2906,21,862,163,2044,0,0,76,1385,108,750,76,2135,"California",30065,0.0249459504407118,2799,0.234,8970,0.748
"2387","lassen",2387,"2021-02-11",184,3090,16,878,168,2212,0,0,80,1362,103,853,80,2215,"California",30065,0.0283718609679029,2799,0.234,8970,0.748
"2388","lassen",2388,"2021-02-12",42,3132,11,889,31,2243,0,0,14,1348,28,881,14,2229,"California",30065,0.0293031764510228,2799,0.234,8970,0.748
"2389","lassen",2389,"2021-02-13",12,3144,3,892,9,2252,0,0,10,1356,2,883,10,2239,"California",30065,0.0293696989855313,2799,0.234,8970,0.748
"2390","lassen",2390,"2021-02-14",13,3157,0,892,13,2265,0,0,12,1367,1,884,12,2251,"California",30065,0.0294029602527856,2799,0.234,8970,0.748
"2391","lassen",2391,"2021-02-15",21,3178,2,894,19,2284,0,0,17,1380,4,888,17,2268,"California",30065,0.0295360053218028,2799,0.234,8970,0.748
"2392","lassen",2392,"2021-02-16",192,3370,4,898,188,2472,0,0,31,1252,159,1047,31,2299,"California",30065,0.0348245468152337,2799,0.234,8970,0.748
"2393","lassen",2393,"2021-02-17",183,3553,94,992,89,2561,0,0,10,1089,173,1220,10,2309,"California",30065,0.0405787460502245,2799,0.234,8970,0.748
"2394","lassen",2394,"2021-02-18",80,3633,22,1014,58,2619,0,0,20,1049,60,1280,20,2329,"California",30065,0.0425744220854815,2799,0.234,8970,0.748
"2395","lassen",2395,"2021-02-19",82,3715,62,1076,20,2639,0,0,18,1003,64,1344,18,2347,"California",30065,0.0447031431897555,2799,0.234,8970,0.748
"2396","lassen",2396,"2021-02-20",8,3723,0,1076,8,2647,0,0,6,1007,2,1346,6,2353,"California",30065,0.0447696657242641,2799,0.234,8970,0.748
"2397","lassen",2397,"2021-02-21",22,3745,2,1078,20,2667,0,0,18,1021,4,1350,18,2371,"California",30065,0.0449027107932812,2799,0.234,8970,0.748
"2398","lassen",2398,"2021-02-22",25,3770,10,1088,15,2682,0,0,6,1008,19,1369,6,2377,"California",30065,0.0455346748711126,2799,0.234,8970,0.748
"2399","lassen",2399,"2021-02-23",153,3923,10,1098,143,2825,0,0,41,937,112,1481,41,2418,"California",30065,0.0492599368035922,2799,0.234,8970,0.748
"2400","lassen",2400,"2021-02-24",165,4088,16,1114,149,2974,0,0,107,987,57,1538,107,2525,"California",30065,0.0511558290370863,2799,0.234,8970,0.748
"2401","lassen",2401,"2021-02-25",156,4244,19,1133,137,3111,0,0,99,1029,57,1595,99,2624,"California",30065,0.0530517212705804,2799,0.234,8970,0.748
"2402","lassen",2402,"2021-02-26",73,4317,16,1149,57,3168,0,0,36,1028,37,1632,36,2660,"California",30065,0.0542823881589889,2799,0.234,8970,0.748
"2403","lassen",2403,"2021-02-27",8,4325,7,1156,1,3169,0,0,3,1026,5,1637,3,2663,"California",30065,0.0544486944952603,2799,0.234,8970,0.748
"2404","lassen",2404,"2021-02-28",6,4331,1,1157,5,3174,0,0,3,1026,3,1640,3,2666,"California",30065,0.0545484782970231,2799,0.234,8970,0.748
"2405","lassen",2405,"2021-03-01",42,4373,4,1161,38,3212,0,0,8,1001,33,1673,8,2674,"California",30065,0.0556461001164144,2799,0.234,8970,0.748
"2406","lassen",2406,"2021-03-02",106,4479,8,1169,98,3310,0,0,80,1055,26,1699,80,2754,"California",30065,0.0565108930650258,2799,0.234,8970,0.748
"2407","lassen",2407,"2021-03-03",170,4649,12,1181,158,3468,0,0,113,1111,57,1756,113,2867,"California",30065,0.0584067852985199,2799,0.234,8970,0.748
"2408","lassen",2408,"2021-03-04",150,4799,17,1198,133,3601,0,0,100,1162,49,1805,100,2967,"California",30065,0.0600365873939797,2799,0.234,8970,0.748
"2409","lassen",2409,"2021-03-05",47,4846,7,1205,17,3618,23,23,11,1160,36,1841,34,3001,"California",30065,0.0612339930151339,2799,0.234,8970,0.748
"2410","lassen",2410,"2021-03-06",55,4901,4,1209,29,3647,22,45,5,1137,50,1891,27,3028,"California",30065,0.062897056377848,2799,0.234,8970,0.748
"2411","lassen",2411,"2021-03-07",56,4957,1,1210,0,3647,55,100,1,1138,55,1946,56,3084,"California",30065,0.0647264260768335,2799,0.234,8970,0.748
"2412","lassen",2412,"2021-03-08",90,5047,2,1212,8,3655,80,180,3,1135,86,2032,83,3167,"California",30065,0.0675868950607018,2799,0.234,8970,0.748
"2413","lassen",2413,"2021-03-09",137,5184,11,1223,109,3764,17,197,88,1192,49,2081,106,3273,"California",30065,0.0692166971561616,2799,0.234,8970,0.748
"2414","lassen",2414,"2021-03-10",175,5359,10,1233,163,3927,2,199,79,1178,95,2176,81,3354,"California",30065,0.0723765175453185,2799,0.234,8970,0.748
"2415","lassen",2415,"2021-03-11",185,5544,16,1249,162,4089,7,206,113,1229,69,2245,120,3474,"California",30065,0.074671544985864,2799,0.234,8970,0.748
"2416","lassen",2416,"2021-03-12",35,5579,18,1267,13,4102,4,210,12,1222,23,2268,16,3490,"California",30065,0.0754365541327125,2799,0.234,8970,0.748
"2417","lassen",2417,"2021-03-13",49,5628,0,1267,3,4105,46,256,1,1220,48,2316,46,3536,"California",30065,0.077033094960918,2799,0.234,8970,0.748
"2418","lassen",2418,"2021-03-14",14,5642,2,1269,11,4116,1,257,2,1211,12,2328,3,3539,"California",30065,0.0774322301679694,2799,0.234,8970,0.748
"2419","lassen",2419,"2021-03-15",33,5675,2,1271,31,4147,0,257,16,1210,17,2345,16,3555,"California",30065,0.0779976717112922,2799,0.234,8970,0.748
"2420","lassen",2420,"2021-03-16",93,5768,2,1273,85,4232,6,263,74,1271,19,2364,80,3635,"California",30065,0.0786296357891236,2799,0.234,8970,0.748
"2421","lassen",2421,"2021-03-17",1083,6851,9,1282,1069,5301,5,268,1064,2321,19,2383,1069,4704,"California",30065,0.0792615998669549,2799,0.234,8970,0.748
"2422","lassen",2422,"2021-03-18",95,6946,9,1291,85,5386,1,269,81,2389,14,2397,82,4786,"California",30065,0.0797272576085149,2799,0.234,8970,0.748
"2423","lassen",2423,"2021-03-19",17,6963,11,1302,2,5388,4,273,7,2390,10,2407,11,4797,"California",30065,0.0800598702810577,2799,0.234,8970,0.748
"2424","lassen",2424,"2021-03-20",29,6992,3,1305,23,5411,3,276,22,2408,7,2414,25,4822,"California",30065,0.0802926991518377,2799,0.234,8970,0.748
"2425","lassen",2425,"2021-03-21",34,7026,0,1305,34,5445,0,276,14,2403,19,2433,14,4836,"California",30065,0.0809246632296691,2799,0.234,8970,0.748
"2426","lassen",2426,"2021-03-22",57,7083,1,1306,56,5501,0,276,54,2454,3,2436,54,4890,"California",30065,0.0810244470314319,2799,0.234,8970,0.748
"2427","lassen",2427,"2021-03-23",119,7202,11,1317,107,5608,1,277,67,2470,52,2488,68,4958,"California",30065,0.0827540329286546,2799,0.234,8970,0.748
"2428","lassen",2428,"2021-03-24",213,7415,13,1330,199,5807,1,278,107,2473,105,2593,108,5066,"California",30065,0.0862464659903542,2799,0.234,8970,0.748
"2429","lassen",2429,"2021-03-25",153,7568,22,1352,131,5938,0,278,70,2460,83,2676,70,5136,"California",30065,0.0890071511724597,2799,0.234,8970,0.748
"2430","lassen",2430,"2021-03-26",78,7646,13,1365,26,5964,39,317,19,2459,58,2734,57,5193,"California",30065,0.0909363046732081,2799,0.234,8970,0.748
"2431","lassen",2431,"2021-03-27",20,7666,4,1369,1,5965,15,332,3,2460,17,2751,18,5211,"California",30065,0.0915017462165308,2799,0.234,8970,0.748
"2432","lassen",2432,"2021-03-28",18,7684,3,1372,5,5970,10,342,4,2460,14,2765,14,5225,"California",30065,0.0919674039580908,2799,0.234,8970,0.748
"2433","lassen",2433,"2021-03-29",52,7736,0,1372,27,5997,25,367,20,2474,31,2796,45,5270,"California",30065,0.0929985032429736,2799,0.234,8970,0.748
"2434","lassen",2434,"2021-03-30",198,7934,10,1382,163,6160,25,392,51,2403,147,2943,76,5346,"California",30065,0.0978879095293531,2799,0.234,8970,0.748
"2435","lassen",2435,"2021-03-31",146,8080,12,1394,112,6272,22,414,62,2403,84,3027,84,5430,"California",30065,0.100681855978713,2799,0.234,8970,0.748
"2436","lassen",2436,"2021-04-01",165,8245,15,1409,131,6403,19,433,48,2354,116,3143,67,5497,"California",30065,0.10454016298021,2799,0.234,8970,0.748
"2437","lassen",2437,"2021-04-02",29,8274,4,1413,3,6406,22,455,2,2351,27,3170,24,5521,"California",30065,0.105438217196075,2799,0.234,8970,0.748
"2438","lassen",2438,"2021-04-03",12,8286,0,1413,2,6408,10,465,0,2349,12,3182,10,5531,"California",30065,0.105837352403127,2799,0.234,8970,0.748
"2439","lassen",2439,"2021-04-04",7,8293,2,1415,0,6408,5,470,1,2349,6,3188,6,5537,"California",30065,0.106036920006652,2799,0.234,8970,0.748
"2440","lassen",2440,"2021-04-05",23,8316,4,1419,12,6420,7,477,11,2356,11,3199,18,5555,"California",30065,0.106402793946449,2799,0.234,8970,0.748
"2441","lassen",2441,"2021-04-06",184,8500,9,1428,145,6565,30,507,53,2308,131,3330,83,5638,"California",30065,0.11076001995676,2799,0.234,8970,0.748
"2442","lassen",2442,"2021-04-07",135,8635,6,1434,92,6657,37,544,32,2276,103,3433,71,5709,"California",30065,0.114185930483951,2799,0.234,8970,0.748
"2443","lassen",2443,"2021-04-08",170,8805,9,1443,105,6762,56,600,34,2234,132,3565,90,5799,"California",30065,0.118576417761517,2799,0.234,8970,0.748
"2444","lassen",2444,"2021-04-09",52,8857,6,1449,11,6773,35,635,9,2235,42,3607,43,5842,"California",30065,0.119973390986197,2799,0.234,8970,0.748
"2445","lassen",2445,"2021-04-10",9,8866,0,1449,2,6775,7,642,0,2234,8,3615,7,5849,"California",30065,0.120239481124231,2799,0.234,8970,0.748
"2446","lassen",2446,"2021-04-11",5,8871,2,1451,0,6775,3,645,2,2236,3,3618,5,5854,"California",30065,0.120339264925994,2799,0.234,8970,0.748
"2447","lassen",2447,"2021-04-12",31,8902,3,1454,15,6790,13,658,3,2224,28,3646,16,5870,"California",30065,0.121270580409114,2799,0.234,8970,0.748
"2448","lassen",2448,"2021-04-13",129,9031,6,1460,123,6913,0,658,40,2176,88,3734,40,5910,"California",30065,0.12419757192749,2799,0.234,8970,0.748
"2449","lassen",2449,"2021-04-14",987,10018,16,1476,971,7884,0,658,51,1292,935,4669,51,5961,"California",30065,0.155296856810244,2799,0.234,8970,0.748
"2450","lassen",2450,"2021-04-15",147,10165,14,1490,133,8017,0,658,19,1183,128,4797,19,5980,"California",30065,0.159554299018793,2799,0.234,8970,0.748
"2451","lassen",2451,"2021-04-16",11,10176,4,1494,7,8024,0,658,5,1182,6,4803,5,5985,"California",30065,0.159753866622318,2799,0.234,8970,0.748
"2452","lassen",2452,"2021-04-17",24,10200,3,1497,21,8045,0,658,4,1166,20,4823,4,5989,"California",30065,0.160419091967404,2799,0.234,8970,0.748
"2453","lassen",2453,"2021-04-18",5,10205,2,1499,3,8048,0,658,2,1165,3,4826,2,5991,"California",30065,0.160518875769167,2799,0.234,8970,0.748
"2454","lassen",2454,"2021-04-19",33,10238,0,1499,33,8081,0,658,17,1166,16,4842,17,6008,"California",30065,0.161051056045235,2799,0.234,8970,0.748
"2455","lassen",2455,"2021-04-20",138,10376,7,1506,131,8212,0,658,52,1132,86,4928,52,6060,"California",30065,0.163911525029104,2799,0.234,8970,0.748
"2456","lassen",2456,"2021-04-21",163,10539,10,1516,153,8365,0,658,32,1035,129,5057,32,6092,"California",30065,0.168202228504906,2799,0.234,8970,0.748
"2457","lassen",2457,"2021-04-22",102,10641,16,1532,86,8451,0,658,33,999,69,5126,33,6125,"California",30065,0.170497255945452,2799,0.234,8970,0.748
"2458","lassen",2458,"2021-04-23",28,10669,3,1535,25,8476,0,658,22,1015,6,5132,22,6147,"California",30065,0.170696823548977,2799,0.234,8970,0.748
"2459","lassen",2459,"2021-04-24",10,10679,6,1541,4,8480,0,658,4,1013,6,5138,4,6151,"California",30065,0.170896391152503,2799,0.234,8970,0.748
"2460","lassen",2460,"2021-04-25",5,10684,0,1541,4,8484,1,659,3,1015,2,5140,4,6155,"California",30065,0.170962913687011,2799,0.234,8970,0.748
"2461","lassen",2461,"2021-04-26",40,10724,1,1542,35,8519,4,663,7,993,33,5173,11,6166,"California",30065,0.172060535506403,2799,0.234,8970,0.748
"2462","lassen",2462,"2021-04-27",121,10845,10,1552,108,8627,3,666,69,1013,52,5225,72,6238,"California",30065,0.173790121403625,2799,0.234,8970,0.748
"2463","lassen",2463,"2021-04-28",84,10929,8,1560,74,8701,2,668,31,993,53,5278,33,6271,"California",30065,0.175552968568102,2799,0.234,8970,0.748
"2464","lassen",2464,"2021-04-29",67,10996,7,1567,57,8758,3,671,22,974,44,5322,25,6296,"California",30065,0.177016464327291,2799,0.234,8970,0.748
"2465","lassen",2465,"2021-04-30",11,11007,7,1574,1,8759,3,674,3,972,8,5330,6,6302,"California",30065,0.177282554465325,2799,0.234,8970,0.748
"2466","lassen",2466,"2021-05-01",3,11010,0,1574,2,8761,1,675,2,974,1,5331,3,6305,"California",30065,0.177315815732579,2799,0.234,8970,0.748
"2467","lassen",2467,"2021-05-02",12,11022,8,1582,4,8765,0,675,8,978,4,5335,8,6313,"California",30065,0.177448860801597,2799,0.234,8970,0.748
"2468","lassen",2468,"2021-05-03",18,11040,1,1583,11,8776,6,681,4,974,14,5349,10,6323,"California",30065,0.177914518543156,2799,0.234,8970,0.748
"2469","lassen",2469,"2021-05-04",75,11115,4,1587,63,8839,8,689,23,953,52,5401,31,6354,"California",30065,0.179644104440379,2799,0.234,8970,0.748
"2470","lassen",2470,"2021-05-05",79,11194,4,1591,65,8904,10,699,24,933,54,5455,34,6388,"California",30065,0.18144021287211,2799,0.234,8970,0.748
"2471","lassen",2471,"2021-05-06",85,11279,20,1611,43,8947,22,721,23,916,62,5517,45,6433,"California",30065,0.183502411441876,2799,0.234,8970,0.748
"2472","lassen",2472,"2021-05-07",45,11324,31,1642,10,8957,4,725,38,951,7,5524,42,6475,"California",30065,0.183735240312656,2799,0.234,8970,0.748
"2473","lassen",2473,"2021-05-08",9,11333,1,1643,4,8961,4,729,3,952,6,5530,7,6482,"California",30065,0.183934807916182,2799,0.234,8970,0.748
"2474","los angeles",2474,"2020-12-15",392,392,392,392,0,0,0,0,392,392,0,0,392,392,"California",10257557,0,3028885,0.71,1145530,0.269
"2475","los angeles",2475,"2020-12-16",3364,3756,3364,3756,0,0,0,0,3364,3756,0,0,3364,3756,"California",10257557,0,3028885,0.71,1145530,0.269
"2476","los angeles",2476,"2020-12-17",10235,13991,10235,13991,0,0,0,0,10236,13992,0,0,10236,13992,"California",10257557,0,3028885,0.71,1145530,0.269
"2477","los angeles",2477,"2020-12-18",14521,28512,14497,28488,24,24,0,0,14521,28513,0,0,14521,28513,"California",10257557,0,3028885,0.71,1145530,0.269
"2478","los angeles",2478,"2020-12-19",7226,35738,7218,35706,8,32,0,0,7227,35740,0,0,7227,35740,"California",10257557,0,3028885,0.71,1145530,0.269
"2479","los angeles",2479,"2020-12-20",4597,40335,4589,40295,8,40,0,0,4599,40339,0,0,4599,40339,"California",10257557,0,3028885,0.71,1145530,0.269
"2480","los angeles",2480,"2020-12-21",13694,54029,13679,53974,15,55,0,0,13694,54032,1,1,13694,54033,"California",10257557,9.74890999874532e-08,3028885,0.71,1145530,0.269
"2481","los angeles",2481,"2020-12-22",11524,65553,11144,65118,380,435,0,0,11525,65556,1,2,11525,65558,"California",10257557,1.94978199974906e-07,3028885,0.71,1145530,0.269
"2482","los angeles",2482,"2020-12-23",11889,77442,10133,75251,1756,2191,0,0,11890,77446,0,2,11890,77448,"California",10257557,1.94978199974906e-07,3028885,0.71,1145530,0.269
"2483","los angeles",2483,"2020-12-24",7020,84462,4253,79504,2767,4958,0,0,7023,84469,0,2,7023,84471,"California",10257557,1.94978199974906e-07,3028885,0.71,1145530,0.269
"2484","los angeles",2484,"2020-12-25",525,84987,419,79923,106,5064,0,0,525,84994,0,2,525,84996,"California",10257557,1.94978199974906e-07,3028885,0.71,1145530,0.269
"2485","los angeles",2485,"2020-12-26",2523,87510,2179,82102,344,5408,0,0,2523,87516,1,3,2523,87519,"California",10257557,2.92467299962359e-07,3028885,0.71,1145530,0.269
"2486","los angeles",2486,"2020-12-27",1757,89267,1027,83129,730,6138,0,0,1757,89273,0,3,1757,89276,"California",10257557,2.92467299962359e-07,3028885,0.71,1145530,0.269
"2487","los angeles",2487,"2020-12-28",10288,99555,6383,89512,3905,10043,0,0,10286,99558,1,4,10286,99562,"California",10257557,3.89956399949813e-07,3028885,0.71,1145530,0.269
"2488","los angeles",2488,"2020-12-29",11598,111153,6077,95589,5521,15564,0,0,11600,111158,0,4,11600,111162,"California",10257557,3.89956399949813e-07,3028885,0.71,1145530,0.269
"2489","los angeles",2489,"2020-12-30",14865,126018,8089,103678,6776,22340,0,0,14864,126022,0,4,14864,126026,"California",10257557,3.89956399949813e-07,3028885,0.71,1145530,0.269
"2490","los angeles",2490,"2020-12-31",7934,133952,2755,106433,5179,27519,0,0,7931,133951,2,6,7931,133957,"California",10257557,5.84934599924719e-07,3028885,0.71,1145530,0.269
"2491","los angeles",2491,"2021-01-01",1005,134957,272,106705,733,28252,0,0,1005,134956,0,6,1005,134962,"California",10257557,5.84934599924719e-07,3028885,0.71,1145530,0.269
"2492","los angeles",2492,"2021-01-02",4463,139420,1658,108363,2805,31057,0,0,4463,139419,0,6,4463,139425,"California",10257557,5.84934599924719e-07,3028885,0.71,1145530,0.269
"2493","los angeles",2493,"2021-01-03",948,140368,213,108576,735,31792,0,0,947,140365,1,7,947,140372,"California",10257557,6.82423699912172e-07,3028885,0.71,1145530,0.269
"2494","los angeles",2494,"2021-01-04",12712,153080,4885,113461,7827,39619,0,0,12698,153060,3,10,12698,153070,"California",10257557,9.74890999874531e-07,3028885,0.71,1145530,0.269
"2495","los angeles",2495,"2021-01-05",16049,169129,7087,120548,8962,48581,0,0,14148,165337,1874,1884,14151,167221,"California",10257557,0.000183669464376362,3028885,0.71,1145530,0.269
"2496","los angeles",2496,"2021-01-06",22680,191809,12080,132628,10600,59181,0,0,17086,176904,5526,7410,17093,184314,"California",10257557,0.000722394230907028,3028885,0.71,1145530,0.269
"2497","los angeles",2497,"2021-01-07",29370,221179,15814,148442,13556,72737,0,0,18860,185312,10466,17876,18874,203188,"California",10257557,0.00174271515137571,3028885,0.71,1145530,0.269
"2498","los angeles",2498,"2021-01-08",33117,254296,17900,166342,15217,87954,0,0,20893,194015,12198,30074,20901,224089,"California",10257557,0.00293188719302267,3028885,0.71,1145530,0.269
"2499","los angeles",2499,"2021-01-09",12372,266668,7081,173423,5291,93245,0,0,7504,196659,4866,34940,7510,231599,"California",10257557,0.00340626915356161,3028885,0.71,1145530,0.269
"2500","los angeles",2500,"2021-01-10",4683,271351,3634,177057,1049,94294,0,0,1948,195873,2735,37675,1949,233548,"California",10257557,0.0036729018420273,3028885,0.71,1145530,0.269
"2501","los angeles",2501,"2021-01-11",25804,297155,16253,193310,9551,103845,0,0,14868,199824,10925,48600,14876,248424,"California",10257557,0.00473797025939022,3028885,0.71,1145530,0.269
"2502","los angeles",2502,"2021-01-12",29233,326388,16082,209392,13151,116996,0,0,19099,208819,10116,58716,19111,267535,"California",10257557,0.0057241699948633,3028885,0.71,1145530,0.269
"2503","los angeles",2503,"2021-01-13",29277,355665,15639,225031,13638,130634,0,0,20331,220226,8928,67644,20335,287870,"California",10257557,0.00659455267955128,3028885,0.71,1145530,0.269
"2504","los angeles",2504,"2021-01-14",29256,384921,12723,237754,16533,147167,0,0,23749,238497,5488,73132,23759,311629,"California",10257557,0.00712957286028242,3028885,0.71,1145530,0.269
"2505","los angeles",2505,"2021-01-15",33820,418741,12372,250126,21448,168615,0,0,30245,265200,3550,76682,30253,341882,"California",10257557,0.00747565916523788,3028885,0.71,1145530,0.269
"2506","los angeles",2506,"2021-01-16",17559,436300,4965,255091,12594,181209,0,0,15782,279217,1769,78451,15786,357668,"California",10257557,0.00764811738311569,3028885,0.71,1145530,0.269
"2507","los angeles",2507,"2021-01-17",5194,441494,2312,257403,2882,184091,0,0,4948,283922,245,78696,4950,362618,"California",10257557,0.00767200221261261,3028885,0.71,1145530,0.269
"2508","los angeles",2508,"2021-01-18",15587,457081,10065,267468,5522,189613,0,0,10881,290111,4694,83390,10883,373501,"California",10257557,0.00812961604795372,3028885,0.71,1145530,0.269
"2509","los angeles",2509,"2021-01-19",38466,495547,20578,288046,17888,207501,0,0,30668,313032,7757,91147,30678,404179,"California",10257557,0.00888583899655639,3028885,0.71,1145530,0.269
"2510","los angeles",2510,"2021-01-20",45779,541326,23922,311968,21857,229358,0,0,38291,343875,7458,98605,38301,442480,"California",10257557,0.00961291270426282,3028885,0.71,1145530,0.269
"2511","los angeles",2511,"2021-01-21",48743,590069,22460,334428,26283,255641,0,0,44470,384149,4210,102815,44484,486964,"California",10257557,0.01002334181521,3028885,0.71,1145530,0.269
"2512","los angeles",2512,"2021-01-22",47931,638000,22240,356668,25691,281332,0,0,44502,425277,3384,106199,44512,531476,"California",10257557,0.0103532449295675,3028885,0.71,1145530,0.269
"2513","los angeles",2513,"2021-01-23",33977,671977,15716,372384,18261,299593,0,0,31923,455191,2021,108220,31935,563411,"California",10257557,0.0105502704006422,3028885,0.71,1145530,0.269
"2514","los angeles",2514,"2021-01-24",15738,687715,12214,384598,3524,303117,0,0,15190,469842,540,108760,15191,578602,"California",10257557,0.0106029145146354,3028885,0.71,1145530,0.269
"2515","los angeles",2515,"2021-01-25",38786,726501,16464,401062,22322,325439,0,0,30285,491671,8472,117232,30301,608903,"California",10257557,0.0114288421697291,3028885,0.71,1145530,0.269
"2516","los angeles",2516,"2021-01-26",49283,775784,24480,425542,24803,350242,0,0,41092,524626,8156,125388,41111,650014,"California",10257557,0.0122239632692268,3028885,0.71,1145530,0.269
"2517","los angeles",2517,"2021-01-27",48560,824344,25843,451385,22717,372959,0,0,39316,554852,9109,134497,39335,689349,"California",10257557,0.0131119914810125,3028885,0.71,1145530,0.269
"2518","los angeles",2518,"2021-01-28",48628,872972,23125,474510,25503,398462,0,0,40205,586770,8301,142798,40219,729568,"California",10257557,0.0139212485000083,3028885,0.71,1145530,0.269
"2519","los angeles",2519,"2021-01-29",49285,922257,25421,499931,23864,422326,0,0,39225,616304,9706,152504,39240,768808,"California",10257557,0.0148674777044866,3028885,0.71,1145530,0.269
"2520","los angeles",2520,"2021-01-30",30004,952261,15410,515341,14594,436920,0,0,25850,638081,4077,156581,25854,794662,"California",10257557,0.0152649407651354,3028885,0.71,1145530,0.269
"2521","los angeles",2521,"2021-01-31",13026,965287,10385,525726,2641,439561,0,0,12096,649264,917,157498,12100,806762,"California",10257557,0.0153543382698239,3028885,0.71,1145530,0.269
"2522","los angeles",2522,"2021-02-01",38084,1003371,16237,541963,21847,461408,0,0,27800,666823,10251,167749,27810,834572,"California",10257557,0.0163536990337953,3028885,0.71,1145530,0.269
"2523","los angeles",2523,"2021-02-02",44240,1047611,17903,559866,26337,487745,0,0,32054,686735,12145,179894,32057,866629,"California",10257557,0.0175377041531429,3028885,0.71,1145530,0.269
"2524","los angeles",2524,"2021-02-03",52146,1099757,19576,579442,32570,520315,0,0,37259,709351,14649,194543,37265,903894,"California",10257557,0.0189658219788591,3028885,0.71,1145530,0.269
"2525","los angeles",2525,"2021-02-04",57186,1156943,20708,600150,36478,556793,0,0,39076,730639,17802,212345,39090,942984,"California",10257557,0.0207013229368357,3028885,0.71,1145530,0.269
"2526","los angeles",2526,"2021-02-05",61213,1218156,21061,621211,40152,596945,0,0,39291,748434,21503,233848,39298,982282,"California",10257557,0.0227976310538659,3028885,0.71,1145530,0.269
"2527","los angeles",2527,"2021-02-06",35509,1253665,13308,634519,22201,619146,0,0,27071,767162,8365,242213,27093,1009375,"California",10257557,0.023613127375261,3028885,0.71,1145530,0.269
"2528","los angeles",2528,"2021-02-07",10821,1264486,8398,642917,2423,621569,0,0,8419,773200,2387,244600,8425,1017800,"California",10257557,0.023845833856931,3028885,0.71,1145530,0.269
"2529","los angeles",2529,"2021-02-08",46739,1311225,21509,664426,25230,646799,0,0,30575,787749,16028,260628,30577,1048377,"California",10257557,0.0254083891515299,3028885,0.71,1145530,0.269
"2530","los angeles",2530,"2021-02-09",55770,1366995,24600,689026,31170,677969,0,0,28375,788811,27320,287948,28382,1076759,"California",10257557,0.0280717913631872,3028885,0.71,1145530,0.269
"2531","los angeles",2531,"2021-02-10",66922,1433917,29416,718442,37506,715475,0,0,30842,783957,35705,323653,30851,1107610,"California",10257557,0.0315526396782392,3028885,0.71,1145530,0.269
"2532","los angeles",2532,"2021-02-11",58008,1491925,30875,749317,27133,742608,0,0,28012,782419,29554,353207,28016,1135626,"California",10257557,0.0344338325392684,3028885,0.71,1145530,0.269
"2533","los angeles",2533,"2021-02-12",59529,1551454,29790,779107,29739,772347,0,0,25964,775173,33226,386433,25980,1161606,"California",10257557,0.0376730053754515,3028885,0.71,1145530,0.269
"2534","los angeles",2534,"2021-02-13",33788,1585242,19609,798716,14179,786526,0,0,15455,772418,18248,404681,15493,1177099,"California",10257557,0.0394519864720225,3028885,0.71,1145530,0.269
"2535","los angeles",2535,"2021-02-14",21885,1607127,14972,813688,6913,793439,0,0,8782,768160,13043,417724,8785,1185884,"California",10257557,0.0407235368031589,3028885,0.71,1145530,0.269
"2536","los angeles",2536,"2021-02-15",32446,1639573,15860,829548,16586,810025,0,0,17796,771375,14587,432311,17802,1203686,"California",10257557,0.0421456103046759,3028885,0.71,1145530,0.269
"2537","los angeles",2537,"2021-02-16",63988,1703561,32510,862058,31478,841503,0,0,29844,767174,34057,466368,29856,1233542,"California",10257557,0.0454657965829486,3028885,0.71,1145530,0.269
"2538","los angeles",2538,"2021-02-17",64477,1768038,34296,896354,30181,871684,0,0,26391,755659,37913,504281,26398,1259940,"California",10257557,0.0491619008307729,3028885,0.71,1145530,0.269
"2539","los angeles",2539,"2021-02-18",68281,1836319,34699,931053,33582,905266,0,0,28574,744713,39530,543811,28584,1288524,"California",10257557,0.0530156449532769,3028885,0.71,1145530,0.269
"2540","los angeles",2540,"2021-02-19",58068,1894387,35878,966931,22190,927456,0,0,28453,743665,29516,573327,28468,1316992,"California",10257557,0.0558931332285066,3028885,0.71,1145530,0.269
"2541","los angeles",2541,"2021-02-20",32759,1927146,23823,990754,8936,936392,0,0,15739,742436,16976,590303,15747,1332739,"California",10257557,0.0575481081898936,3028885,0.71,1145530,0.269
"2542","los angeles",2542,"2021-02-21",16767,1943913,15111,1005865,1656,938048,0,0,8525,742760,8204,598507,8528,1341267,"California",10257557,0.0583479087661906,3028885,0.71,1145530,0.269
"2543","los angeles",2543,"2021-02-22",34338,1978251,24988,1030853,9350,947398,0,0,17743,743992,16522,615029,17754,1359021,"California",10257557,0.0599586236761833,3028885,0.71,1145530,0.269
"2544","los angeles",2544,"2021-02-23",53698,2031949,22797,1053650,30901,978299,0,0,21159,732731,32432,647461,21171,1380192,"California",10257557,0.0631203901669764,3028885,0.71,1145530,0.269
"2545","los angeles",2545,"2021-02-24",64303,2096252,28420,1082070,35883,1014182,0,0,28324,725263,35810,683271,28342,1408534,"California",10257557,0.0666114748375271,3028885,0.71,1145530,0.269
"2546","los angeles",2546,"2021-02-25",73575,2169827,33771,1115841,39804,1053986,0,0,38591,729041,34825,718096,38603,1447137,"California",10257557,0.0700065327445902,3028885,0.71,1145530,0.269
"2547","los angeles",2547,"2021-02-26",82842,2252669,38610,1154451,44232,1098218,0,0,47363,741185,35247,753343,47391,1494528,"California",10257557,0.0734427310518479,3028885,0.71,1145530,0.269
"2548","los angeles",2548,"2021-02-27",58712,2311381,25031,1179482,33677,1131895,4,4,30005,742654,28563,781906,30032,1524560,"California",10257557,0.0762273122147895,3028885,0.71,1145530,0.269
"2549","los angeles",2549,"2021-02-28",26832,2338213,18515,1197997,8316,1140211,1,5,18863,753657,7868,789774,18871,1543431,"California",10257557,0.0769943564534908,3028885,0.71,1145530,0.269
"2550","los angeles",2550,"2021-03-01",55669,2393882,31198,1229195,24452,1164663,19,24,33757,765697,21751,811525,33791,1577222,"California",10257557,0.0791148418673179,3028885,0.71,1145530,0.269
"2551","los angeles",2551,"2021-03-02",71058,2464940,31535,1260730,39521,1204184,2,26,43438,781651,27497,839022,43451,1620673,"California",10257557,0.0817954996496729,3028885,0.71,1145530,0.269
"2552","los angeles",2552,"2021-03-03",82798,2547738,41637,1302367,41151,1245335,10,36,52051,803142,30592,869614,52083,1672756,"California",10257557,0.0847778861964891,3028885,0.71,1145530,0.269
"2553","los angeles",2553,"2021-03-04",89683,2637421,45777,1348144,43895,1289230,11,47,56589,826845,32915,902529,56618,1729374,"California",10257557,0.0879867399225761,3028885,0.71,1145530,0.269
"2554","los angeles",2554,"2021-03-05",87712,2725133,42678,1390822,45005,1334235,29,76,58445,856263,29089,931618,58507,1787881,"California",10257557,0.0908226003521111,3028885,0.71,1145530,0.269
"2555","los angeles",2555,"2021-03-06",66212,2791345,33280,1424102,31115,1365350,1817,1893,42646,877307,23424,955042,44468,1832349,"California",10257557,0.0931061850302172,3028885,0.71,1145530,0.269
"2556","los angeles",2556,"2021-03-07",25708,2817053,19320,1443422,5587,1370937,801,2694,19821,892066,5860,960902,20619,1852968,"California",10257557,0.0936774711561437,3028885,0.71,1145530,0.269
"2557","los angeles",2557,"2021-03-08",51401,2868454,26692,1470114,22763,1393700,1946,4640,38639,919984,12664,973566,40582,1893550,"California",10257557,0.0949120731183848,3028885,0.71,1145530,0.269
"2558","los angeles",2558,"2021-03-09",69021,2937475,26484,1496598,39261,1432961,3276,7916,41255,936890,27617,1001183,44523,1938073,"California",10257557,0.0976044295927383,3028885,0.71,1145530,0.269
"2559","los angeles",2559,"2021-03-10",79223,3016698,37360,1533958,36993,1469954,4870,12786,49636,961929,29429,1030612,54468,1992541,"California",10257557,0.100473436316269,3028885,0.71,1145530,0.269
"2560","los angeles",2560,"2021-03-11",92284,3108982,44989,1578947,40621,1510575,6674,19460,54039,984537,38066,1068678,60674,2053215,"California",10257557,0.104184456396391,3028885,0.71,1145530,0.269
"2561","los angeles",2561,"2021-03-12",97175,3206157,43234,1622181,40113,1550688,13828,33288,56517,1014358,40476,1109154,70297,2123512,"California",10257557,0.108130425207484,3028885,0.71,1145530,0.269
"2562","los angeles",2562,"2021-03-13",74043,3280200,34473,1656654,27673,1578361,11897,45185,44005,1040287,29931,1139085,55860,2179372,"California",10257557,0.111048371459208,3028885,0.71,1145530,0.269
"2563","los angeles",2563,"2021-03-14",38096,3318296,25419,1682073,10216,1588577,2461,47646,25500,1055693,12533,1151618,27939,2207311,"California",10257557,0.112270202349351,3028885,0.71,1145530,0.269
"2564","los angeles",2564,"2021-03-15",73517,3391813,35553,1717626,32632,1621209,5332,52978,44866,1077406,28465,1180083,50178,2257489,"California",10257557,0.115045229580494,3028885,0.71,1145530,0.269
"2565","los angeles",2565,"2021-03-16",98485,3490298,42642,1760268,50075,1671284,5768,58746,64373,1113579,33930,1214013,70103,2327592,"California",10257557,0.118353034743068,3028885,0.71,1145530,0.269
"2566","los angeles",2566,"2021-03-17",95449,3585747,42975,1803243,44269,1715553,8205,66951,64171,1154762,31084,1245097,72267,2399859,"California",10257557,0.121383385927078,3028885,0.71,1145530,0.269
"2567","los angeles",2567,"2021-03-18",100053,3685800,47392,1850635,47458,1763011,5203,72154,63824,1187816,35962,1281059,69016,2468875,"California",10257557,0.124889288940827,3028885,0.71,1145530,0.269
"2568","los angeles",2568,"2021-03-19",106547,3792347,55150,1905785,46724,1809735,4673,76827,66245,1218645,40041,1321100,70870,2539745,"California",10257557,0.128792849993424,3028885,0.71,1145530,0.269
"2569","los angeles",2569,"2021-03-20",75099,3867446,36604,1942389,33984,1843719,4511,81338,52045,1252299,22886,1343986,56540,2596285,"California",10257557,0.131023985535737,3028885,0.71,1145530,0.269
"2570","los angeles",2570,"2021-03-21",33578,3901024,24782,1967171,7952,1851671,844,82182,21802,1263276,11668,1355654,22645,2618930,"California",10257557,0.132161488354391,3028885,0.71,1145530,0.269
"2571","los angeles",2571,"2021-03-22",69432,3970456,40559,2007730,26870,1878541,2003,84185,49341,1294767,19850,1375504,51341,2670271,"California",10257557,0.134096646989142,3028885,0.71,1145530,0.269
"2572","los angeles",2572,"2021-03-23",94883,4065339,50872,2058602,40953,1919494,3058,87243,62875,1328918,31770,1407274,65921,2736192,"California",10257557,0.137193875695743,3028885,0.71,1145530,0.269
"2573","los angeles",2573,"2021-03-24",103544,4168883,54734,2113336,45859,1965353,2951,90194,61485,1351581,41761,1449035,64424,2800616,"California",10257557,0.141265118000319,3028885,0.71,1145530,0.269
"2574","los angeles",2574,"2021-03-25",108581,4277464,57993,2171329,46895,2012248,3693,93887,62371,1371685,45944,1494979,66048,2866664,"California",10257557,0.145744157210143,3028885,0.71,1145530,0.269
"2575","los angeles",2575,"2021-03-26",112403,4389867,61401,2232730,46899,2059147,4103,97990,64025,1391663,48126,1543105,68104,2934768,"California",10257557,0.150435917636139,3028885,0.71,1145530,0.269
"2576","los angeles",2576,"2021-03-27",82035,4471902,42975,2275705,36933,2096080,2127,100117,42917,1397823,38886,1581991,45046,2979814,"California",10257557,0.154226878778251,3028885,0.71,1145530,0.269
"2577","los angeles",2577,"2021-03-28",40882,4512784,27341,2303046,12958,2109038,583,100700,20779,1399178,20006,1601997,21361,3001175,"California",10257557,0.1561772457126,3028885,0.71,1145530,0.269
"2578","los angeles",2578,"2021-03-29",81439,4594223,45936,2348982,33903,2142941,1600,102300,46684,1412887,34570,1636567,48279,3049454,"California",10257557,0.159547443899166,3028885,0.71,1145530,0.269
"2579","los angeles",2579,"2021-03-30",106998,4701221,50425,2399407,50825,2193766,5748,108048,65597,1443018,41187,1677754,71318,3120772,"California",10257557,0.163562727460349,3028885,0.71,1145530,0.269
"2580","los angeles",2580,"2021-03-31",120025,4821246,60299,2459706,51215,2244981,8511,116559,70269,1472271,49501,1727255,78754,3199526,"California",10257557,0.168388535398828,3028885,0.71,1145530,0.269
"2581","los angeles",2581,"2021-04-01",130468,4951714,60930,2520636,54709,2299690,14829,131388,71008,1498860,59190,1786445,85779,3285305,"California",10257557,0.174158915227086,3028885,0.71,1145530,0.269
"2582","los angeles",2582,"2021-04-02",128476,5080190,56881,2577517,56715,2356405,14880,146268,69028,1523597,59148,1845593,83885,3369190,"California",10257557,0.179925200513144,3028885,0.71,1145530,0.269
"2583","los angeles",2583,"2021-04-03",96407,5176597,43893,2621410,39461,2395866,13053,159321,48046,1536457,48195,1893788,61055,3430245,"California",10257557,0.184623687687039,3028885,0.71,1145530,0.269
"2584","los angeles",2584,"2021-04-04",38950,5215547,20355,2641765,12001,2407867,6594,165915,16700,1537537,22182,1915970,23262,3453507,"California",10257557,0.186786190902961,3028885,0.71,1145530,0.269
"2585","los angeles",2585,"2021-04-05",93178,5308725,44110,2685875,38943,2446810,10125,176040,44862,1544332,48138,1964108,54933,3508440,"California",10257557,0.191479121198157,3028885,0.71,1145530,0.269
"2586","los angeles",2586,"2021-04-06",120183,5428908,56578,2742453,43456,2490266,20149,196189,55831,1556081,64125,2028233,75874,3584314,"California",10257557,0.197730609734852,3028885,0.71,1145530,0.269
"2587","los angeles",2587,"2021-04-07",118664,5547572,53986,2796439,43762,2534028,20916,217105,54298,1567051,64139,2092372,75109,3659423,"California",10257557,0.203983463118947,3028885,0.71,1145530,0.269
"2588","los angeles",2588,"2021-04-08",131267,5678839,57809,2854248,49564,2583592,23894,240999,59883,1579580,71124,2163496,83653,3743076,"California",10257557,0.210917277866455,3028885,0.71,1145530,0.269
"2589","los angeles",2589,"2021-04-09",129649,5808488,56063,2910311,49813,2633405,23773,264772,56218,1586281,73165,2236661,79866,3822942,"California",10257557,0.218050067867037,3028885,0.71,1145530,0.269
"2590","los angeles",2590,"2021-04-10",100636,5909124,42745,2953056,34020,2667425,23871,288643,37340,1584309,63083,2299744,61111,3884053,"California",10257557,0.224199972761545,3028885,0.71,1145530,0.269
"2591","los angeles",2591,"2021-04-11",41582,5950706,22483,2975539,9589,2677014,9510,298153,14487,1581236,27026,2326770,23953,3908006,"California",10257557,0.226834713177806,3028885,0.71,1145530,0.269
"2592","los angeles",2592,"2021-04-12",78314,6029020,38352,3013891,33690,2710704,6272,304425,32666,1574660,45463,2372233,38887,3946893,"California",10257557,0.231266860130536,3028885,0.71,1145530,0.269
"2593","los angeles",2593,"2021-04-13",116752,6145772,58773,3072664,57560,2768264,419,304844,61866,1582274,54676,2426909,62290,4009183,"California",10257557,0.23659717416145,3028885,0.71,1145530,0.269
"2594","los angeles",2594,"2021-04-14",116762,6262534,58786,3131450,57848,2826112,128,304972,63516,1592910,53002,2479911,63638,4072821,"California",10257557,0.241764291438985,3028885,0.71,1145530,0.269
"2595","los angeles",2595,"2021-04-15",127506,6390040,69190,3200640,58146,2884258,170,305142,73018,1611724,54246,2534157,73060,4145881,"California",10257557,0.247052685156904,3028885,0.71,1145530,0.269
"2596","los angeles",2596,"2021-04-16",127956,6517996,68133,3268773,59682,2943940,141,305283,67658,1619407,60047,2594204,67730,4213611,"California",10257557,0.252906613143851,3028885,0.71,1145530,0.269
"2597","los angeles",2597,"2021-04-17",96629,6614625,50617,3319390,45987,2989927,25,305308,54986,1632957,41459,2635663,55009,4268620,"California",10257557,0.256948413740231,3028885,0.71,1145530,0.269
"2598","los angeles",2598,"2021-04-18",33768,6648393,22399,3341789,11368,3001295,1,305309,18660,1636580,15043,2650706,18666,4287286,"California",10257557,0.258414942271342,3028885,0.71,1145530,0.269
"2599","los angeles",2599,"2021-04-19",74323,6722716,39510,3381299,34803,3036098,10,305319,33303,1629033,40868,2691574,33321,4320607,"California",10257557,0.262399126809629,3028885,0.71,1145530,0.269
"2600","los angeles",2600,"2021-04-20",101021,6823737,49572,3430871,51431,3087529,18,305337,50219,1628683,50588,2742162,50238,4370845,"California",10257557,0.267330905399795,3028885,0.71,1145530,0.269
"2601","los angeles",2601,"2021-04-21",108508,6932245,52157,3483028,56163,3143692,188,305525,48224,1617082,60015,2802177,48414,4419259,"California",10257557,0.273181713735542,3028885,0.71,1145530,0.269
"2602","los angeles",2602,"2021-04-22",114184,7046429,58919,3541947,55231,3198923,34,305559,50120,1603452,63789,2865966,50159,4469418,"California",10257557,0.279400445934641,3028885,0.71,1145530,0.269
"2603","los angeles",2603,"2021-04-23",113052,7159481,62037,3603984,50999,3249922,16,305575,53842,1598375,58937,2924903,53860,4523278,"California",10257557,0.285146161020602,3028885,0.71,1145530,0.269
"2604","los angeles",2604,"2021-04-24",87492,7246973,56248,3660232,31218,3281140,26,305601,48811,1608741,38477,2963380,48843,4572121,"California",10257557,0.288897249120819,3028885,0.71,1145530,0.269
"2605","los angeles",2605,"2021-04-25",37744,7284717,25084,3685316,12655,3293795,5,305606,20413,1611919,17240,2980620,20418,4592539,"California",10257557,0.290577961204603,3028885,0.71,1145530,0.269
"2606","los angeles",2606,"2021-04-26",66925,7351642,35950,3721266,30529,3324324,446,306052,33132,1611872,33619,3014239,33572,4626111,"California",10257557,0.293855447257081,3028885,0.71,1145530,0.269
"2607","los angeles",2607,"2021-04-27",83949,7435591,40281,3761547,41993,3366317,1675,307727,31855,1593535,51858,3066097,33521,4659632,"California",10257557,0.29891103700423,3028885,0.71,1145530,0.269
"2608","los angeles",2608,"2021-04-28",84196,7519787,40763,3802310,41422,3407739,2011,309738,32834,1577270,51103,3117200,34838,4694470,"California",10257557,0.303893022480889,3028885,0.71,1145530,0.269
"2609","los angeles",2609,"2021-04-29",90506,7610293,45287,3847597,43116,3450855,2103,311841,32114,1553422,58067,3175267,34219,4728689,"California",10257557,0.30955392204986,3028885,0.71,1145530,0.269
"2610","los angeles",2610,"2021-04-30",98327,7708620,48860,3896457,47100,3497955,2367,314208,35809,1529431,62154,3237421,38163,4766852,"California",10257557,0.315613259570481,3028885,0.71,1145530,0.269
"2611","los angeles",2611,"2021-05-01",74635,7783255,42039,3938496,31106,3529061,1490,315698,28239,1512981,46175,3283596,29725,4796577,"California",10257557,0.320114818762401,3028885,0.71,1145530,0.269
"2612","los angeles",2612,"2021-05-02",27898,7811153,17899,3956395,9265,3538326,734,316432,10097,1506119,17691,3301287,10829,4807406,"California",10257557,0.321839498430279,3028885,0.71,1145530,0.269
"2613","los angeles",2613,"2021-05-03",59889,7871042,29397,3985792,28336,3566662,2156,318588,20964,1490510,38719,3340006,23110,4830516,"California",10257557,0.325614178892693,3028885,0.71,1145530,0.269
"2614","los angeles",2614,"2021-05-04",84404,7955446,46522,4032314,35700,3602362,2182,320770,25788,1460132,58341,3398347,27963,4858479,"California",10257557,0.331301790475061,3028885,0.71,1145530,0.269
"2615","los angeles",2615,"2021-05-05",74972,8030418,46523,4078837,26200,3628562,2249,323019,21057,1429778,53648,3451995,23294,4881773,"California",10257557,0.336531885711188,3028885,0.71,1145530,0.269
"2616","los angeles",2616,"2021-05-06",81943,8112361,51691,4130528,27862,3656424,2390,325409,19873,1390272,61750,3513745,22244,4904017,"California",10257557,0.342551837635414,3028885,0.71,1145530,0.269
"2617","los angeles",2617,"2021-05-07",81448,8193809,51059,4181587,28158,3684582,2231,327640,22349,1356030,58812,3572557,24570,4928587,"California",10257557,0.348285366583876,3028885,0.71,1145530,0.269
"2618","los angeles",2618,"2021-05-08",55965,8249774,38413,4220000,15960,3700542,1592,329232,15131,1332332,40412,3612969,16714,4945301,"California",10257557,0.352225096092569,3028885,0.71,1145530,0.269
"2619","madera",2619,"2020-12-16",22,22,22,22,0,0,0,0,22,22,0,0,22,22,"California",160089,0,23168,0.431,29378,0.547
"2620","madera",2620,"2020-12-17",13,35,13,35,0,0,0,0,13,35,0,0,13,35,"California",160089,0,23168,0.431,29378,0.547
"2621","madera",2621,"2020-12-18",60,95,60,95,0,0,0,0,60,95,0,0,60,95,"California",160089,0,23168,0.431,29378,0.547
"2622","madera",2622,"2020-12-19",5,100,5,100,0,0,0,0,5,100,0,0,5,100,"California",160089,0,23168,0.431,29378,0.547
"2623","madera",2623,"2020-12-20",14,114,14,114,0,0,0,0,14,114,0,0,14,114,"California",160089,0,23168,0.431,29378,0.547
"2624","madera",2624,"2020-12-21",60,174,60,174,0,0,0,0,60,174,0,0,60,174,"California",160089,0,23168,0.431,29378,0.547
"2625","madera",2625,"2020-12-22",97,271,95,269,2,2,0,0,97,271,0,0,97,271,"California",160089,0,23168,0.431,29378,0.547
"2626","madera",2626,"2020-12-23",67,338,67,336,0,2,0,0,67,338,0,0,67,338,"California",160089,0,23168,0.431,29378,0.547
"2627","madera",2627,"2020-12-24",45,383,40,376,5,7,0,0,45,383,0,0,45,383,"California",160089,0,23168,0.431,29378,0.547
"2628","madera",2628,"2020-12-26",28,411,26,402,2,9,0,0,28,411,0,0,28,411,"California",160089,0,23168,0.431,29378,0.547
"2629","madera",2629,"2020-12-27",30,441,12,414,18,27,0,0,30,441,0,0,30,441,"California",160089,0,23168,0.431,29378,0.547
"2630","madera",2630,"2020-12-28",107,548,37,451,70,97,0,0,107,548,0,0,107,548,"California",160089,0,23168,0.431,29378,0.547
"2631","madera",2631,"2020-12-29",175,723,40,491,135,232,0,0,175,723,0,0,175,723,"California",160089,0,23168,0.431,29378,0.547
"2632","madera",2632,"2020-12-30",218,941,86,577,132,364,0,0,218,941,0,0,218,941,"California",160089,0,23168,0.431,29378,0.547
"2633","madera",2633,"2020-12-31",201,1142,80,657,121,485,0,0,201,1142,0,0,201,1142,"California",160089,0,23168,0.431,29378,0.547
"2634","madera",2634,"2021-01-01",1,1143,1,658,0,485,0,0,1,1143,0,0,1,1143,"California",160089,0,23168,0.431,29378,0.547
"2635","madera",2635,"2021-01-02",89,1232,33,691,56,541,0,0,89,1232,0,0,89,1232,"California",160089,0,23168,0.431,29378,0.547
"2636","madera",2636,"2021-01-03",5,1237,5,696,0,541,0,0,5,1237,0,0,5,1237,"California",160089,0,23168,0.431,29378,0.547
"2637","madera",2637,"2021-01-04",129,1366,65,761,64,605,0,0,129,1366,0,0,129,1366,"California",160089,0,23168,0.431,29378,0.547
"2638","madera",2638,"2021-01-05",279,1645,143,904,136,741,0,0,275,1637,4,4,275,1641,"California",160089,2.49861014810512e-05,23168,0.431,29378,0.547
"2639","madera",2639,"2021-01-06",184,1829,27,931,157,898,0,0,164,1781,20,24,164,1805,"California",160089,0.000149916608886307,23168,0.431,29378,0.547
"2640","madera",2640,"2021-01-07",396,2225,113,1044,283,1181,0,0,374,2133,22,46,374,2179,"California",160089,0.000287340167032088,23168,0.431,29378,0.547
"2641","madera",2641,"2021-01-08",418,2643,72,1116,346,1527,0,0,363,2443,54,100,364,2543,"California",160089,0.000624652537026279,23168,0.431,29378,0.547
"2642","madera",2642,"2021-01-09",37,2680,14,1130,23,1550,0,0,28,2462,9,109,28,2571,"California",160089,0.000680871265358644,23168,0.431,29378,0.547
"2643","madera",2643,"2021-01-10",17,2697,14,1144,3,1553,0,0,5,2455,12,121,5,2576,"California",160089,0.000755829569801798,23168,0.431,29378,0.547
"2644","madera",2644,"2021-01-11",237,2934,189,1333,48,1601,0,0,195,2608,42,163,195,2771,"California",160089,0.00101818363535283,23168,0.431,29378,0.547
"2645","madera",2645,"2021-01-12",391,3325,158,1491,233,1834,0,0,285,2787,106,269,285,3056,"California",160089,0.00168031532460069,23168,0.431,29378,0.547
"2646","madera",2646,"2021-01-13",185,3510,91,1582,94,1928,0,0,129,2861,56,325,130,3186,"California",160089,0.00203012074533541,23168,0.431,29378,0.547
"2647","madera",2647,"2021-01-14",554,4064,82,1664,472,2400,0,0,520,3347,34,359,520,3706,"California",160089,0.00224250260792434,23168,0.431,29378,0.547
"2648","madera",2648,"2021-01-15",600,4664,160,1824,440,2840,0,0,579,3905,21,380,579,4285,"California",160089,0.00237367964069986,23168,0.431,29378,0.547
"2649","madera",2649,"2021-01-16",382,5046,47,1871,335,3175,0,0,353,4229,29,409,353,4638,"California",160089,0.00255482887643748,23168,0.431,29378,0.547
"2650","madera",2650,"2021-01-17",335,5381,15,1886,320,3495,0,0,331,4556,4,413,331,4969,"California",160089,0.00257981497791853,23168,0.431,29378,0.547
"2651","madera",2651,"2021-01-18",77,5458,61,1947,16,3511,0,0,58,4596,18,431,58,5027,"California",160089,0.00269225243458326,23168,0.431,29378,0.547
"2652","madera",2652,"2021-01-19",572,6030,135,2082,437,3948,0,0,545,5115,27,458,546,5573,"California",160089,0.00286090861958036,23168,0.431,29378,0.547
"2653","madera",2653,"2021-01-20",235,6265,80,2162,155,4103,0,0,207,5295,27,485,207,5780,"California",160089,0.00302956480457745,23168,0.431,29378,0.547
"2654","madera",2654,"2021-01-21",238,6503,131,2293,107,4210,0,0,205,5469,31,516,205,5985,"California",160089,0.0032232070910556,23168,0.431,29378,0.547
"2655","madera",2655,"2021-01-22",257,6760,83,2376,174,4384,0,0,243,5698,14,530,243,6228,"California",160089,0.00331065844623928,23168,0.431,29378,0.547
"2656","madera",2656,"2021-01-23",100,6860,52,2428,48,4432,0,0,76,5750,24,554,76,6304,"California",160089,0.00346057505512559,23168,0.431,29378,0.547
"2657","madera",2657,"2021-01-24",101,6961,82,2510,19,4451,0,0,78,5805,23,577,78,6382,"California",160089,0.00360424513864163,23168,0.431,29378,0.547
"2658","madera",2658,"2021-01-25",255,7216,124,2634,131,4582,0,0,141,5832,114,691,141,6523,"California",160089,0.00431634903085159,23168,0.431,29378,0.547
"2659","madera",2659,"2021-01-26",483,7699,189,2823,294,4876,0,0,294,5939,188,879,295,6818,"California",160089,0.00549069580046099,23168,0.431,29378,0.547
"2660","madera",2660,"2021-01-27",737,8436,63,2886,674,5550,0,0,600,6404,137,1016,602,7420,"California",160089,0.006346469776187,23168,0.431,29378,0.547
"2661","madera",2661,"2021-01-28",543,8979,107,2993,436,5986,0,0,440,6741,103,1119,440,7860,"California",160089,0.00698986188932406,23168,0.431,29378,0.547
"2662","madera",2662,"2021-01-29",468,9447,95,3088,373,6359,0,0,412,7097,56,1175,412,8272,"California",160089,0.00733966731005878,23168,0.431,29378,0.547
"2663","madera",2663,"2021-01-30",505,9952,16,3104,489,6848,0,0,451,7494,54,1229,451,8723,"California",160089,0.00767697968005297,23168,0.431,29378,0.547
"2664","madera",2664,"2021-01-31",9,9961,6,3110,3,6851,0,0,8,7501,1,1230,8,8731,"California",160089,0.00768322620542323,23168,0.431,29378,0.547
"2665","madera",2665,"2021-02-01",258,10219,73,3183,185,7036,0,0,198,7639,60,1290,198,8929,"California",160089,0.008058017727639,23168,0.431,29378,0.547
"2666","madera",2666,"2021-02-02",251,10470,87,3270,164,7200,0,0,161,7712,89,1379,162,9091,"California",160089,0.00861395848559239,23168,0.431,29378,0.547
"2667","madera",2667,"2021-02-03",594,11064,460,3730,134,7334,0,0,474,8069,118,1497,475,9566,"California",160089,0.0093510484792834,23168,0.431,29378,0.547
"2668","madera",2668,"2021-02-04",389,11453,121,3851,268,7602,0,0,112,7906,276,1773,113,9679,"California",160089,0.0110750894814759,23168,0.431,29378,0.547
"2669","madera",2669,"2021-02-05",975,12428,297,4148,678,8280,0,0,369,7675,601,2374,370,10049,"California",160089,0.0148292512290039,23168,0.431,29378,0.547
"2670","madera",2670,"2021-02-06",359,12787,324,4472,35,8315,0,0,320,7957,38,2412,320,10369,"California",160089,0.0150666191930739,23168,0.431,29378,0.547
"2671","madera",2671,"2021-02-07",35,12822,7,4479,28,8343,0,0,30,7982,5,2417,30,10399,"California",160089,0.0150978518199252,23168,0.431,29378,0.547
"2672","madera",2672,"2021-02-08",384,13206,308,4787,76,8419,0,0,270,8139,113,2530,270,10669,"California",160089,0.0158037091867649,23168,0.431,29378,0.547
"2673","madera",2673,"2021-02-09",480,13686,119,4906,361,8780,0,0,198,8059,279,2809,199,10868,"California",160089,0.0175464897650682,23168,0.431,29378,0.547
"2674","madera",2674,"2021-02-10",431,14117,149,5055,282,9062,0,0,325,8278,106,2915,325,11193,"California",160089,0.018208621454316,23168,0.431,29378,0.547
"2675","madera",2675,"2021-02-11",935,15052,307,5362,628,9690,0,0,406,8157,528,3443,407,11600,"California",160089,0.0215067868498148,23168,0.431,29378,0.547
"2676","madera",2676,"2021-02-12",844,15896,120,5482,724,10414,0,0,311,7944,527,3970,314,11914,"California",160089,0.0247987057199433,23168,0.431,29378,0.547
"2677","madera",2677,"2021-02-13",485,16381,44,5526,441,10855,0,0,139,7740,345,4315,141,12055,"California",160089,0.0269537569726839,23168,0.431,29378,0.547
"2678","madera",2678,"2021-02-14",399,16780,75,5601,324,11179,0,0,137,7616,262,4577,138,12193,"California",160089,0.0285903466196928,23168,0.431,29378,0.547
"2679","madera",2679,"2021-02-15",244,17024,98,5699,146,11325,0,0,175,7723,68,4645,175,12368,"California",160089,0.0290151103448707,23168,0.431,29378,0.547
"2680","madera",2680,"2021-02-16",775,17799,183,5882,592,11917,0,0,229,7409,544,5189,230,12598,"California",160089,0.0324132201462936,23168,0.431,29378,0.547
"2681","madera",2681,"2021-02-17",609,18408,274,6156,335,12252,0,0,339,7485,265,5454,341,12939,"California",160089,0.0340685493694133,23168,0.431,29378,0.547
"2682","madera",2682,"2021-02-18",1299,19707,540,6696,759,13011,0,0,1120,8427,179,5633,1121,14060,"California",160089,0.0351866774106903,23168,0.431,29378,0.547
"2683","madera",2683,"2021-02-19",861,20568,545,7241,316,13327,0,0,719,9005,142,5775,720,14780,"California",160089,0.0360736840132676,23168,0.431,29378,0.547
"2684","madera",2684,"2021-02-20",1070,21638,979,8220,91,13418,0,0,999,9935,70,5845,1000,15780,"California",160089,0.036510940789186,23168,0.431,29378,0.547
"2685","madera",2685,"2021-02-21",962,22600,819,9039,143,13561,0,0,957,10887,5,5850,957,16737,"California",160089,0.0365421734160373,23168,0.431,29378,0.547
"2686","madera",2686,"2021-02-22",909,23509,833,9872,76,13637,0,0,855,11688,54,5904,855,17592,"California",160089,0.0368794857860315,23168,0.431,29378,0.547
"2687","madera",2687,"2021-02-23",770,24279,497,10369,273,13910,0,0,550,12019,219,6123,550,18142,"California",160089,0.0382474748421191,23168,0.431,29378,0.547
"2688","madera",2688,"2021-02-24",906,25185,299,10668,607,14517,0,0,377,11868,528,6651,377,18519,"California",160089,0.0415456402376178,23168,0.431,29378,0.547
"2689","madera",2689,"2021-02-25",1017,26202,306,10974,711,15228,0,0,587,12027,428,7079,587,19106,"California",160089,0.0442191530960903,23168,0.431,29378,0.547
"2690","madera",2690,"2021-02-26",1074,27276,185,11159,889,16117,0,0,698,12351,374,7453,698,19804,"California",160089,0.0465553535845686,23168,0.431,29378,0.547
"2691","madera",2691,"2021-02-27",872,28148,245,11404,627,16744,0,0,449,12383,420,7873,452,20256,"California",160089,0.049178894240079,23168,0.431,29378,0.547
"2692","madera",2692,"2021-02-28",189,28337,29,11433,160,16904,0,0,183,12560,6,7879,183,20439,"California",160089,0.0492163733923005,23168,0.431,29378,0.547
"2693","madera",2693,"2021-03-01",374,28711,120,11553,254,17158,0,0,194,12576,178,8057,194,20633,"California",160089,0.0503282549082073,23168,0.431,29378,0.547
"2694","madera",2694,"2021-03-02",655,29366,269,11822,386,17544,0,0,541,13004,114,8171,542,21175,"California",160089,0.0510403588004173,23168,0.431,29378,0.547
"2695","madera",2695,"2021-03-03",1329,30695,707,12529,622,18166,0,0,927,13556,399,8570,951,22126,"California",160089,0.0535327224231521,23168,0.431,29378,0.547
"2696","madera",2696,"2021-03-04",1179,31874,506,13035,673,18839,0,0,934,14247,246,8816,937,23063,"California",160089,0.0550693676642368,23168,0.431,29378,0.547
"2697","madera",2697,"2021-03-05",1329,33203,407,13442,909,19748,13,13,1064,15072,263,9079,1088,24151,"California",160089,0.0567122038366159,23168,0.431,29378,0.547
"2698","madera",2698,"2021-03-06",802,34005,621,14063,149,19897,32,45,484,15272,317,9396,517,24668,"California",160089,0.0586923523789892,23168,0.431,29378,0.547
"2699","madera",2699,"2021-03-07",153,34158,27,14090,104,20001,22,67,103,15347,50,9446,125,24793,"California",160089,0.0590046786475023,23168,0.431,29378,0.547
"2700","madera",2700,"2021-03-08",597,34755,336,14426,202,20203,59,126,304,15419,293,9739,365,25158,"California",160089,0.0608349105809893,23168,0.431,29378,0.547
"2701","madera",2701,"2021-03-09",457,35212,160,14586,263,20466,34,160,279,15564,176,9915,321,25479,"California",160089,0.0619342990461556,23168,0.431,29378,0.547
"2702","madera",2702,"2021-03-10",1138,36350,513,15099,547,21013,78,238,709,15927,425,10340,788,26267,"California",160089,0.0645890723285173,23168,0.431,29378,0.547
"2703","madera",2703,"2021-03-11",1660,38010,844,15943,484,21497,332,570,749,16110,909,11249,1092,27359,"California",160089,0.0702671638900861,23168,0.431,29378,0.547
"2704","madera",2704,"2021-03-12",1531,39541,779,16722,597,22094,155,725,753,16267,776,12025,933,28292,"California",160089,0.0751144675774101,23168,0.431,29378,0.547
"2705","madera",2705,"2021-03-13",1811,41352,1268,17990,345,22439,198,923,745,16162,1064,13089,959,29251,"California",160089,0.0817607705713697,23168,0.431,29378,0.547
"2706","madera",2706,"2021-03-14",583,41935,448,18438,102,22541,33,956,293,16201,287,13376,326,29577,"California",160089,0.0835535233526351,23168,0.431,29378,0.547
"2707","madera",2707,"2021-03-15",737,42672,220,18658,470,23011,47,1003,513,16565,221,13597,585,30162,"California",160089,0.0849340054594632,23168,0.431,29378,0.547
"2708","madera",2708,"2021-03-16",825,43497,422,19080,356,23367,47,1050,642,17091,180,13777,706,30868,"California",160089,0.0860583800261105,23168,0.431,29378,0.547
"2709","madera",2709,"2021-03-17",1413,44910,932,20012,419,23786,62,1112,861,17560,544,14321,1013,31881,"California",160089,0.0894564898275334,23168,0.431,29378,0.547
"2710","madera",2710,"2021-03-18",1875,46785,649,20661,1166,24952,60,1172,911,17658,957,15278,1055,32936,"California",160089,0.0954344146068749,23168,0.431,29378,0.547
"2711","madera",2711,"2021-03-19",1521,48306,587,21248,850,25802,84,1256,987,18266,528,15806,1136,34072,"California",160089,0.0987325800023737,23168,0.431,29378,0.547
"2712","madera",2712,"2021-03-20",1130,49436,772,22020,307,26109,51,1307,580,18397,548,16354,679,34751,"California",160089,0.102155675905278,23168,0.431,29378,0.547
"2713","madera",2713,"2021-03-21",1073,50509,872,22892,156,26265,45,1352,357,18087,713,17067,403,35154,"California",160089,0.106609448494275,23168,0.431,29378,0.547
"2714","madera",2714,"2021-03-22",1359,51868,851,23743,440,26705,68,1420,686,18213,670,17737,796,35950,"California",160089,0.110794620492351,23168,0.431,29378,0.547
"2715","madera",2715,"2021-03-23",1397,53265,840,24583,466,27171,91,1511,735,18462,659,18396,908,36858,"California",160089,0.114911080711354,23168,0.431,29378,0.547
"2716","madera",2716,"2021-03-24",907,54172,471,25054,405,27576,31,1542,602,18796,303,18699,637,37495,"California",160089,0.116803777898544,23168,0.431,29378,0.547
"2717","madera",2717,"2021-03-25",1126,55298,491,25545,611,28187,24,1566,647,19012,468,19167,684,38179,"California",160089,0.119727151771827,23168,0.431,29378,0.547
"2718","madera",2718,"2021-03-26",1439,56737,510,26055,797,28984,132,1698,673,19060,760,19927,808,38987,"California",160089,0.124474511053227,23168,0.431,29378,0.547
"2719","madera",2719,"2021-03-27",831,57568,530,26585,279,29263,22,1720,373,19004,452,20379,396,39383,"California",160089,0.127297940520585,23168,0.431,29378,0.547
"2720","madera",2720,"2021-03-28",419,57987,136,26721,222,29485,61,1781,229,19158,189,20568,343,39726,"California",160089,0.128478533815565,23168,0.431,29378,0.547
"2721","madera",2721,"2021-03-29",680,58667,179,26900,474,29959,27,1808,488,19489,188,20756,519,40245,"California",160089,0.129652880585174,23168,0.431,29378,0.547
"2722","madera",2722,"2021-03-30",1017,59684,561,27461,424,30383,32,1840,557,19622,457,21213,590,40835,"California",160089,0.132507542679385,23168,0.431,29378,0.547
"2723","madera",2723,"2021-03-31",1322,61006,489,27950,698,31081,135,1975,447,19336,869,22082,583,41418,"California",160089,0.137935773226143,23168,0.431,29378,0.547
"2724","madera",2724,"2021-04-01",1249,62255,538,28488,661,31742,50,2025,441,19022,803,22885,489,41907,"California",160089,0.142951733098464,23168,0.431,29378,0.547
"2725","madera",2725,"2021-04-02",1538,63793,409,28897,1070,32812,59,2084,471,18497,1056,23941,531,42438,"California",160089,0.149548063889461,23168,0.431,29378,0.547
"2726","madera",2726,"2021-04-03",880,64673,684,29581,176,32988,20,2104,383,18414,495,24436,412,42850,"California",160089,0.152640093947742,23168,0.431,29378,0.547
"2727","madera",2727,"2021-04-04",184,64857,65,29646,117,33105,2,2106,85,18402,99,24535,87,42937,"California",160089,0.153258499959398,23168,0.431,29378,0.547
"2728","madera",2728,"2021-04-05",734,65591,255,29901,421,33526,58,2164,340,18421,393,24928,412,43349,"California",160089,0.155713384429911,23168,0.431,29378,0.547
"2729","madera",2729,"2021-04-06",1692,67283,879,30780,464,33990,349,2513,634,18347,1056,25984,982,44331,"California",160089,0.162309715220908,23168,0.431,29378,0.547
"2730","madera",2730,"2021-04-07",1199,68482,371,31151,679,34669,149,2662,456,18217,740,26724,610,44941,"California",160089,0.166932143994903,23168,0.431,29378,0.547
"2731","madera",2731,"2021-04-08",1697,70179,655,31806,786,35455,256,2918,568,17925,1122,27846,830,45771,"California",160089,0.173940745460338,23168,0.431,29378,0.547
"2732","madera",2732,"2021-04-09",1612,71791,673,32479,790,36245,149,3067,940,18351,666,28512,1092,46863,"California",160089,0.178100931356933,23168,0.431,29378,0.547
"2733","madera",2733,"2021-04-10",954,72745,679,33158,208,36453,67,3134,709,18882,246,28758,777,47640,"California",160089,0.179637576598017,23168,0.431,29378,0.547
"2734","madera",2734,"2021-04-11",791,73536,639,33797,73,36526,79,3213,301,18772,487,29245,377,48017,"California",160089,0.182679634453335,23168,0.431,29378,0.547
"2735","madera",2735,"2021-04-12",778,74314,265,34062,435,36961,78,3291,301,18675,477,29722,380,48397,"California",160089,0.185659227054951,23168,0.431,29378,0.547
"2736","madera",2736,"2021-04-13",1235,75549,610,34672,584,37545,41,3332,728,18949,505,30227,779,49176,"California",160089,0.188813722366933,23168,0.431,29378,0.547
"2737","madera",2737,"2021-04-14",1363,76912,838,35510,525,38070,0,3332,582,18754,783,31010,588,49764,"California",160089,0.193704751731849,23168,0.431,29378,0.547
"2738","madera",2738,"2021-04-15",1123,78035,470,35980,652,38722,1,3333,448,18540,664,31674,450,50214,"California",160089,0.197852444577704,23168,0.431,29378,0.547
"2739","madera",2739,"2021-04-16",1282,79317,519,36499,763,39485,0,3333,443,18156,828,32502,444,50658,"California",160089,0.203024567584281,23168,0.431,29378,0.547
"2740","madera",2740,"2021-04-17",1264,80581,1065,37564,199,39684,0,3333,825,18542,439,32941,825,51483,"California",160089,0.205766792221827,23168,0.431,29378,0.547
"2741","madera",2741,"2021-04-18",244,80825,207,37771,37,39721,0,3333,99,18497,144,33085,99,51582,"California",160089,0.206666291875144,23168,0.431,29378,0.547
"2742","madera",2742,"2021-04-19",798,81623,232,38003,565,40286,1,3334,270,18247,521,33606,271,51853,"California",160089,0.209920731593051,23168,0.431,29378,0.547
"2743","madera",2743,"2021-04-20",865,82488,423,38426,442,40728,0,3334,237,17861,625,34231,239,52092,"California",160089,0.213824809949466,23168,0.431,29378,0.547
"2744","madera",2744,"2021-04-21",854,83342,447,38873,407,41135,0,3334,297,17605,555,34786,299,52391,"California",160089,0.217291631529961,23168,0.431,29378,0.547
"2745","madera",2745,"2021-04-22",1059,84401,510,39383,549,41684,0,3334,393,17337,662,35448,394,52785,"California",160089,0.221426831325075,23168,0.431,29378,0.547
"2746","madera",2746,"2021-04-23",961,85362,306,39689,654,42338,1,3335,347,17076,609,36057,348,53133,"California",160089,0.225230965275565,23168,0.431,29378,0.547
"2747","madera",2747,"2021-04-24",703,86065,464,40153,239,42577,0,3335,283,16944,416,36473,284,53417,"California",160089,0.227829519829595,23168,0.431,29378,0.547
"2748","madera",2748,"2021-04-25",265,86330,161,40314,101,42678,3,3338,118,16923,143,36616,122,53539,"California",160089,0.228722772957542,23168,0.431,29378,0.547
"2749","madera",2749,"2021-04-26",506,86836,89,40403,411,43089,6,3344,104,16633,400,37016,110,53649,"California",160089,0.231221383105647,23168,0.431,29378,0.547
"2750","madera",2750,"2021-04-27",556,87392,257,40660,278,43367,21,3365,297,16694,258,37274,319,53968,"California",160089,0.232832986651175,23168,0.431,29378,0.547
"2751","madera",2751,"2021-04-28",474,87866,197,40857,258,43625,19,3384,236,16712,236,37510,254,54222,"California",160089,0.234307166638557,23168,0.431,29378,0.547
"2752","madera",2752,"2021-04-29",516,88382,240,41097,249,43874,27,3411,251,16732,258,37768,278,54500,"California",160089,0.235918770184085,23168,0.431,29378,0.547
"2753","madera",2753,"2021-04-30",922,89304,505,41602,401,44275,16,3427,262,16354,656,38424,278,54778,"California",160089,0.240016490826977,23168,0.431,29378,0.547
"2754","madera",2754,"2021-05-01",956,90260,864,42466,79,44354,13,3440,388,16187,568,38992,401,55179,"California",160089,0.243564517237287,23168,0.431,29378,0.547
"2755","madera",2755,"2021-05-02",398,90658,350,42816,44,44398,4,3444,149,16091,249,39241,153,55332,"California",160089,0.245119902054482,23168,0.431,29378,0.547
"2756","madera",2756,"2021-05-03",501,91159,200,43016,260,44658,41,3485,99,15832,399,39640,140,55472,"California",160089,0.247612265677217,23168,0.431,29378,0.547
"2757","madera",2757,"2021-05-04",874,92033,429,43445,403,45061,42,3527,211,15422,663,40303,253,55725,"California",160089,0.251753711997701,23168,0.431,29378,0.547
"2758","madera",2758,"2021-05-05",997,93030,477,43922,461,45522,59,3586,278,15043,717,41020,338,56063,"California",160089,0.25623247068818,23168,0.431,29378,0.547
"2759","madera",2759,"2021-05-06",692,93722,240,44162,418,45940,34,3620,156,14702,531,41551,190,56253,"California",160089,0.259549375659789,23168,0.431,29378,0.547
"2760","madera",2760,"2021-05-07",804,94526,275,44437,507,46447,22,3642,194,14314,603,42154,215,56468,"California",160089,0.263316030458058,23168,0.431,29378,0.547
"2761","madera",2761,"2021-05-08",968,95494,755,45192,203,46650,10,3652,187,13732,779,42933,197,56665,"California",160089,0.268182073721492,23168,0.431,29378,0.547
"2762","marin",2762,"2020-12-15",2,2,2,2,0,0,0,0,2,2,0,0,2,2,"California",260800,0,128288,0.823,24612,0.158
"2763","marin",2763,"2020-12-16",107,109,107,109,0,0,0,0,107,109,0,0,107,109,"California",260800,0,128288,0.823,24612,0.158
"2764","marin",2764,"2020-12-17",260,369,260,369,0,0,0,0,260,369,0,0,260,369,"California",260800,0,128288,0.823,24612,0.158
"2765","marin",2765,"2020-12-18",373,742,373,742,0,0,0,0,373,742,0,0,373,742,"California",260800,0,128288,0.823,24612,0.158
"2766","marin",2766,"2020-12-19",349,1091,348,1090,1,1,0,0,349,1091,0,0,349,1091,"California",260800,0,128288,0.823,24612,0.158
"2767","marin",2767,"2020-12-20",167,1258,166,1256,1,2,0,0,167,1258,0,0,167,1258,"California",260800,0,128288,0.823,24612,0.158
"2768","marin",2768,"2020-12-21",238,1496,235,1491,3,5,0,0,238,1496,0,0,238,1496,"California",260800,0,128288,0.823,24612,0.158
"2769","marin",2769,"2020-12-22",521,2017,317,1808,204,209,0,0,521,2017,0,0,521,2017,"California",260800,0,128288,0.823,24612,0.158
"2770","marin",2770,"2020-12-23",730,2747,321,2129,409,618,0,0,730,2747,0,0,730,2747,"California",260800,0,128288,0.823,24612,0.158
"2771","marin",2771,"2020-12-24",357,3104,159,2288,198,816,0,0,357,3104,0,0,357,3104,"California",260800,0,128288,0.823,24612,0.158
"2772","marin",2772,"2020-12-25",27,3131,0,2288,27,843,0,0,27,3131,0,0,27,3131,"California",260800,0,128288,0.823,24612,0.158
"2773","marin",2773,"2020-12-26",143,3274,93,2381,50,893,0,0,143,3274,0,0,143,3274,"California",260800,0,128288,0.823,24612,0.158
"2774","marin",2774,"2020-12-27",92,3366,55,2436,37,930,0,0,92,3366,0,0,92,3366,"California",260800,0,128288,0.823,24612,0.158
"2775","marin",2775,"2020-12-28",408,3774,99,2535,309,1239,0,0,408,3774,0,0,408,3774,"California",260800,0,128288,0.823,24612,0.158
"2776","marin",2776,"2020-12-29",402,4176,88,2623,314,1553,0,0,402,4176,0,0,402,4176,"California",260800,0,128288,0.823,24612,0.158
"2777","marin",2777,"2020-12-30",626,4802,388,3011,238,1791,0,0,626,4802,0,0,626,4802,"California",260800,0,128288,0.823,24612,0.158
"2778","marin",2778,"2020-12-31",197,4999,34,3045,163,1954,0,0,197,4999,0,0,197,4999,"California",260800,0,128288,0.823,24612,0.158
"2779","marin",2779,"2021-01-01",16,5015,6,3051,10,1964,0,0,16,5015,0,0,16,5015,"California",260800,0,128288,0.823,24612,0.158
"2780","marin",2780,"2021-01-02",108,5123,102,3153,6,1970,0,0,108,5123,0,0,108,5123,"California",260800,0,128288,0.823,24612,0.158
"2781","marin",2781,"2021-01-03",54,5177,36,3189,18,1988,0,0,51,5174,0,0,51,5174,"California",260800,0,128288,0.823,24612,0.158
"2782","marin",2782,"2021-01-04",296,5473,192,3381,104,2092,0,0,295,5468,1,1,295,5469,"California",260800,3.83435582822086e-06,128288,0.823,24612,0.158
"2783","marin",2783,"2021-01-05",369,5842,222,3603,147,2239,0,0,326,5751,43,44,326,5795,"California",260800,0.000168711656441718,128288,0.823,24612,0.158
"2784","marin",2784,"2021-01-06",819,6661,318,3921,501,2740,0,0,641,6214,178,222,641,6436,"California",260800,0.000851226993865031,128288,0.823,24612,0.158
"2785","marin",2785,"2021-01-07",890,7551,502,4423,388,3128,0,0,544,6412,346,568,544,6980,"California",260800,0.00217791411042945,128288,0.823,24612,0.158
"2786","marin",2786,"2021-01-08",971,8522,515,4938,456,3584,0,0,594,6630,376,944,594,7574,"California",260800,0.00361963190184049,128288,0.823,24612,0.158
"2787","marin",2787,"2021-01-09",620,9142,224,5162,396,3980,0,0,488,6986,132,1076,488,8062,"California",260800,0.00412576687116564,128288,0.823,24612,0.158
"2788","marin",2788,"2021-01-10",129,9271,100,5262,29,4009,0,0,55,6967,74,1150,55,8117,"California",260800,0.00440950920245399,128288,0.823,24612,0.158
"2789","marin",2789,"2021-01-11",468,9739,326,5588,142,4151,0,0,248,6997,220,1370,250,8367,"California",260800,0.00525306748466258,128288,0.823,24612,0.158
"2790","marin",2790,"2021-01-12",935,10674,538,6126,397,4548,0,0,568,7201,364,1734,568,8935,"California",260800,0.00664877300613497,128288,0.823,24612,0.158
"2791","marin",2791,"2021-01-13",1175,11849,498,6624,677,5225,0,0,937,7900,238,1972,937,9872,"California",260800,0.00756134969325153,128288,0.823,24612,0.158
"2792","marin",2792,"2021-01-14",1068,12917,318,6942,750,5975,0,0,918,8670,148,2120,918,10790,"California",260800,0.00812883435582822,128288,0.823,24612,0.158
"2793","marin",2793,"2021-01-15",1156,14073,354,7296,802,6777,0,0,1026,9568,129,2249,1027,11817,"California",260800,0.00862346625766871,128288,0.823,24612,0.158
"2794","marin",2794,"2021-01-16",1120,15193,914,8210,206,6983,0,0,1046,10540,74,2323,1046,12863,"California",260800,0.00890720858895705,128288,0.823,24612,0.158
"2795","marin",2795,"2021-01-17",1232,16425,1113,9323,119,7102,0,0,1203,11718,28,2351,1206,14069,"California",260800,0.00901457055214724,128288,0.823,24612,0.158
"2796","marin",2796,"2021-01-18",360,16785,159,9482,201,7303,0,0,309,11976,51,2402,309,14378,"California",260800,0.0092101226993865,128288,0.823,24612,0.158
"2797","marin",2797,"2021-01-19",1156,17941,914,10396,242,7545,0,0,984,12789,171,2573,984,15362,"California",260800,0.00986579754601227,128288,0.823,24612,0.158
"2798","marin",2798,"2021-01-20",1790,19731,1208,11604,582,8127,0,0,1060,13130,719,3292,1060,16422,"California",260800,0.0126226993865031,128288,0.823,24612,0.158
"2799","marin",2799,"2021-01-21",1685,21416,1062,12666,623,8750,0,0,1332,14114,350,3642,1334,17756,"California",260800,0.0139647239263804,128288,0.823,24612,0.158
"2800","marin",2800,"2021-01-22",1701,23117,1089,13755,612,9362,0,0,1533,15479,168,3810,1533,19289,"California",260800,0.0146088957055215,128288,0.823,24612,0.158
"2801","marin",2801,"2021-01-23",1843,24960,1341,15096,502,9864,0,0,1754,17145,88,3898,1754,21043,"California",260800,0.0149463190184049,128288,0.823,24612,0.158
"2802","marin",2802,"2021-01-24",615,25575,166,15262,449,10313,0,0,583,17696,32,3930,583,21626,"California",260800,0.015069018404908,128288,0.823,24612,0.158
"2803","marin",2803,"2021-01-25",1128,26703,229,15491,899,11212,0,0,693,17955,435,4365,694,22320,"California",260800,0.016736963190184,128288,0.823,24612,0.158
"2804","marin",2804,"2021-01-26",1505,28208,783,16274,722,11934,0,0,1130,18711,374,4739,1130,23450,"California",260800,0.0181710122699387,128288,0.823,24612,0.158
"2805","marin",2805,"2021-01-27",1714,29922,886,17160,828,12762,0,0,1352,19704,360,5099,1353,24803,"California",260800,0.0195513803680982,128288,0.823,24612,0.158
"2806","marin",2806,"2021-01-28",2079,32001,1070,18230,1009,13771,0,0,1815,21257,263,5362,1816,26619,"California",260800,0.0205598159509202,128288,0.823,24612,0.158
"2807","marin",2807,"2021-01-29",2195,34196,1446,19676,749,14520,0,0,1991,23057,192,5554,1992,28611,"California",260800,0.0212960122699387,128288,0.823,24612,0.158
"2808","marin",2808,"2021-01-30",1721,35917,906,20582,815,15335,0,0,1642,24621,79,5633,1643,30254,"California",260800,0.0215989263803681,128288,0.823,24612,0.158
"2809","marin",2809,"2021-01-31",457,36374,320,20902,137,15472,0,0,431,25026,26,5659,431,30685,"California",260800,0.0216986196319018,128288,0.823,24612,0.158
"2810","marin",2810,"2021-02-01",1090,37464,416,21318,674,16146,0,0,891,25719,199,5858,892,31577,"California",260800,0.0224616564417178,128288,0.823,24612,0.158
"2811","marin",2811,"2021-02-02",1353,38817,463,21781,890,17036,0,0,723,25823,619,6477,723,32300,"California",260800,0.0248351226993865,128288,0.823,24612,0.158
"2812","marin",2812,"2021-02-03",1782,40599,429,22210,1353,18389,0,0,1257,26556,524,7001,1257,33557,"California",260800,0.0268443251533742,128288,0.823,24612,0.158
"2813","marin",2813,"2021-02-04",1540,42139,513,22723,1027,19416,0,0,937,26893,600,7601,937,34494,"California",260800,0.0291449386503067,128288,0.823,24612,0.158
"2814","marin",2814,"2021-02-05",2179,44318,683,23406,1496,20912,0,0,1341,27400,834,8435,1341,35835,"California",260800,0.0323427914110429,128288,0.823,24612,0.158
"2815","marin",2815,"2021-02-06",1426,45744,850,24256,576,21488,0,0,604,27183,821,9256,604,36439,"California",260800,0.0354907975460123,128288,0.823,24612,0.158
"2816","marin",2816,"2021-02-07",1290,47034,1008,25264,282,21770,0,0,488,26870,801,10057,488,36927,"California",260800,0.0385621165644172,128288,0.823,24612,0.158
"2817","marin",2817,"2021-02-08",1521,48555,754,26018,767,22537,0,0,726,26803,793,10850,726,37653,"California",260800,0.0416027607361963,128288,0.823,24612,0.158
"2818","marin",2818,"2021-02-09",1783,50338,1122,27140,661,23198,0,0,835,26690,948,11798,835,38488,"California",260800,0.0452377300613497,128288,0.823,24612,0.158
"2819","marin",2819,"2021-02-10",2338,52676,1492,28632,846,24044,0,0,1218,26791,1118,12916,1219,39707,"California",260800,0.0495245398773006,128288,0.823,24612,0.158
"2820","marin",2820,"2021-02-11",2871,55547,1644,30276,1227,25271,0,0,1454,26837,1411,14327,1457,41164,"California",260800,0.0549348159509202,128288,0.823,24612,0.158
"2821","marin",2821,"2021-02-12",3063,58610,1540,31816,1523,26794,0,0,1563,26903,1497,15824,1563,42727,"California",260800,0.0606748466257669,128288,0.823,24612,0.158
"2822","marin",2822,"2021-02-13",2337,60947,1243,33059,1094,27888,0,0,1130,26828,1205,17029,1130,43857,"California",260800,0.065295245398773,128288,0.823,24612,0.158
"2823","marin",2823,"2021-02-14",811,61758,302,33361,509,28397,0,0,718,27454,93,17122,719,44576,"California",260800,0.0656518404907975,128288,0.823,24612,0.158
"2824","marin",2824,"2021-02-15",1215,62973,355,33716,860,29257,0,0,835,27911,379,17501,836,45412,"California",260800,0.0671050613496933,128288,0.823,24612,0.158
"2825","marin",2825,"2021-02-16",2464,65437,1057,34773,1407,30664,0,0,1503,28454,960,18461,1503,46915,"California",260800,0.0707860429447853,128288,0.823,24612,0.158
"2826","marin",2826,"2021-02-17",2099,67536,942,35715,1157,31821,0,0,1086,28530,1011,19472,1087,48002,"California",260800,0.0746625766871166,128288,0.823,24612,0.158
"2827","marin",2827,"2021-02-18",2417,69953,1581,37296,836,32657,0,0,1059,28232,1357,20829,1059,49061,"California",260800,0.0798657975460123,128288,0.823,24612,0.158
"2828","marin",2828,"2021-02-19",2762,72715,2157,39453,605,33262,0,0,1220,27923,1530,22359,1221,50282,"California",260800,0.0857323619631902,128288,0.823,24612,0.158
"2829","marin",2829,"2021-02-20",2565,75280,2112,41565,453,33715,0,0,1216,27798,1342,23701,1217,51499,"California",260800,0.0908780674846626,128288,0.823,24612,0.158
"2830","marin",2830,"2021-02-21",1285,76565,1092,42657,193,33908,0,0,909,28335,372,24073,909,52408,"California",260800,0.0923044478527607,128288,0.823,24612,0.158
"2831","marin",2831,"2021-02-22",1828,78393,1408,44065,420,34328,0,0,1216,28941,610,24683,1216,53624,"California",260800,0.0946434049079755,128288,0.823,24612,0.158
"2832","marin",2832,"2021-02-23",2836,81229,1616,45681,1220,35548,0,0,1908,29932,918,25601,1909,55533,"California",260800,0.0981633435582822,128288,0.823,24612,0.158
"2833","marin",2833,"2021-02-24",3511,84740,1610,47291,1901,37449,0,0,2251,30931,1253,26854,2252,57785,"California",260800,0.102967791411043,128288,0.823,24612,0.158
"2834","marin",2834,"2021-02-25",3932,88672,1810,49101,2122,39571,0,0,2774,32555,1151,28005,2775,60560,"California",260800,0.107381134969325,128288,0.823,24612,0.158
"2835","marin",2835,"2021-02-26",3494,92166,1890,50991,1604,41175,0,0,2535,34144,947,28952,2536,63096,"California",260800,0.11101226993865,128288,0.823,24612,0.158
"2836","marin",2836,"2021-02-27",2611,94777,1495,52486,1116,42291,0,0,1777,35092,831,29783,1779,64875,"California",260800,0.114198619631902,128288,0.823,24612,0.158
"2837","marin",2837,"2021-02-28",1380,96157,919,53405,461,42752,0,0,1043,35801,334,30117,1043,65918,"California",260800,0.115479294478528,128288,0.823,24612,0.158
"2838","marin",2838,"2021-03-01",2492,98649,1547,54952,945,43697,0,0,1675,36665,811,30928,1675,67593,"California",260800,0.118588957055215,128288,0.823,24612,0.158
"2839","marin",2839,"2021-03-02",2448,101097,1610,56562,837,44534,1,1,1695,37611,750,31678,1696,69289,"California",260800,0.12146472392638,128288,0.823,24612,0.158
"2840","marin",2840,"2021-03-03",4320,105417,2400,58962,1916,46450,4,5,2797,38894,1518,33196,2801,72090,"California",260800,0.12728527607362,128288,0.823,24612,0.158
"2841","marin",2841,"2021-03-04",3349,108766,1653,60615,1695,48145,1,6,2336,40228,1006,34202,2340,74430,"California",260800,0.13114263803681,128288,0.823,24612,0.158
"2842","marin",2842,"2021-03-05",3036,111802,1139,61754,1885,50030,12,18,1780,40768,1252,35454,1792,76222,"California",260800,0.135943251533742,128288,0.823,24612,0.158
"2843","marin",2843,"2021-03-06",3227,115029,2314,64068,835,50865,78,96,2653,42929,569,36023,2730,78952,"California",260800,0.138125,128288,0.823,24612,0.158
"2844","marin",2844,"2021-03-07",1371,116400,1153,65221,194,51059,24,120,981,43548,386,36409,1005,79957,"California",260800,0.139605061349693,128288,0.823,24612,0.158
"2845","marin",2845,"2021-03-08",1875,118275,1370,66591,388,51447,117,237,1408,44609,464,36873,1525,81482,"California",260800,0.141384202453988,128288,0.823,24612,0.158
"2846","marin",2846,"2021-03-09",2100,120375,1219,67810,774,52221,107,344,1427,45472,671,37544,1534,83016,"California",260800,0.143957055214724,128288,0.823,24612,0.158
"2847","marin",2847,"2021-03-10",4400,124775,2459,70269,1660,53881,281,625,3173,47705,1223,38767,3456,86472,"California",260800,0.148646472392638,128288,0.823,24612,0.158
"2848","marin",2848,"2021-03-11",4567,129342,1876,72145,2556,56437,135,760,3273,49826,1287,40054,3408,89880,"California",260800,0.153581288343558,128288,0.823,24612,0.158
"2849","marin",2849,"2021-03-12",3978,133320,1538,73683,2084,58521,356,1116,1566,49347,2401,42455,1922,91802,"California",260800,0.162787576687117,128288,0.823,24612,0.158
"2850","marin",2850,"2021-03-13",4096,137416,2859,76542,1165,59686,72,1188,2421,50162,1673,44128,2488,94290,"California",260800,0.16920245398773,128288,0.823,24612,0.158
"2851","marin",2851,"2021-03-14",2274,139690,1097,77639,1060,60746,117,1305,727,49460,1545,45673,843,95133,"California",260800,0.175126533742331,128288,0.823,24612,0.158
"2852","marin",2852,"2021-03-15",3233,142923,1766,79405,1419,62165,48,1353,1220,48725,2002,47675,1267,96400,"California",260800,0.182802914110429,128288,0.823,24612,0.158
"2853","marin",2853,"2021-03-16",4302,147225,2315,81720,1623,63788,364,1717,1525,47838,2774,50449,1887,98287,"California",260800,0.193439417177914,128288,0.823,24612,0.158
"2854","marin",2854,"2021-03-17",4178,151403,2267,83987,1867,65655,44,1761,2056,47826,2111,52560,2099,100386,"California",260800,0.201533742331288,128288,0.823,24612,0.158
"2855","marin",2855,"2021-03-18",4484,155887,2259,86246,2150,67805,75,1836,2248,47926,2220,54780,2320,102706,"California",260800,0.210046012269939,128288,0.823,24612,0.158
"2856","marin",2856,"2021-03-19",4467,160354,2282,88528,1966,69771,219,2055,2429,48543,2029,56809,2646,105352,"California",260800,0.217825920245399,128288,0.823,24612,0.158
"2857","marin",2857,"2021-03-20",3574,163928,1980,90508,1480,71251,114,2169,2032,49155,1535,58344,2147,107499,"California",260800,0.223711656441718,128288,0.823,24612,0.158
"2858","marin",2858,"2021-03-21",1536,165464,1131,91639,380,71631,25,2194,800,49246,734,59078,825,108324,"California",260800,0.226526073619632,128288,0.823,24612,0.158
"2859","marin",2859,"2021-03-22",2470,167934,2136,93775,169,71800,165,2359,994,48934,1471,60549,1159,109483,"California",260800,0.232166411042945,128288,0.823,24612,0.158
"2860","marin",2860,"2021-03-23",4247,172181,2199,95974,1918,73718,130,2489,1932,48687,2309,62858,2062,111545,"California",260800,0.241019938650307,128288,0.823,24612,0.158
"2861","marin",2861,"2021-03-24",4422,176603,2899,98873,1419,75137,104,2593,1802,47982,2609,65467,1904,113449,"California",260800,0.251023773006135,128288,0.823,24612,0.158
"2862","marin",2862,"2021-03-25",4643,181246,2838,101711,1737,76874,68,2661,2268,47954,2362,67829,2334,115783,"California",260800,0.260080521472393,128288,0.823,24612,0.158
"2863","marin",2863,"2021-03-26",4286,185532,2326,104037,1746,78620,214,2875,2419,48737,1850,69679,2633,118416,"California",260800,0.267174079754601,128288,0.823,24612,0.158
"2864","marin",2864,"2021-03-27",3697,189229,2653,106690,1025,79645,19,2894,1147,47364,2540,72219,1167,119583,"California",260800,0.276913343558282,128288,0.823,24612,0.158
"2865","marin",2865,"2021-03-28",2380,191609,1719,108409,655,80300,6,2900,1104,47204,1270,73489,1110,120693,"California",260800,0.281782975460123,128288,0.823,24612,0.158
"2866","marin",2866,"2021-03-29",2686,194295,2092,110501,569,80869,25,2925,1185,46915,1499,74988,1210,121903,"California",260800,0.287530674846626,128288,0.823,24612,0.158
"2867","marin",2867,"2021-03-30",4654,198949,3644,114145,977,81846,33,2958,3056,48409,1595,76583,3089,124992,"California",260800,0.293646472392638,128288,0.823,24612,0.158
"2868","marin",2868,"2021-03-31",5798,204747,4107,118252,1642,83488,49,3007,2577,47825,3210,79793,2626,127618,"California",260800,0.305954754601227,128288,0.823,24612,0.158
"2869","marin",2869,"2021-04-01",4403,209150,2271,120523,1881,85369,251,3258,2121,47922,2274,82067,2371,129989,"California",260800,0.314674079754601,128288,0.823,24612,0.158
"2870","marin",2870,"2021-04-02",3697,212847,1835,122358,1499,86868,363,3621,1978,48548,1712,83779,2338,132327,"California",260800,0.321238496932515,128288,0.823,24612,0.158
"2871","marin",2871,"2021-04-03",3847,216694,2524,124882,954,87822,369,3990,1471,48025,2365,86144,1842,134169,"California",260800,0.330306748466258,128288,0.823,24612,0.158
"2872","marin",2872,"2021-04-04",1638,218332,1230,126112,204,88026,204,4194,1195,48983,441,86585,1399,135568,"California",260800,0.331997699386503,128288,0.823,24612,0.158
"2873","marin",2873,"2021-04-05",2198,220530,1527,127639,300,88326,371,4565,1269,49697,924,87509,1638,137206,"California",260800,0.335540644171779,128288,0.823,24612,0.158
"2874","marin",2874,"2021-04-06",3948,224478,2110,129749,1288,89614,550,5115,2194,50689,1749,89258,2741,139947,"California",260800,0.342246932515337,128288,0.823,24612,0.158
"2875","marin",2875,"2021-04-07",3914,228392,1981,131730,1294,90908,639,5754,1428,50277,2479,91737,2067,142014,"California",260800,0.351752300613497,128288,0.823,24612,0.158
"2876","marin",2876,"2021-04-08",5003,233395,1957,133687,2439,93347,607,6361,2287,50454,2707,94444,2884,144898,"California",260800,0.362131901840491,128288,0.823,24612,0.158
"2877","marin",2877,"2021-04-09",3954,237349,1541,135228,1687,95034,726,7087,1303,49833,2646,97090,2025,146923,"California",260800,0.372277607361963,128288,0.823,24612,0.158
"2878","marin",2878,"2021-04-10",3187,240536,1462,136690,1292,96326,433,7520,1438,49963,1739,98829,1869,148792,"California",260800,0.378945552147239,128288,0.823,24612,0.158
"2879","marin",2879,"2021-04-11",1060,241596,804,137494,94,96420,162,7682,476,50018,582,99411,637,149429,"California",260800,0.381177147239264,128288,0.823,24612,0.158
"2880","marin",2880,"2021-04-12",1737,243333,1237,138731,340,96760,160,7842,926,50297,808,100219,1087,150516,"California",260800,0.384275306748466,128288,0.823,24612,0.158
"2881","marin",2881,"2021-04-13",3707,247040,2267,140998,1433,98193,7,7849,1343,49293,2354,102573,1350,151866,"California",260800,0.393301380368098,128288,0.823,24612,0.158
"2882","marin",2882,"2021-04-14",4149,251189,2477,143475,1670,99863,2,7851,1701,48554,2441,105014,1702,153568,"California",260800,0.402661042944785,128288,0.823,24612,0.158
"2883","marin",2883,"2021-04-15",5557,256746,3936,147411,1621,101484,0,7851,3183,49377,2361,107375,3184,156752,"California",260800,0.411713957055215,128288,0.823,24612,0.158
"2884","marin",2884,"2021-04-16",4240,260986,2234,149645,2003,103487,3,7854,2061,49274,2167,109542,2064,158816,"California",260800,0.420023006134969,128288,0.823,24612,0.158
"2885","marin",2885,"2021-04-17",3520,264506,2151,151796,1369,104856,0,7854,1759,49277,1756,111298,1759,160575,"California",260800,0.426756134969325,128288,0.823,24612,0.158
"2886","marin",2886,"2021-04-18",3200,267706,3098,154894,102,104958,0,7854,2564,51208,633,111931,2564,163139,"California",260800,0.429183282208589,128288,0.823,24612,0.158
"2887","marin",2887,"2021-04-19",2018,269724,1849,156743,169,105127,0,7854,1161,51517,854,112785,1163,164302,"California",260800,0.43245782208589,128288,0.823,24612,0.158
"2888","marin",2888,"2021-04-20",3691,273415,2552,159295,1139,106266,0,7854,1476,50783,2210,114995,1476,165778,"California",260800,0.440931748466258,128288,0.823,24612,0.158
"2889","marin",2889,"2021-04-21",3996,277411,2937,162232,1056,107322,3,7857,1369,49540,2613,117608,1370,167148,"California",260800,0.450950920245399,128288,0.823,24612,0.158
"2890","marin",2890,"2021-04-22",4208,281619,3207,165439,1001,108323,0,7857,1482,48307,2718,120326,1485,168633,"California",260800,0.461372699386503,128288,0.823,24612,0.158
"2891","marin",2891,"2021-04-23",3225,284844,1825,167264,1400,109723,0,7857,1237,47562,1983,122309,1238,169871,"California",260800,0.468976226993865,128288,0.823,24612,0.158
"2892","marin",2892,"2021-04-24",2518,287362,1691,168955,826,110549,1,7858,925,46904,1584,123893,926,170797,"California",260800,0.475049846625767,128288,0.823,24612,0.158
"2893","marin",2893,"2021-04-25",1388,288750,1271,170226,117,110666,0,7858,312,46146,1070,124963,312,171109,"California",260800,0.479152607361963,128288,0.823,24612,0.158
"2894","marin",2894,"2021-04-26",1514,290264,1322,171548,189,110855,3,7861,337,45312,1175,126138,341,171450,"California",260800,0.483657975460123,128288,0.823,24612,0.158
"2895","marin",2895,"2021-04-27",2918,293182,2134,173682,746,111601,38,7899,939,44316,1969,128107,973,172423,"California",260800,0.49120782208589,128288,0.823,24612,0.158
"2896","marin",2896,"2021-04-28",2286,295468,1576,175258,663,112264,47,7946,718,43515,1565,129672,764,173187,"California",260800,0.497208588957055,128288,0.823,24612,0.158
"2897","marin",2897,"2021-04-29",2874,298342,1968,177226,844,113108,62,8008,789,42288,2078,131750,851,174038,"California",260800,0.505176380368098,128288,0.823,24612,0.158
"2898","marin",2898,"2021-04-30",1948,300290,1272,178498,588,113696,88,8096,696,41827,1245,132995,784,174822,"California",260800,0.509950153374233,128288,0.823,24612,0.158
"2899","marin",2899,"2021-05-01",1808,302098,1003,179501,782,114478,23,8119,524,41098,1276,134271,547,175369,"California",260800,0.514842791411043,128288,0.823,24612,0.158
"2900","marin",2900,"2021-05-02",724,302822,587,180088,108,114586,29,8148,202,40810,518,134789,230,175599,"California",260800,0.516828987730061,128288,0.823,24612,0.158
"2901","marin",2901,"2021-05-03",1212,304034,988,181076,170,114756,54,8202,264,40182,945,135734,317,175916,"California",260800,0.52045245398773,128288,0.823,24612,0.158
"2902","marin",2902,"2021-05-04",2923,306957,1965,183041,868,115624,90,8292,476,38307,2441,138175,566,176482,"California",260800,0.529812116564417,128288,0.823,24612,0.158
"2903","marin",2903,"2021-05-05",2702,309659,1986,185027,597,116221,119,8411,439,36607,2258,140433,558,177040,"California",260800,0.53847009202454,128288,0.823,24612,0.158
"2904","marin",2904,"2021-05-06",3248,312907,2527,187554,635,116856,86,8497,426,34305,2814,143247,512,177552,"California",260800,0.549259969325153,128288,0.823,24612,0.158
"2905","marin",2905,"2021-05-07",2042,314949,1544,189098,408,117264,90,8587,394,33146,1641,144888,482,178034,"California",260800,0.555552147239264,128288,0.823,24612,0.158
"2906","marin",2906,"2021-05-08",2472,317421,1859,190957,494,117758,119,8706,348,31497,2116,147004,467,178501,"California",260800,0.563665644171779,128288,0.823,24612,0.158
"2907","mariposa",2907,"2020-12-17",37,37,37,37,0,0,0,0,39,39,0,0,39,39,"California",17795,0,4088,0.398,5950,0.579
"2908","mariposa",2908,"2020-12-18",55,92,55,92,0,0,0,0,56,95,0,0,56,95,"California",17795,0,4088,0.398,5950,0.579
"2909","mariposa",2909,"2020-12-20",2,94,2,94,0,0,0,0,2,97,0,0,2,97,"California",17795,0,4088,0.398,5950,0.579
"2910","mariposa",2910,"2020-12-21",47,141,47,141,0,0,0,0,52,149,0,0,52,149,"California",17795,0,4088,0.398,5950,0.579
"2911","mariposa",2911,"2020-12-22",5,146,5,146,0,0,0,0,5,154,0,0,5,154,"California",17795,0,4088,0.398,5950,0.579
"2912","mariposa",2912,"2020-12-23",17,163,17,163,0,0,0,0,17,171,0,0,17,171,"California",17795,0,4088,0.398,5950,0.579
"2913","mariposa",2913,"2020-12-24",1,164,0,163,1,1,0,0,0,171,0,0,0,171,"California",17795,0,4088,0.398,5950,0.579
"2914","mariposa",2914,"2020-12-26",1,165,1,164,0,1,0,0,1,172,0,0,1,172,"California",17795,0,4088,0.398,5950,0.579
"2915","mariposa",2915,"2020-12-27",1,166,0,164,1,2,0,0,1,173,0,0,1,173,"California",17795,0,4088,0.398,5950,0.579
"2916","mariposa",2916,"2020-12-28",6,172,3,167,3,5,0,0,6,179,0,0,6,179,"California",17795,0,4088,0.398,5950,0.579
"2917","mariposa",2917,"2020-12-29",33,205,3,170,30,35,0,0,33,212,0,0,33,212,"California",17795,0,4088,0.398,5950,0.579
"2918","mariposa",2918,"2020-12-30",25,230,4,174,21,56,0,0,25,237,0,0,25,237,"California",17795,0,4088,0.398,5950,0.579
"2919","mariposa",2919,"2020-12-31",16,246,0,174,16,72,0,0,16,253,0,0,16,253,"California",17795,0,4088,0.398,5950,0.579
"2920","mariposa",2920,"2021-01-02",1,247,1,175,0,72,0,0,1,254,0,0,1,254,"California",17795,0,4088,0.398,5950,0.579
"2921","mariposa",2921,"2021-01-04",8,255,1,176,7,79,0,0,8,262,0,0,8,262,"California",17795,0,4088,0.398,5950,0.579
"2922","mariposa",2922,"2021-01-05",24,279,14,190,10,89,0,0,14,266,10,10,14,276,"California",17795,0.000561955605507165,4088,0.398,5950,0.579
"2923","mariposa",2923,"2021-01-06",6,285,3,193,3,92,0,0,3,266,3,13,3,279,"California",17795,0.000730542287159314,4088,0.398,5950,0.579
"2924","mariposa",2924,"2021-01-07",51,336,46,239,5,97,0,0,5,225,46,59,5,284,"California",17795,0.00331553807249227,4088,0.398,5950,0.579
"2925","mariposa",2925,"2021-01-08",108,444,79,318,29,126,0,0,33,183,75,134,33,317,"California",17795,0.00753020511379601,4088,0.398,5950,0.579
"2926","mariposa",2926,"2021-01-09",1,445,0,318,1,127,0,0,1,184,0,134,1,318,"California",17795,0.00753020511379601,4088,0.398,5950,0.579
"2927","mariposa",2927,"2021-01-11",31,476,10,328,21,148,0,0,23,199,8,142,23,341,"California",17795,0.00797976959820174,4088,0.398,5950,0.579
"2928","mariposa",2928,"2021-01-12",19,495,4,332,15,163,0,0,15,210,4,146,15,356,"California",17795,0.00820455184040461,4088,0.398,5950,0.579
"2929","mariposa",2929,"2021-01-13",21,516,4,336,17,180,0,0,18,225,3,149,18,374,"California",17795,0.00837313852205676,4088,0.398,5950,0.579
"2930","mariposa",2930,"2021-01-14",73,589,7,343,66,246,0,0,67,286,6,155,67,441,"California",17795,0.00871031188536106,4088,0.398,5950,0.579
"2931","mariposa",2931,"2021-01-15",66,655,26,369,40,286,0,0,56,332,10,165,56,497,"California",17795,0.00927226749086822,4088,0.398,5950,0.579
"2932","mariposa",2932,"2021-01-16",14,669,2,371,12,298,0,0,13,344,1,166,13,510,"California",17795,0.00932846305141894,4088,0.398,5950,0.579
"2933","mariposa",2933,"2021-01-17",2,671,0,371,2,300,0,0,2,346,0,166,2,512,"California",17795,0.00932846305141894,4088,0.398,5950,0.579
"2934","mariposa",2934,"2021-01-18",3,674,3,374,0,300,0,0,1,345,2,168,1,513,"California",17795,0.00944085417252037,4088,0.398,5950,0.579
"2935","mariposa",2935,"2021-01-19",8,682,4,378,4,304,0,0,5,348,2,170,5,518,"California",17795,0.0095532452936218,4088,0.398,5950,0.579
"2936","mariposa",2936,"2021-01-20",23,705,1,379,22,326,0,0,22,369,1,171,22,540,"California",17795,0.00960944085417252,4088,0.398,5950,0.579
"2937","mariposa",2937,"2021-01-21",65,770,7,386,58,384,0,0,61,426,4,175,61,601,"California",17795,0.00983422309637539,4088,0.398,5950,0.579
"2938","mariposa",2938,"2021-01-22",56,826,2,388,54,438,0,0,56,482,0,175,56,657,"California",17795,0.00983422309637539,4088,0.398,5950,0.579
"2939","mariposa",2939,"2021-01-23",116,942,2,390,114,552,0,0,115,596,1,176,115,772,"California",17795,0.0098904186569261,4088,0.398,5950,0.579
"2940","mariposa",2940,"2021-01-24",2,944,2,392,0,552,0,0,2,598,0,176,2,774,"California",17795,0.0098904186569261,4088,0.398,5950,0.579
"2941","mariposa",2941,"2021-01-25",4,948,1,393,3,555,0,0,0,594,4,180,0,774,"California",17795,0.010115200899129,4088,0.398,5950,0.579
"2942","mariposa",2942,"2021-01-26",36,984,4,397,32,587,0,0,4,570,32,212,8,782,"California",17795,0.0119134588367519,4088,0.398,5950,0.579
"2943","mariposa",2943,"2021-01-27",23,1007,1,398,22,609,0,0,13,573,10,222,13,795,"California",17795,0.0124754144422591,4088,0.398,5950,0.579
"2944","mariposa",2944,"2021-01-28",126,1133,3,401,123,732,0,0,113,674,12,234,113,908,"California",17795,0.0131497611688677,4088,0.398,5950,0.579
"2945","mariposa",2945,"2021-01-29",84,1217,22,423,62,794,0,0,83,756,1,235,83,991,"California",17795,0.0132059567294184,4088,0.398,5950,0.579
"2946","mariposa",2946,"2021-01-30",9,1226,1,424,8,802,0,0,8,763,1,236,8,999,"California",17795,0.0132621522899691,4088,0.398,5950,0.579
"2947","mariposa",2947,"2021-01-31",1,1227,0,424,1,803,0,0,1,764,0,236,1,1000,"California",17795,0.0132621522899691,4088,0.398,5950,0.579
"2948","mariposa",2948,"2021-02-01",87,1314,30,454,57,860,0,0,66,809,21,257,66,1066,"California",17795,0.0144422590615341,4088,0.398,5950,0.579
"2949","mariposa",2949,"2021-02-02",15,1329,3,457,12,872,0,0,9,812,6,263,9,1075,"California",17795,0.0147794324248384,4088,0.398,5950,0.579
"2950","mariposa",2950,"2021-02-03",20,1349,1,458,19,891,0,0,14,820,6,269,14,1089,"California",17795,0.0151166057881427,4088,0.398,5950,0.579
"2951","mariposa",2951,"2021-02-04",97,1446,8,466,89,980,0,0,92,909,4,273,93,1182,"California",17795,0.0153413880303456,4088,0.398,5950,0.579
"2952","mariposa",2952,"2021-02-05",189,1635,5,471,184,1164,0,0,163,1046,26,299,163,1345,"California",17795,0.0168024726046642,4088,0.398,5950,0.579
"2953","mariposa",2953,"2021-02-06",11,1646,4,475,7,1171,0,0,10,1055,1,300,10,1355,"California",17795,0.0168586681652149,4088,0.398,5950,0.579
"2954","mariposa",2954,"2021-02-07",1,1647,0,475,1,1172,0,0,1,1056,0,300,1,1356,"California",17795,0.0168586681652149,4088,0.398,5950,0.579
"2955","mariposa",2955,"2021-02-08",40,1687,2,477,38,1210,0,0,21,1058,19,319,21,1377,"California",17795,0.0179263838156786,4088,0.398,5950,0.579
"2956","mariposa",2956,"2021-02-09",43,1730,25,502,18,1228,0,0,37,1089,6,325,37,1414,"California",17795,0.0182635571789829,4088,0.398,5950,0.579
"2957","mariposa",2957,"2021-02-10",28,1758,5,507,23,1251,0,0,17,1102,10,335,23,1437,"California",17795,0.01882551278449,4088,0.398,5950,0.579
"2958","mariposa",2958,"2021-02-11",375,2133,5,512,370,1621,0,0,361,1452,14,349,364,1801,"California",17795,0.0196122506322001,4088,0.398,5950,0.579
"2959","mariposa",2959,"2021-02-12",184,2317,8,520,176,1797,0,0,141,1550,43,392,141,1942,"California",17795,0.0220286597358809,4088,0.398,5950,0.579
"2960","mariposa",2960,"2021-02-13",11,2328,3,523,8,1805,0,0,9,1557,2,394,9,1951,"California",17795,0.0221410508569823,4088,0.398,5950,0.579
"2961","mariposa",2961,"2021-02-14",8,2336,4,527,4,1809,0,0,5,1559,3,397,5,1956,"California",17795,0.0223096375386344,4088,0.398,5950,0.579
"2962","mariposa",2962,"2021-02-15",9,2345,3,530,6,1815,0,0,7,1564,2,399,7,1963,"California",17795,0.0224220286597359,4088,0.398,5950,0.579
"2963","mariposa",2963,"2021-02-16",57,2402,34,564,23,1838,0,0,34,1575,23,422,34,1997,"California",17795,0.0237145265524024,4088,0.398,5950,0.579
"2964","mariposa",2964,"2021-02-17",36,2438,8,572,28,1866,0,0,27,1595,8,430,28,2025,"California",17795,0.0241640910368081,4088,0.398,5950,0.579
"2965","mariposa",2965,"2021-02-18",57,2495,7,579,50,1916,0,0,20,1578,37,467,20,2045,"California",17795,0.0262433267771846,4088,0.398,5950,0.579
"2966","mariposa",2966,"2021-02-19",82,2577,3,582,79,1995,0,0,77,1650,5,472,77,2122,"California",17795,0.0265243045799382,4088,0.398,5950,0.579
"2967","mariposa",2967,"2021-02-20",252,2829,4,586,248,2243,0,0,222,1843,29,501,222,2344,"California",17795,0.028153975835909,4088,0.398,5950,0.579
"2968","mariposa",2968,"2021-02-21",236,3065,3,589,233,2476,0,0,235,2077,1,502,235,2579,"California",17795,0.0282101713964597,4088,0.398,5950,0.579
"2969","mariposa",2969,"2021-02-22",23,3088,7,596,16,2492,0,0,21,2096,2,504,21,2600,"California",17795,0.0283225625175611,4088,0.398,5950,0.579
"2970","mariposa",2970,"2021-02-23",42,3130,36,632,6,2498,0,0,25,2104,17,521,25,2625,"California",17795,0.0292778870469233,4088,0.398,5950,0.579
"2971","mariposa",2971,"2021-02-24",20,3150,3,635,17,2515,0,0,8,2101,11,532,8,2633,"California",17795,0.0298960382129812,4088,0.398,5950,0.579
"2972","mariposa",2972,"2021-02-25",17,3167,8,643,9,2524,0,0,11,2106,6,538,11,2644,"California",17795,0.0302332115762855,4088,0.398,5950,0.579
"2973","mariposa",2973,"2021-02-26",421,3588,7,650,414,2938,0,0,360,2406,61,599,361,3005,"California",17795,0.0336611407698792,4088,0.398,5950,0.579
"2974","mariposa",2974,"2021-02-27",171,3759,5,655,166,3104,0,0,160,2555,11,610,160,3165,"California",17795,0.0342792919359371,4088,0.398,5950,0.579
"2975","mariposa",2975,"2021-02-28",2,3761,1,656,1,3105,0,0,0,2553,2,612,0,3165,"California",17795,0.0343916830570385,4088,0.398,5950,0.579
"2976","mariposa",2976,"2021-03-01",82,3843,26,682,56,3161,0,0,17,2506,64,676,17,3182,"California",17795,0.0379881989322843,4088,0.398,5950,0.579
"2977","mariposa",2977,"2021-03-02",21,3864,14,696,7,3168,0,0,11,2508,9,685,11,3193,"California",17795,0.0384939589772408,4088,0.398,5950,0.579
"2978","mariposa",2978,"2021-03-03",70,3934,5,701,65,3233,0,0,66,2571,4,689,67,3260,"California",17795,0.0387187412194437,4088,0.398,5950,0.579
"2979","mariposa",2979,"2021-03-04",37,3971,9,710,28,3261,0,0,20,2575,17,706,21,3281,"California",17795,0.0396740657488058,4088,0.398,5950,0.579
"2980","mariposa",2980,"2021-03-05",54,4025,9,719,45,3306,0,0,38,2602,16,722,43,3324,"California",17795,0.0405731947176173,4088,0.398,5950,0.579
"2981","mariposa",2981,"2021-03-06",15,4040,6,725,9,3315,0,0,7,2601,8,730,7,3331,"California",17795,0.041022759202023,4088,0.398,5950,0.579
"2982","mariposa",2982,"2021-03-07",1,4041,1,726,0,3315,0,0,0,2600,1,731,0,3331,"California",17795,0.0410789547625738,4088,0.398,5950,0.579
"2983","mariposa",2983,"2021-03-08",38,4079,4,730,23,3338,11,11,9,2591,29,760,20,3351,"California",17795,0.0427086260185445,4088,0.398,5950,0.579
"2984","mariposa",2984,"2021-03-09",45,4124,18,748,17,3355,10,21,14,2584,31,791,24,3375,"California",17795,0.0444506883956167,4088,0.398,5950,0.579
"2985","mariposa",2985,"2021-03-10",29,4153,9,757,10,3365,10,31,9,2583,20,811,19,3394,"California",17795,0.0455745996066311,4088,0.398,5950,0.579
"2986","mariposa",2986,"2021-03-11",467,4620,6,763,442,3807,19,50,224,2587,242,1053,246,3640,"California",17795,0.0591739252599045,4088,0.398,5950,0.579
"2987","mariposa",2987,"2021-03-12",254,4874,8,771,219,4026,27,77,114,2587,140,1193,140,3780,"California",17795,0.0670413037370048,4088,0.398,5950,0.579
"2988","mariposa",2988,"2021-03-13",32,4906,6,777,11,4037,15,92,11,2591,21,1214,25,3805,"California",17795,0.0682214105085698,4088,0.398,5950,0.579
"2989","mariposa",2989,"2021-03-14",17,4923,2,779,4,4041,11,103,3,2591,14,1228,14,3819,"California",17795,0.0690081483562799,4088,0.398,5950,0.579
"2990","mariposa",2990,"2021-03-15",76,4999,7,786,31,4072,38,141,31,2615,45,1273,69,3888,"California",17795,0.0715369485810621,4088,0.398,5950,0.579
"2991","mariposa",2991,"2021-03-16",82,5081,32,818,15,4087,35,176,24,2616,58,1331,59,3947,"California",17795,0.0747962910930036,4088,0.398,5950,0.579
"2992","mariposa",2992,"2021-03-17",71,5152,10,828,53,4140,8,184,51,2656,19,1350,59,4006,"California",17795,0.0758640067434673,4088,0.398,5950,0.579
"2993","mariposa",2993,"2021-03-18",66,5218,15,843,41,4181,10,194,41,2682,25,1375,51,4057,"California",17795,0.0772688957572352,4088,0.398,5950,0.579
"2994","mariposa",2994,"2021-03-19",338,5556,11,854,322,4503,5,199,303,2955,35,1410,308,4365,"California",17795,0.0792357403765103,4088,0.398,5950,0.579
"2995","mariposa",2995,"2021-03-20",426,5982,5,859,419,4922,2,201,46,2624,380,1790,49,4414,"California",17795,0.100590053385783,4088,0.398,5950,0.579
"2996","mariposa",2996,"2021-03-21",14,5996,8,867,5,4927,1,202,9,2630,4,1794,10,4424,"California",17795,0.100814835627985,4088,0.398,5950,0.579
"2997","mariposa",2997,"2021-03-22",36,6032,7,874,21,4948,8,210,24,2651,12,1806,33,4457,"California",17795,0.101489182354594,4088,0.398,5950,0.579
"2998","mariposa",2998,"2021-03-23",53,6085,33,907,10,4958,10,220,32,2672,21,1827,42,4499,"California",17795,0.102669289126159,4088,0.398,5950,0.579
"2999","mariposa",2999,"2021-03-24",55,6140,5,912,48,5006,2,222,50,2719,5,1832,52,4551,"California",17795,0.102950266928913,4088,0.398,5950,0.579
"3000","mariposa",3000,"2021-03-25",73,6213,15,927,50,5056,8,230,53,2760,20,1852,61,4612,"California",17795,0.104074178139927,4088,0.398,5950,0.579
"3001","mariposa",3001,"2021-03-26",486,6699,9,936,476,5532,1,231,250,2775,236,2088,251,4863,"California",17795,0.117336330429896,4088,0.398,5950,0.579
"3002","mariposa",3002,"2021-03-27",225,6924,8,944,217,5749,0,231,90,2732,135,2223,92,4955,"California",17795,0.124922731104243,4088,0.398,5950,0.579
"3003","mariposa",3003,"2021-03-28",5,6929,0,944,2,5751,3,234,1,2732,4,2227,4,4959,"California",17795,0.125147513346446,4088,0.398,5950,0.579
"3004","mariposa",3004,"2021-03-29",19,6948,6,950,13,5764,0,234,12,2737,7,2234,12,4971,"California",17795,0.125540882270301,4088,0.398,5950,0.579
"3005","mariposa",3005,"2021-03-30",36,6984,13,963,7,5771,16,250,13,2743,23,2257,29,5000,"California",17795,0.126833380162967,4088,0.398,5950,0.579
"3006","mariposa",3006,"2021-03-31",89,7073,16,979,66,5837,7,257,69,2799,20,2277,76,5076,"California",17795,0.127957291373981,4088,0.398,5950,0.579
"3007","mariposa",3007,"2021-04-01",53,7126,9,988,36,5873,8,265,33,2820,20,2297,41,5117,"California",17795,0.129081202584996,4088,0.398,5950,0.579
"3008","mariposa",3008,"2021-04-02",347,7473,11,999,334,6207,2,267,307,3090,39,2336,309,5426,"California",17795,0.131272829446474,4088,0.398,5950,0.579
"3009","mariposa",3009,"2021-04-03",10,7483,7,1006,3,6210,0,267,5,3090,5,2341,5,5431,"California",17795,0.131553807249227,4088,0.398,5950,0.579
"3010","mariposa",3010,"2021-04-04",2,7485,1,1007,0,6210,1,268,0,3089,2,2343,1,5432,"California",17795,0.131666198370329,4088,0.398,5950,0.579
"3011","mariposa",3011,"2021-04-05",32,7517,23,1030,6,6216,3,271,16,3092,16,2359,19,5451,"California",17795,0.13256532733914,4088,0.398,5950,0.579
"3012","mariposa",3012,"2021-04-06",44,7561,20,1050,8,6224,16,287,14,3093,29,2388,30,5481,"California",17795,0.134194998595111,4088,0.398,5950,0.579
"3013","mariposa",3013,"2021-04-07",97,7658,6,1056,72,6296,19,306,28,3071,69,2457,47,5528,"California",17795,0.13807249227311,4088,0.398,5950,0.579
"3014","mariposa",3014,"2021-04-08",275,7933,13,1069,243,6539,19,325,140,3098,133,2590,160,5688,"California",17795,0.145546501826356,4088,0.398,5950,0.579
"3015","mariposa",3015,"2021-04-09",37,7970,9,1078,13,6552,15,340,10,3096,27,2617,25,5713,"California",17795,0.147063781961225,4088,0.398,5950,0.579
"3016","mariposa",3016,"2021-04-10",203,8173,3,1081,190,6742,10,350,188,3280,13,2630,197,5910,"California",17795,0.147794324248384,4088,0.398,5950,0.579
"3017","mariposa",3017,"2021-04-11",125,8298,4,1085,119,6861,2,352,58,3274,67,2697,61,5971,"California",17795,0.151559426805282,4088,0.398,5950,0.579
"3018","mariposa",3018,"2021-04-12",42,8340,13,1098,27,6888,2,354,13,3260,29,2726,15,5986,"California",17795,0.153189098061253,4088,0.398,5950,0.579
"3019","mariposa",3019,"2021-04-13",53,8393,45,1143,8,6896,0,354,34,3275,19,2745,34,6020,"California",17795,0.154256813711717,4088,0.398,5950,0.579
"3020","mariposa",3020,"2021-04-14",112,8505,7,1150,105,7001,0,354,58,3280,53,2798,58,6078,"California",17795,0.157235178420905,4088,0.398,5950,0.579
"3021","mariposa",3021,"2021-04-15",57,8562,17,1167,40,7041,0,354,42,3310,12,2810,42,6120,"California",17795,0.157909525147513,4088,0.398,5950,0.579
"3022","mariposa",3022,"2021-04-16",381,8943,11,1178,370,7411,0,354,106,3141,275,3085,106,6226,"California",17795,0.17336330429896,4088,0.398,5950,0.579
"3023","mariposa",3023,"2021-04-17",10,8953,5,1183,5,7416,0,354,7,3145,3,3088,7,6233,"California",17795,0.173531890980613,4088,0.398,5950,0.579
"3024","mariposa",3024,"2021-04-18",6,8959,0,1183,6,7422,0,354,3,3145,3,3091,3,6236,"California",17795,0.173700477662265,4088,0.398,5950,0.579
"3025","mariposa",3025,"2021-04-19",54,9013,23,1206,31,7453,0,354,27,3147,25,3116,27,6263,"California",17795,0.175105366676033,4088,0.398,5950,0.579
"3026","mariposa",3026,"2021-04-20",62,9075,49,1255,13,7466,0,354,39,3165,21,3137,39,6302,"California",17795,0.176285473447598,4088,0.398,5950,0.579
"3027","mariposa",3027,"2021-04-21",88,9163,12,1267,76,7542,0,354,40,3158,47,3184,40,6342,"California",17795,0.178926664793481,4088,0.398,5950,0.579
"3028","mariposa",3028,"2021-04-22",44,9207,8,1275,36,7578,0,354,36,3187,7,3191,36,6378,"California",17795,0.179320033717336,4088,0.398,5950,0.579
"3029","mariposa",3029,"2021-04-23",314,9521,69,1344,245,7823,0,354,145,3164,169,3360,146,6524,"California",17795,0.188817083450407,4088,0.398,5950,0.579
"3030","mariposa",3030,"2021-04-24",105,9626,10,1354,95,7918,0,354,42,3144,62,3422,42,6566,"California",17795,0.192301208204552,4088,0.398,5950,0.579
"3031","mariposa",3031,"2021-04-26",12,9638,9,1363,3,7921,0,354,2,3136,10,3432,2,6568,"California",17795,0.192863163810059,4088,0.398,5950,0.579
"3032","mariposa",3032,"2021-04-27",29,9667,15,1378,13,7934,1,355,14,3140,11,3443,15,6583,"California",17795,0.193481314976117,4088,0.398,5950,0.579
"3033","mariposa",3033,"2021-04-28",73,9740,13,1391,53,7987,7,362,28,3130,45,3488,35,6618,"California",17795,0.196010115200899,4088,0.398,5950,0.579
"3034","mariposa",3034,"2021-04-29",84,9824,12,1403,71,8058,1,363,79,3205,5,3493,80,6698,"California",17795,0.196291093003653,4088,0.398,5950,0.579
"3035","mariposa",3035,"2021-04-30",209,10033,5,1408,199,8257,5,368,63,3127,146,3639,68,6766,"California",17795,0.204495644844057,4088,0.398,5950,0.579
"3036","mariposa",3036,"2021-05-01",1,10034,1,1409,0,8257,0,368,0,3126,1,3640,0,6766,"California",17795,0.204551840404608,4088,0.398,5950,0.579
"3037","mariposa",3037,"2021-05-02",3,10037,2,1411,0,8257,1,369,0,3124,3,3643,1,6767,"California",17795,0.20472042708626,4088,0.398,5950,0.579
"3038","mariposa",3038,"2021-05-03",15,10052,12,1423,2,8259,1,370,7,3125,7,3650,8,6775,"California",17795,0.205113796010115,4088,0.398,5950,0.579
"3039","mariposa",3039,"2021-05-04",50,10102,31,1454,15,8274,4,374,36,3151,14,3664,40,6815,"California",17795,0.205900533857825,4088,0.398,5950,0.579
"3040","mariposa",3040,"2021-05-05",54,10156,8,1462,44,8318,2,376,17,3133,37,3701,19,6834,"California",17795,0.207979769598202,4088,0.398,5950,0.579
"3041","mariposa",3041,"2021-05-06",55,10211,33,1495,16,8334,6,382,36,3156,19,3720,42,6876,"California",17795,0.209047485248665,4088,0.398,5950,0.579
"3042","mariposa",3042,"2021-05-07",25,10236,8,1503,14,8348,3,385,15,3164,10,3730,18,6894,"California",17795,0.209609440854173,4088,0.398,5950,0.579
"3043","mariposa",3043,"2021-05-08",281,10517,4,1507,277,8625,0,385,34,2953,247,3977,36,6930,"California",17795,0.223489744310199,4088,0.398,5950,0.579
"3044","mendocino",3044,"2020-12-17",70,70,70,70,0,0,0,0,70,70,0,0,70,70,"California",88439,0,28782,0.664,13267,0.306
"3045","mendocino",3045,"2020-12-18",85,155,84,154,1,1,0,0,84,154,0,0,84,154,"California",88439,0,28782,0.664,13267,0.306
"3046","mendocino",3046,"2020-12-19",4,159,4,158,0,1,0,0,4,158,0,0,4,158,"California",88439,0,28782,0.664,13267,0.306
"3047","mendocino",3047,"2020-12-20",7,166,7,165,0,1,0,0,7,165,0,0,7,165,"California",88439,0,28782,0.664,13267,0.306
"3048","mendocino",3048,"2020-12-21",241,407,241,406,0,1,0,0,77,242,0,0,77,242,"California",88439,0,28782,0.664,13267,0.306
"3049","mendocino",3049,"2020-12-22",251,658,190,596,61,62,0,0,251,493,0,0,251,493,"California",88439,0,28782,0.664,13267,0.306
"3050","mendocino",3050,"2020-12-23",270,928,47,643,223,285,0,0,269,762,0,0,269,762,"California",88439,0,28782,0.664,13267,0.306
"3051","mendocino",3051,"2020-12-24",49,977,8,651,41,326,0,0,49,811,0,0,49,811,"California",88439,0,28782,0.664,13267,0.306
"3052","mendocino",3052,"2020-12-25",1,978,0,651,1,327,0,0,1,812,0,0,1,812,"California",88439,0,28782,0.664,13267,0.306
"3053","mendocino",3053,"2020-12-26",2,980,2,653,0,327,0,0,2,814,0,0,2,814,"California",88439,0,28782,0.664,13267,0.306
"3054","mendocino",3054,"2020-12-27",1,981,0,653,1,328,0,0,1,815,0,0,1,815,"California",88439,0,28782,0.664,13267,0.306
"3055","mendocino",3055,"2020-12-28",74,1055,9,662,65,393,0,0,74,889,0,0,74,889,"California",88439,0,28782,0.664,13267,0.306
"3056","mendocino",3056,"2020-12-29",122,1177,61,723,61,454,0,0,122,1011,0,0,122,1011,"California",88439,0,28782,0.664,13267,0.306
"3057","mendocino",3057,"2020-12-30",123,1300,68,791,55,509,0,0,123,1134,0,0,123,1134,"California",88439,0,28782,0.664,13267,0.306
"3058","mendocino",3058,"2020-12-31",132,1432,97,888,35,544,0,0,132,1266,0,0,132,1266,"California",88439,0,28782,0.664,13267,0.306
"3059","mendocino",3059,"2021-01-01",8,1440,6,894,2,546,0,0,8,1274,0,0,8,1274,"California",88439,0,28782,0.664,13267,0.306
"3060","mendocino",3060,"2021-01-04",840,2280,19,913,821,1367,0,0,840,2114,0,0,840,2114,"California",88439,0,28782,0.664,13267,0.306
"3061","mendocino",3061,"2021-01-05",71,2351,35,948,36,1403,0,0,58,2159,13,13,58,2172,"California",88439,0.000146993973247097,28782,0.664,13267,0.306
"3062","mendocino",3062,"2021-01-06",155,2506,133,1081,22,1425,0,0,145,2294,10,23,145,2317,"California",88439,0.000260066260360248,28782,0.664,13267,0.306
"3063","mendocino",3063,"2021-01-07",358,2864,238,1319,120,1545,0,0,295,2526,63,86,295,2612,"California",88439,0.000972421669173102,28782,0.664,13267,0.306
"3064","mendocino",3064,"2021-01-08",95,2959,82,1401,13,1558,0,0,41,2514,54,140,42,2654,"California",88439,0.00158301201958412,28782,0.664,13267,0.306
"3065","mendocino",3065,"2021-01-09",10,2969,6,1407,4,1562,0,0,8,2520,2,142,8,2662,"California",88439,0.00160562647700675,28782,0.664,13267,0.306
"3066","mendocino",3066,"2021-01-10",8,2977,8,1415,0,1562,0,0,1,2514,7,149,1,2663,"California",88439,0.00168477707798596,28782,0.664,13267,0.306
"3067","mendocino",3067,"2021-01-11",101,3078,92,1507,9,1571,0,0,43,2500,57,206,43,2706,"California",88439,0.00232928911453092,28782,0.664,13267,0.306
"3068","mendocino",3068,"2021-01-12",385,3463,375,1882,10,1581,0,0,269,2653,116,322,269,2975,"California",88439,0.00364092764504348,28782,0.664,13267,0.306
"3069","mendocino",3069,"2021-01-13",484,3947,145,2027,339,1920,0,0,442,3056,40,362,443,3418,"California",88439,0.00409321679349608,28782,0.664,13267,0.306
"3070","mendocino",3070,"2021-01-14",636,4583,20,2047,616,2536,0,0,627,3674,9,371,627,4045,"California",88439,0.00419498185189792,28782,0.664,13267,0.306
"3071","mendocino",3071,"2021-01-15",1857,6440,859,2906,998,3534,0,0,1852,5522,5,376,1853,5898,"California",88439,0.00425151799545449,28782,0.664,13267,0.306
"3072","mendocino",3072,"2021-01-16",791,7231,50,2956,741,4275,0,0,789,6309,2,378,789,6687,"California",88439,0.00427413245287712,28782,0.664,13267,0.306
"3073","mendocino",3073,"2021-01-17",553,7784,1,2957,552,4827,0,0,552,6860,1,379,552,7239,"California",88439,0.00428543968158844,28782,0.664,13267,0.306
"3074","mendocino",3074,"2021-01-18",488,8272,463,3420,25,4852,0,0,476,7324,12,391,476,7715,"California",88439,0.00442112642612422,28782,0.664,13267,0.306
"3075","mendocino",3075,"2021-01-19",334,8606,148,3568,186,5038,0,0,158,7306,176,567,158,7873,"California",88439,0.00641119867931569,28782,0.664,13267,0.306
"3076","mendocino",3076,"2021-01-20",553,9159,406,3974,147,5185,0,0,447,7650,104,671,448,8321,"California",88439,0.00758715046529246,28782,0.664,13267,0.306
"3077","mendocino",3077,"2021-01-21",537,9696,224,4198,313,5498,0,0,351,7816,185,856,351,8672,"California",88439,0.00967898777688576,28782,0.664,13267,0.306
"3078","mendocino",3078,"2021-01-22",149,9845,58,4256,91,5589,0,0,110,7887,39,895,110,8782,"California",88439,0.0101199696966271,28782,0.664,13267,0.306
"3079","mendocino",3079,"2021-01-23",155,10000,83,4339,72,5661,0,0,149,8030,6,901,149,8931,"California",88439,0.0101878130688949,28782,0.664,13267,0.306
"3080","mendocino",3080,"2021-01-24",5,10005,3,4342,2,5663,0,0,5,8035,0,901,5,8936,"California",88439,0.0101878130688949,28782,0.664,13267,0.306
"3081","mendocino",3081,"2021-01-25",191,10196,18,4360,173,5836,0,0,121,8086,70,971,121,9057,"California",88439,0.010979319078687,28782,0.664,13267,0.306
"3082","mendocino",3082,"2021-01-26",155,10351,55,4415,100,5936,0,0,95,8121,60,1031,95,9152,"California",88439,0.0116577528013659,28782,0.664,13267,0.306
"3083","mendocino",3083,"2021-01-27",440,10791,370,4785,70,6006,0,0,175,8038,258,1289,175,9327,"California",88439,0.0145750178088852,28782,0.664,13267,0.306
"3084","mendocino",3084,"2021-01-28",590,11381,526,5311,64,6070,0,0,495,8439,94,1383,495,9822,"California",88439,0.0156378973077488,28782,0.664,13267,0.306
"3085","mendocino",3085,"2021-01-29",392,11773,351,5662,41,6111,0,0,363,8774,29,1412,364,10186,"California",88439,0.015965806940377,28782,0.664,13267,0.306
"3086","mendocino",3086,"2021-01-30",49,11822,31,5693,18,6129,0,0,42,8809,7,1419,42,10228,"California",88439,0.0160449575413562,28782,0.664,13267,0.306
"3087","mendocino",3087,"2021-01-31",273,12095,2,5695,271,6400,0,0,3,8542,270,1689,3,10231,"California",88439,0.0190979092934113,28782,0.664,13267,0.306
"3088","mendocino",3088,"2021-02-01",381,12476,52,5747,329,6729,0,0,59,8279,322,2011,59,10290,"California",88439,0.0227388369384548,28782,0.664,13267,0.306
"3089","mendocino",3089,"2021-02-02",724,13200,504,6251,220,6949,0,0,365,8285,359,2370,365,10655,"California",88439,0.0267981320458169,28782,0.664,13267,0.306
"3090","mendocino",3090,"2021-02-03",390,13590,205,6456,185,7134,0,0,221,8339,167,2537,221,10876,"California",88439,0.0286864392406065,28782,0.664,13267,0.306
"3091","mendocino",3091,"2021-02-04",624,14214,529,6985,95,7229,0,0,500,8715,124,2661,500,11376,"California",88439,0.0300885356008096,28782,0.664,13267,0.306
"3092","mendocino",3092,"2021-02-05",1300,15514,1212,8197,88,7317,0,0,583,8583,715,3376,583,11959,"California",88439,0.0381732041293999,28782,0.664,13267,0.306
"3093","mendocino",3093,"2021-02-06",559,16073,158,8355,401,7718,0,0,544,9112,15,3391,544,12503,"California",88439,0.0383428125600697,28782,0.664,13267,0.306
"3094","mendocino",3094,"2021-02-07",32,16105,28,8383,4,7722,0,0,32,9144,0,3391,32,12535,"California",88439,0.0383428125600697,28782,0.664,13267,0.306
"3095","mendocino",3095,"2021-02-08",747,16852,715,9098,32,7754,0,0,285,8967,462,3853,285,12820,"California",88439,0.0435667522246972,28782,0.664,13267,0.306
"3096","mendocino",3096,"2021-02-09",141,16993,58,9156,83,7837,0,0,89,9004,52,3905,89,12909,"California",88439,0.0441547281176856,28782,0.664,13267,0.306
"3097","mendocino",3097,"2021-02-10",1487,18480,923,10079,564,8401,0,0,742,9012,738,4643,746,13655,"California",88439,0.0524994629066362,28782,0.664,13267,0.306
"3098","mendocino",3098,"2021-02-11",1142,19622,208,10287,934,9335,0,0,280,8438,862,5505,288,13943,"California",88439,0.0622462940557899,28782,0.664,13267,0.306
"3099","mendocino",3099,"2021-02-12",1408,21030,162,10449,1246,10581,0,0,641,8314,766,6271,642,14585,"California",88439,0.0709076312486573,28782,0.664,13267,0.306
"3100","mendocino",3100,"2021-02-13",496,21526,12,10461,484,11065,0,0,103,8030,392,6663,108,14693,"California",88439,0.0753400649034928,28782,0.664,13267,0.306
"3101","mendocino",3101,"2021-02-14",693,22219,3,10464,690,11755,0,0,134,7605,559,7222,134,14827,"California",88439,0.081660805753118,28782,0.664,13267,0.306
"3102","mendocino",3102,"2021-02-15",330,22549,42,10506,288,12043,0,0,175,7625,155,7377,175,15002,"California",88439,0.0834134262033718,28782,0.664,13267,0.306
"3103","mendocino",3103,"2021-02-16",201,22750,51,10557,150,12193,0,0,130,7684,71,7448,130,15132,"California",88439,0.0842162394418752,28782,0.664,13267,0.306
"3104","mendocino",3104,"2021-02-17",1353,24103,1191,11748,162,12355,0,0,877,8087,474,7922,877,16009,"California",88439,0.0895758658510386,28782,0.664,13267,0.306
"3105","mendocino",3105,"2021-02-18",1782,25885,641,12389,1141,13496,0,0,1216,8738,565,8487,1216,17225,"California",88439,0.0959644500729316,28782,0.664,13267,0.306
"3106","mendocino",3106,"2021-02-19",750,26635,146,12535,604,14100,0,0,611,9210,139,8626,611,17836,"California",88439,0.0975361548638044,28782,0.664,13267,0.306
"3107","mendocino",3107,"2021-02-20",571,27206,545,13080,26,14126,0,0,540,9721,29,8655,540,18376,"California",88439,0.0978640644964326,28782,0.664,13267,0.306
"3108","mendocino",3108,"2021-02-21",325,27531,6,13086,319,14445,0,0,313,10023,11,8666,313,18689,"California",88439,0.097988444012257,28782,0.664,13267,0.306
"3109","mendocino",3109,"2021-02-22",162,27693,30,13116,132,14577,0,0,69,10001,91,8757,69,18758,"California",88439,0.0990174018249867,28782,0.664,13267,0.306
"3110","mendocino",3110,"2021-02-23",678,28371,665,13781,13,14590,0,0,613,10551,63,8820,613,19371,"California",88439,0.0997297572337996,28782,0.664,13267,0.306
"3111","mendocino",3111,"2021-02-24",1840,30211,1759,15540,81,14671,0,0,1431,11580,404,9224,1433,20804,"California",88439,0.104297877633171,28782,0.664,13267,0.306
"3112","mendocino",3112,"2021-02-25",1704,31915,532,16072,1172,15843,0,0,1284,12446,418,9642,1284,22088,"California",88439,0.109024299234501,28782,0.664,13267,0.306
"3113","mendocino",3113,"2021-02-26",1402,33317,748,16820,654,16497,0,0,1039,13124,361,10003,1039,23127,"California",88439,0.113106208799285,28782,0.664,13267,0.306
"3114","mendocino",3114,"2021-02-27",199,33516,151,16971,48,16545,0,0,76,13078,122,10125,76,23203,"California",88439,0.114485690702066,28782,0.664,13267,0.306
"3115","mendocino",3115,"2021-02-28",35,33551,13,16984,22,16567,0,0,24,13091,11,10136,24,23227,"California",88439,0.11461007021789,28782,0.664,13267,0.306
"3116","mendocino",3116,"2021-03-01",578,34129,534,17518,44,16611,0,0,539,13593,37,10173,539,23766,"California",88439,0.115028437680209,28782,0.664,13267,0.306
"3117","mendocino",3117,"2021-03-02",73,34202,26,17544,47,16658,0,0,41,13603,31,10204,41,23807,"California",88439,0.11537896177026,28782,0.664,13267,0.306
"3118","mendocino",3118,"2021-03-03",1716,35918,1331,18875,385,17043,0,0,1082,14053,632,10836,1082,24889,"California",88439,0.122525130315811,28782,0.664,13267,0.306
"3119","mendocino",3119,"2021-03-04",1768,37686,147,19022,1621,18664,0,0,1550,15389,215,11051,1551,26440,"California",88439,0.124956184488744,28782,0.664,13267,0.306
"3120","mendocino",3120,"2021-03-05",211,37897,150,19172,52,18716,9,9,119,15427,90,11141,128,26568,"California",88439,0.125973835072762,28782,0.664,13267,0.306
"3121","mendocino",3121,"2021-03-06",244,38141,21,19193,198,18914,25,34,203,15615,40,11181,228,26796,"California",88439,0.126426124221215,28782,0.664,13267,0.306
"3122","mendocino",3122,"2021-03-07",505,38646,8,19201,477,19391,20,54,118,15366,386,11567,137,26933,"California",88439,0.130790714503782,28782,0.664,13267,0.306
"3123","mendocino",3123,"2021-03-08",125,38771,30,19231,58,19449,37,91,64,15408,59,11626,101,27034,"California",88439,0.13145784099775,28782,0.664,13267,0.306
"3124","mendocino",3124,"2021-03-09",573,39344,233,19464,299,19748,41,132,475,15826,98,11724,516,27550,"California",88439,0.132565949411459,28782,0.664,13267,0.306
"3125","mendocino",3125,"2021-03-10",1111,40455,981,20445,65,19813,65,197,268,15322,840,12564,336,27886,"California",88439,0.142064021528963,28782,0.664,13267,0.306
"3126","mendocino",3126,"2021-03-11",825,41280,612,21057,160,19973,53,250,395,15343,427,12991,448,28334,"California",88439,0.146892208188695,28782,0.664,13267,0.306
"3127","mendocino",3127,"2021-03-12",2020,43300,1031,22088,894,20867,95,345,1212,15849,801,13792,1307,29641,"California",88439,0.155949298386458,28782,0.664,13267,0.306
"3128","mendocino",3128,"2021-03-13",656,43956,526,22614,73,20940,57,402,99,15452,553,14345,156,29797,"California",88439,0.162202195863816,28782,0.664,13267,0.306
"3129","mendocino",3129,"2021-03-14",104,44060,2,22616,95,21035,7,409,11,15381,89,14434,18,29815,"California",88439,0.163208539219123,28782,0.664,13267,0.306
"3130","mendocino",3130,"2021-03-15",597,44657,50,22666,489,21524,58,467,208,15258,388,14822,265,30080,"California",88439,0.167595743959113,28782,0.664,13267,0.306
"3131","mendocino",3131,"2021-03-16",569,45226,373,23039,151,21675,45,512,138,15012,429,15251,183,30263,"California",88439,0.172446545076267,28782,0.664,13267,0.306
"3132","mendocino",3132,"2021-03-17",1563,46789,1359,24398,56,21731,148,660,214,14035,1346,16597,369,30632,"California",88439,0.187666074921697,28782,0.664,13267,0.306
"3133","mendocino",3133,"2021-03-18",1306,48095,247,24645,1021,22752,38,698,283,13340,1015,17612,320,30952,"California",88439,0.199142912063682,28782,0.664,13267,0.306
"3134","mendocino",3134,"2021-03-19",1757,49852,857,25502,839,23591,61,759,332,12314,1421,19033,395,31347,"California",88439,0.215210484062461,28782,0.664,13267,0.306
"3135","mendocino",3135,"2021-03-20",68,49920,10,25512,37,23628,21,780,12,12291,56,19089,33,31380,"California",88439,0.215843688870295,28782,0.664,13267,0.306
"3136","mendocino",3136,"2021-03-21",8,49928,1,25513,2,23630,5,785,3,12294,5,19094,8,31388,"California",88439,0.215900225013851,28782,0.664,13267,0.306
"3137","mendocino",3137,"2021-03-22",624,50552,580,26093,15,23645,29,814,146,11994,474,19568,174,31562,"California",88439,0.221259851423015,28782,0.664,13267,0.306
"3138","mendocino",3138,"2021-03-23",165,50717,33,26126,102,23747,30,844,115,12089,50,19618,145,31707,"California",88439,0.22182521285858,28782,0.664,13267,0.306
"3139","mendocino",3139,"2021-03-24",913,51630,840,26966,26,23773,47,891,114,11453,797,20415,161,31868,"California",88439,0.230837074141499,28782,0.664,13267,0.306
"3140","mendocino",3140,"2021-03-25",1987,53617,50,27016,1917,25690,20,911,174,9836,1809,22224,192,32060,"California",88439,0.251291850880268,28782,0.664,13267,0.306
"3141","mendocino",3141,"2021-03-26",509,54126,359,27375,125,25815,25,936,325,10002,184,22408,350,32410,"California",88439,0.25337238096315,28782,0.664,13267,0.306
"3142","mendocino",3142,"2021-03-27",143,54269,13,27388,118,25933,12,948,81,10033,61,22469,92,32502,"California",88439,0.25406212191454,28782,0.664,13267,0.306
"3143","mendocino",3143,"2021-03-28",25,54294,5,27393,16,25949,4,952,3,10019,21,22490,7,32509,"California",88439,0.254299573717478,28782,0.664,13267,0.306
"3144","mendocino",3144,"2021-03-29",187,54481,99,27492,46,25995,42,994,96,10066,91,22581,138,32647,"California",88439,0.255328531530207,28782,0.664,13267,0.306
"3145","mendocino",3145,"2021-03-30",684,55165,599,28091,48,26043,37,1031,411,10242,272,22853,448,33095,"California",88439,0.258404097739685,28782,0.664,13267,0.306
"3146","mendocino",3146,"2021-03-31",869,56034,272,28363,537,26580,60,1091,405,10245,462,23315,465,33560,"California",88439,0.263628037404313,28782,0.664,13267,0.306
"3147","mendocino",3147,"2021-04-01",1709,57743,399,28762,1231,27811,79,1170,384,9390,1317,24632,462,34022,"California",88439,0.278519657617115,28782,0.664,13267,0.306
"3148","mendocino",3148,"2021-04-02",1284,59027,1056,29818,155,27966,73,1243,223,8629,1057,25689,296,34318,"California",88439,0.290471398364975,28782,0.664,13267,0.306
"3149","mendocino",3149,"2021-04-03",705,59732,9,29827,675,28641,21,1264,83,8115,618,26307,104,34422,"California",88439,0.297459265708568,28782,0.664,13267,0.306
"3150","mendocino",3150,"2021-04-04",69,59801,34,29861,29,28670,6,1270,54,8160,15,26322,60,34482,"California",88439,0.297628874139237,28782,0.664,13267,0.306
"3151","mendocino",3151,"2021-04-05",211,60012,142,30003,45,28715,24,1294,131,8232,80,26402,152,34634,"California",88439,0.298533452436142,28782,0.664,13267,0.306
"3152","mendocino",3152,"2021-04-06",396,60408,121,30124,180,28895,95,1389,107,8145,289,26691,202,34836,"California",88439,0.301801241533713,28782,0.664,13267,0.306
"3153","mendocino",3153,"2021-04-07",485,60893,177,30301,63,28958,245,1634,120,8146,363,27054,364,35200,"California",88439,0.30590576555592,28782,0.664,13267,0.306
"3154","mendocino",3154,"2021-04-08",1488,62381,911,31212,462,29420,115,1749,999,8777,483,27537,1114,36314,"California",88439,0.311367157023485,28782,0.664,13267,0.306
"3155","mendocino",3155,"2021-04-09",758,63139,425,31637,172,29592,161,1910,397,8975,360,27897,558,36872,"California",88439,0.315437759359559,28782,0.664,13267,0.306
"3156","mendocino",3156,"2021-04-10",404,63543,91,31728,267,29859,46,1956,100,8817,304,28201,146,37018,"California",88439,0.318875156887798,28782,0.664,13267,0.306
"3157","mendocino",3157,"2021-04-11",121,63664,47,31775,18,29877,56,2012,58,8868,63,28264,114,37132,"California",88439,0.319587512296611,28782,0.664,13267,0.306
"3158","mendocino",3158,"2021-04-12",619,64283,513,32288,46,29923,60,2072,413,9135,206,28470,473,37605,"California",88439,0.321916801411142,28782,0.664,13267,0.306
"3159","mendocino",3159,"2021-04-13",289,64572,226,32514,63,29986,0,2072,222,9290,67,28537,222,37827,"California",88439,0.3226743857348,28782,0.664,13267,0.306
"3160","mendocino",3160,"2021-04-14",513,65085,424,32938,89,30075,0,2072,412,9601,101,28638,412,38239,"California",88439,0.323816415834643,28782,0.664,13267,0.306
"3161","mendocino",3161,"2021-04-15",656,65741,326,33264,330,30405,0,2072,395,9739,257,28895,395,38634,"California",88439,0.326722373613451,28782,0.664,13267,0.306
"3162","mendocino",3162,"2021-04-16",124,65865,51,33315,72,30477,1,2073,77,9770,46,28941,77,38711,"California",88439,0.327242506134172,28782,0.664,13267,0.306
"3163","mendocino",3163,"2021-04-17",198,66063,12,33327,186,30663,0,2073,70,9714,126,29067,70,38781,"California",88439,0.328667216951797,28782,0.664,13267,0.306
"3164","mendocino",3164,"2021-04-18",7,66070,2,33329,5,30668,0,2073,4,9715,3,29070,4,38785,"California",88439,0.328701138637931,28782,0.664,13267,0.306
"3165","mendocino",3165,"2021-04-19",531,66601,506,33835,24,30692,1,2074,432,10050,98,29168,433,39218,"California",88439,0.32980924705164,28782,0.664,13267,0.306
"3166","mendocino",3166,"2021-04-20",411,67012,284,34119,127,30819,0,2074,262,10163,149,29317,262,39480,"California",88439,0.331494024129626,28782,0.664,13267,0.306
"3167","mendocino",3167,"2021-04-21",183,67195,124,34243,58,30877,1,2075,114,10209,68,29385,114,39594,"California",88439,0.332262915681996,28782,0.664,13267,0.306
"3168","mendocino",3168,"2021-04-22",485,67680,309,34552,175,31052,1,2076,320,10366,163,29548,320,39914,"California",88439,0.33410599396194,28782,0.664,13267,0.306
"3169","mendocino",3169,"2021-04-23",840,68520,699,35251,141,31193,0,2076,688,10904,150,29698,688,40602,"California",88439,0.335802078268637,28782,0.664,13267,0.306
"3170","mendocino",3170,"2021-04-24",101,68621,14,35265,87,31280,0,2076,94,10991,7,29705,94,40696,"California",88439,0.335881228869616,28782,0.664,13267,0.306
"3171","mendocino",3171,"2021-04-25",52,68673,28,35293,20,31300,4,2080,18,10979,34,29739,22,40718,"California",88439,0.336265674645801,28782,0.664,13267,0.306
"3172","mendocino",3172,"2021-04-26",272,68945,209,35502,58,31358,5,2085,189,11091,82,29821,194,40912,"California",88439,0.337192867400129,28782,0.664,13267,0.306
"3173","mendocino",3173,"2021-04-27",174,69119,67,35569,83,31441,24,2109,90,11121,83,29904,113,41025,"California",88439,0.338131367383168,28782,0.664,13267,0.306
"3174","mendocino",3174,"2021-04-28",216,69335,147,35716,53,31494,16,2125,126,11173,90,29994,142,41167,"California",88439,0.339149017967186,28782,0.664,13267,0.306
"3175","mendocino",3175,"2021-04-29",1135,70470,839,36555,282,31776,14,2139,106,10266,1027,31021,120,41287,"California",88439,0.350761541853707,28782,0.664,13267,0.306
"3176","mendocino",3176,"2021-04-30",607,71077,386,36941,211,31987,10,2149,229,10127,378,31399,239,41526,"California",88439,0.355035674306584,28782,0.664,13267,0.306
"3177","mendocino",3177,"2021-05-01",470,71547,434,37375,30,32017,6,2155,366,10396,103,31502,372,41898,"California",88439,0.35620031886385,28782,0.664,13267,0.306
"3178","mendocino",3178,"2021-05-02",56,71603,47,37422,6,32023,3,2158,9,10362,46,31548,12,41910,"California",88439,0.35672045138457,28782,0.664,13267,0.306
"3179","mendocino",3179,"2021-05-03",135,71738,76,37498,38,32061,21,2179,40,10329,94,31642,61,41971,"California",88439,0.357783330883434,28782,0.664,13267,0.306
"3180","mendocino",3180,"2021-05-04",373,72111,254,37752,86,32147,33,2212,134,10258,238,31880,167,42138,"California",88439,0.360474451316727,28782,0.664,13267,0.306
"3181","mendocino",3181,"2021-05-05",868,72979,784,38536,67,32214,17,2229,217,9842,649,32529,233,42371,"California",88439,0.36781284275037,28782,0.664,13267,0.306
"3182","mendocino",3182,"2021-05-06",626,73605,382,38918,223,32437,21,2250,149,9538,474,33003,170,42541,"California",88439,0.373172469159534,28782,0.664,13267,0.306
"3183","mendocino",3183,"2021-05-07",170,73775,32,38950,114,32551,24,2274,108,9609,61,33064,132,42673,"California",88439,0.373862210110924,28782,0.664,13267,0.306
"3184","mendocino",3184,"2021-05-08",126,73901,4,38954,120,32671,2,2276,110,9706,15,33079,112,42785,"California",88439,0.374031818541594,28782,0.664,13267,0.306
"3185","merced",3185,"2020-12-16",3,3,3,3,0,0,0,0,3,3,0,0,3,3,"California",287420,0,48991,0.541,39397,0.435
"3186","merced",3186,"2020-12-17",5,8,5,8,0,0,0,0,5,8,0,0,5,8,"California",287420,0,48991,0.541,39397,0.435
"3187","merced",3187,"2020-12-18",143,151,143,151,0,0,0,0,143,151,0,0,143,151,"California",287420,0,48991,0.541,39397,0.435
"3188","merced",3188,"2020-12-19",39,190,39,190,0,0,0,0,39,190,0,0,39,190,"California",287420,0,48991,0.541,39397,0.435
"3189","merced",3189,"2020-12-20",17,207,17,207,0,0,0,0,17,207,0,0,17,207,"California",287420,0,48991,0.541,39397,0.435
"3190","merced",3190,"2020-12-21",125,332,122,329,3,3,0,0,125,332,0,0,125,332,"California",287420,0,48991,0.541,39397,0.435
"3191","merced",3191,"2020-12-22",152,484,152,481,0,3,0,0,152,484,0,0,152,484,"California",287420,0,48991,0.541,39397,0.435
"3192","merced",3192,"2020-12-23",248,732,242,723,6,9,0,0,248,732,0,0,248,732,"California",287420,0,48991,0.541,39397,0.435
"3193","merced",3193,"2020-12-24",72,804,72,795,0,9,0,0,72,804,0,0,72,804,"California",287420,0,48991,0.541,39397,0.435
"3194","merced",3194,"2020-12-25",4,808,4,799,0,9,0,0,4,808,0,0,4,808,"California",287420,0,48991,0.541,39397,0.435
"3195","merced",3195,"2020-12-26",6,814,3,802,3,12,0,0,6,814,0,0,6,814,"California",287420,0,48991,0.541,39397,0.435
"3196","merced",3196,"2020-12-27",12,826,11,813,1,13,0,0,12,826,0,0,12,826,"California",287420,0,48991,0.541,39397,0.435
"3197","merced",3197,"2020-12-28",123,949,98,911,25,38,0,0,123,949,0,0,123,949,"California",287420,0,48991,0.541,39397,0.435
"3198","merced",3198,"2020-12-29",180,1129,124,1035,56,94,0,0,180,1129,0,0,180,1129,"California",287420,0,48991,0.541,39397,0.435
"3199","merced",3199,"2020-12-30",214,1343,89,1124,125,219,0,0,214,1343,0,0,214,1343,"California",287420,0,48991,0.541,39397,0.435
"3200","merced",3200,"2020-12-31",103,1446,34,1158,69,288,0,0,103,1446,0,0,103,1446,"California",287420,0,48991,0.541,39397,0.435
"3201","merced",3201,"2021-01-01",4,1450,0,1158,4,292,0,0,4,1450,0,0,4,1450,"California",287420,0,48991,0.541,39397,0.435
"3202","merced",3202,"2021-01-02",128,1578,117,1275,11,303,0,0,128,1578,0,0,128,1578,"California",287420,0,48991,0.541,39397,0.435
"3203","merced",3203,"2021-01-03",9,1587,5,1280,4,307,0,0,9,1587,0,0,9,1587,"California",287420,0,48991,0.541,39397,0.435
"3204","merced",3204,"2021-01-04",80,1667,42,1322,38,345,0,0,80,1667,0,0,80,1667,"California",287420,0,48991,0.541,39397,0.435
"3205","merced",3205,"2021-01-05",320,1987,231,1553,89,434,0,0,314,1977,6,6,316,1983,"California",287420,2.08753740171178e-05,48991,0.541,39397,0.435
"3206","merced",3206,"2021-01-06",254,2241,103,1656,151,585,0,0,248,2219,6,12,248,2231,"California",287420,4.17507480342356e-05,48991,0.541,39397,0.435
"3207","merced",3207,"2021-01-07",184,2425,80,1736,104,689,0,0,174,2382,11,23,174,2405,"California",287420,8.00222670656183e-05,48991,0.541,39397,0.435
"3208","merced",3208,"2021-01-08",527,2952,393,2129,134,823,0,0,376,2608,150,173,376,2781,"California",287420,0.000601906617493563,48991,0.541,39397,0.435
"3209","merced",3209,"2021-01-09",23,2975,10,2139,13,836,0,0,17,2619,6,179,17,2798,"California",287420,0.000622781991510681,48991,0.541,39397,0.435
"3210","merced",3210,"2021-01-10",11,2986,7,2146,4,840,0,0,7,2622,4,183,7,2805,"California",287420,0.000636698907522093,48991,0.541,39397,0.435
"3211","merced",3211,"2021-01-11",225,3211,167,2313,58,898,0,0,101,2601,124,307,103,2908,"California",287420,0.00106812330387586,48991,0.541,39397,0.435
"3212","merced",3212,"2021-01-12",280,3491,157,2470,123,1021,0,0,230,2780,51,358,230,3138,"California",287420,0.00124556398302136,48991,0.541,39397,0.435
"3213","merced",3213,"2021-01-13",372,3863,173,2643,199,1220,0,0,221,2853,151,509,224,3362,"California",287420,0.00177092756245216,48991,0.541,39397,0.435
"3214","merced",3214,"2021-01-14",325,4188,201,2844,124,1344,0,0,160,2850,164,673,161,3523,"California",287420,0.00234152111892005,48991,0.541,39397,0.435
"3215","merced",3215,"2021-01-15",578,4766,127,2971,451,1795,0,0,540,3353,39,712,542,4065,"California",287420,0.00247721105003131,48991,0.541,39397,0.435
"3216","merced",3216,"2021-01-16",203,4969,122,3093,81,1876,0,0,198,3546,5,717,198,4263,"California",287420,0.00249460719504558,48991,0.541,39397,0.435
"3217","merced",3217,"2021-01-17",49,5018,12,3105,37,1913,0,0,48,3593,1,718,48,4311,"California",287420,0.00249808642404843,48991,0.541,39397,0.435
"3218","merced",3218,"2021-01-18",260,5278,126,3231,134,2047,0,0,238,3812,22,740,241,4552,"California",287420,0.0025746294621112,48991,0.541,39397,0.435
"3219","merced",3219,"2021-01-19",710,5988,586,3817,124,2171,0,0,539,4184,171,911,543,5095,"California",287420,0.00316957762159905,48991,0.541,39397,0.435
"3220","merced",3220,"2021-01-20",571,6559,466,4283,105,2276,0,0,514,4644,57,968,517,5612,"California",287420,0.00336789367476167,48991,0.541,39397,0.435
"3221","merced",3221,"2021-01-21",1007,7566,647,4930,360,2636,0,0,908,5456,99,1067,911,6523,"California",287420,0.00371233734604412,48991,0.541,39397,0.435
"3222","merced",3222,"2021-01-22",1304,8870,686,5616,618,3254,0,0,1277,6718,27,1094,1289,7812,"California",287420,0.00380627652912115,48991,0.541,39397,0.435
"3223","merced",3223,"2021-01-23",307,9177,185,5801,122,3376,0,0,202,6815,105,1199,202,8014,"California",287420,0.00417159557442071,48991,0.541,39397,0.435
"3224","merced",3224,"2021-01-24",32,9209,14,5815,18,3394,0,0,23,6830,8,1207,23,8037,"California",287420,0.00419942940644353,48991,0.541,39397,0.435
"3225","merced",3225,"2021-01-25",727,9936,241,6056,486,3880,0,0,668,7441,58,1265,669,8706,"California",287420,0.004401224688609,48991,0.541,39397,0.435
"3226","merced",3226,"2021-01-26",913,10849,483,6539,430,4310,0,0,672,7900,214,1479,673,9379,"California",287420,0.00514577969521954,48991,0.541,39397,0.435
"3227","merced",3227,"2021-01-27",977,11826,582,7121,395,4705,0,0,810,8545,165,1644,810,10189,"California",287420,0.00571985248069028,48991,0.541,39397,0.435
"3228","merced",3228,"2021-01-28",1139,12965,593,7714,546,5251,0,0,1017,9441,122,1766,1018,11207,"California",287420,0.00614431841903834,48991,0.541,39397,0.435
"3229","merced",3229,"2021-01-29",845,13810,321,8035,524,5775,0,0,600,9805,238,2004,602,11809,"California",287420,0.00697237492171735,48991,0.541,39397,0.435
"3230","merced",3230,"2021-01-30",259,14069,27,8062,232,6007,0,0,243,10032,16,2020,243,12052,"California",287420,0.00702804258576299,48991,0.541,39397,0.435
"3231","merced",3231,"2021-01-31",46,14115,10,8072,36,6043,0,0,45,10076,1,2021,45,12097,"California",287420,0.00703152181476585,48991,0.541,39397,0.435
"3232","merced",3232,"2021-02-01",374,14489,52,8124,322,6365,0,0,325,10354,48,2069,326,12423,"California",287420,0.00719852480690279,48991,0.541,39397,0.435
"3233","merced",3233,"2021-02-02",294,14783,181,8305,113,6478,0,0,175,10413,117,2186,176,12599,"California",287420,0.00760559460023659,48991,0.541,39397,0.435
"3234","merced",3234,"2021-02-03",349,15132,71,8376,278,6756,0,0,168,10400,181,2367,168,12767,"California",287420,0.00823533504975297,48991,0.541,39397,0.435
"3235","merced",3235,"2021-02-04",371,15503,146,8522,225,6981,0,0,240,10511,130,2497,241,13008,"California",287420,0.00868763482012386,48991,0.541,39397,0.435
"3236","merced",3236,"2021-02-05",513,16016,173,8695,340,7321,0,0,272,10545,240,2737,274,13282,"California",287420,0.00952264978080857,48991,0.541,39397,0.435
"3237","merced",3237,"2021-02-06",389,16405,219,8914,170,7491,0,0,246,10650,142,2879,247,13529,"California",287420,0.0100167002992137,48991,0.541,39397,0.435
"3238","merced",3238,"2021-02-07",21,16426,13,8927,8,7499,0,0,14,10657,7,2886,14,13543,"California",287420,0.0100410549022337,48991,0.541,39397,0.435
"3239","merced",3239,"2021-02-08",279,16705,197,9124,82,7581,0,0,170,10720,108,2994,171,13714,"California",287420,0.0104168116345418,48991,0.541,39397,0.435
"3240","merced",3240,"2021-02-09",1215,17920,955,10079,260,7841,0,0,772,11058,435,3429,773,14487,"California",287420,0.0119302762507828,48991,0.541,39397,0.435
"3241","merced",3241,"2021-02-10",1852,19772,1431,11510,421,8262,0,0,1273,11762,569,3998,1273,15760,"California",287420,0.0139099575534062,48991,0.541,39397,0.435
"3242","merced",3242,"2021-02-11",2503,22275,2007,13517,496,8758,0,0,1815,12898,679,4677,1815,17575,"California",287420,0.0162723540463433,48991,0.541,39397,0.435
"3243","merced",3243,"2021-02-12",1713,23988,1012,14529,701,9459,0,0,745,12686,959,5636,747,18322,"California",287420,0.0196089346600793,48991,0.541,39397,0.435
"3244","merced",3244,"2021-02-13",361,24349,206,14735,155,9614,0,0,262,12852,98,5734,264,18586,"California",287420,0.0199498991023589,48991,0.541,39397,0.435
"3245","merced",3245,"2021-02-14",117,24466,26,14761,91,9705,0,0,96,12928,21,5755,97,18683,"California",287420,0.0200229629114188,48991,0.541,39397,0.435
"3246","merced",3246,"2021-02-15",274,24740,40,14801,234,9939,0,0,170,13001,98,5853,171,18854,"California",287420,0.0203639273536984,48991,0.541,39397,0.435
"3247","merced",3247,"2021-02-16",1212,25952,843,15644,369,10308,0,0,838,13485,356,6209,840,19694,"California",287420,0.0216025328787141,48991,0.541,39397,0.435
"3248","merced",3248,"2021-02-17",1874,27826,1629,17273,245,10553,0,0,1313,14253,548,6757,1316,21010,"California",287420,0.0235091503722775,48991,0.541,39397,0.435
"3249","merced",3249,"2021-02-18",1209,29035,819,18092,390,10943,0,0,406,13877,782,7539,406,21416,"California",287420,0.0262299074525085,48991,0.541,39397,0.435
"3250","merced",3250,"2021-02-19",1261,30296,413,18505,848,11791,0,0,537,13698,718,8257,539,21955,"California",287420,0.028727993876557,48991,0.541,39397,0.435
"3251","merced",3251,"2021-02-20",276,30572,31,18536,245,12036,0,0,142,13708,132,8389,142,22097,"California",287420,0.0291872521049335,48991,0.541,39397,0.435
"3252","merced",3252,"2021-02-21",76,30648,62,18598,14,12050,0,0,32,13696,44,8433,32,22129,"California",287420,0.0293403381810591,48991,0.541,39397,0.435
"3253","merced",3253,"2021-02-22",831,31479,293,18891,538,12588,0,0,483,13833,346,8779,483,22612,"California",287420,0.0305441514160462,48991,0.541,39397,0.435
"3254","merced",3254,"2021-02-23",1080,32559,421,19312,659,13247,0,0,638,14034,437,9216,638,23250,"California",287420,0.032064574490293,48991,0.541,39397,0.435
"3255","merced",3255,"2021-02-24",815,33374,303,19615,512,13759,0,0,445,14119,361,9577,446,23696,"California",287420,0.0333205761603229,48991,0.541,39397,0.435
"3256","merced",3256,"2021-02-25",1756,35130,865,20480,891,14650,0,0,1305,14978,448,10025,1307,25003,"California",287420,0.034879270753601,48991,0.541,39397,0.435
"3257","merced",3257,"2021-02-26",2148,37278,1375,21855,773,15423,0,0,1736,16305,410,10435,1737,26740,"California",287420,0.0363057546447707,48991,0.541,39397,0.435
"3258","merced",3258,"2021-02-27",2526,39804,1102,22957,1424,16847,0,0,2241,18262,284,10719,2241,28981,"California",287420,0.037293855681581,48991,0.541,39397,0.435
"3259","merced",3259,"2021-02-28",306,40110,71,23028,235,17082,0,0,251,18462,51,10770,251,29232,"California",287420,0.0374712963607265,48991,0.541,39397,0.435
"3260","merced",3260,"2021-03-01",1115,41225,280,23308,834,17916,1,1,774,18905,332,11102,775,30007,"California",287420,0.0386264003896736,48991,0.541,39397,0.435
"3261","merced",3261,"2021-03-02",1746,42971,903,24211,842,18758,1,2,1358,19885,379,11481,1359,31366,"California",287420,0.0399450281817549,48991,0.541,39397,0.435
"3262","merced",3262,"2021-03-03",2212,45183,1727,25938,484,19242,1,3,1456,20603,739,12220,1457,32823,"California",287420,0.0425161784148633,48991,0.541,39397,0.435
"3263","merced",3263,"2021-03-04",2881,48064,2267,28205,612,19854,2,5,1911,21564,953,13173,1914,34737,"California",287420,0.0458318836545821,48991,0.541,39397,0.435
"3264","merced",3264,"2021-03-05",2064,50128,1193,29398,847,20701,24,29,1528,22593,524,13697,1553,36290,"California",287420,0.0476549996520771,48991,0.541,39397,0.435
"3265","merced",3265,"2021-03-06",1166,51294,662,30060,482,21183,22,51,910,23270,255,13952,932,37222,"California",287420,0.0485422030478046,48991,0.541,39397,0.435
"3266","merced",3266,"2021-03-07",229,51523,65,30125,139,21322,25,76,200,23466,29,13981,225,37447,"California",287420,0.0486431006888873,48991,0.541,39397,0.435
"3267","merced",3267,"2021-03-08",1363,52886,765,30890,533,21855,65,141,1151,24470,211,14192,1215,38662,"California",287420,0.0493772180084893,48991,0.541,39397,0.435
"3268","merced",3268,"2021-03-09",1691,54577,996,31886,588,22443,107,248,1097,25086,589,14781,1205,39867,"California",287420,0.0514264838911697,48991,0.541,39397,0.435
"3269","merced",3269,"2021-03-10",2688,57265,1861,33747,627,23070,200,448,1617,25850,1057,15838,1821,41688,"California",287420,0.0551040289471853,48991,0.541,39397,0.435
"3270","merced",3270,"2021-03-11",1934,59199,689,34436,1041,24111,204,652,1219,26595,700,16538,1445,43133,"California",287420,0.0575394892491824,48991,0.541,39397,0.435
"3271","merced",3271,"2021-03-12",2196,61395,900,35336,1028,25139,268,920,1482,27647,710,17248,1762,44895,"California",287420,0.060009741841208,48991,0.541,39397,0.435
"3272","merced",3272,"2021-03-13",720,62115,309,35645,168,25307,243,1163,412,28003,300,17548,656,45551,"California",287420,0.0610535105420639,48991,0.541,39397,0.435
"3273","merced",3273,"2021-03-14",249,62364,136,35781,83,25390,30,1193,149,28084,99,17647,180,45731,"California",287420,0.0613979542133463,48991,0.541,39397,0.435
"3274","merced",3274,"2021-03-15",1502,63866,493,36274,754,26144,255,1448,984,28811,511,18158,1238,46969,"California",287420,0.0631758402338042,48991,0.541,39397,0.435
"3275","merced",3275,"2021-03-16",1432,65298,686,36960,520,26664,226,1674,949,29511,474,18632,1174,48143,"California",287420,0.0648249947811565,48991,0.541,39397,0.435
"3276","merced",3276,"2021-03-17",1959,67257,1057,38017,724,27388,178,1852,1511,30762,440,19072,1691,49834,"California",287420,0.0663558555424118,48991,0.541,39397,0.435
"3277","merced",3277,"2021-03-18",2036,69293,1168,39185,721,28109,147,1999,1388,31673,637,19709,1548,51382,"California",287420,0.0685721244172291,48991,0.541,39397,0.435
"3278","merced",3278,"2021-03-19",2661,71954,1449,40634,1019,29128,193,2192,1384,31985,1266,20975,1578,52960,"California",287420,0.072976828334841,48991,0.541,39397,0.435
"3279","merced",3279,"2021-03-20",2413,74367,1485,42119,533,29661,395,2587,957,31888,1453,22428,1356,54316,"California",287420,0.0780321480759864,48991,0.541,39397,0.435
"3280","merced",3280,"2021-03-21",556,74923,343,42462,200,29861,13,2600,437,32221,119,22547,452,54768,"California",287420,0.0784461763273259,48991,0.541,39397,0.435
"3281","merced",3281,"2021-03-22",1262,76185,629,43091,557,30418,76,2676,887,32818,368,22915,965,55733,"California",287420,0.0797265326003758,48991,0.541,39397,0.435
"3282","merced",3282,"2021-03-23",1824,78009,1099,44190,661,31079,64,2740,1347,33757,473,23388,1412,57145,"California",287420,0.0813722079187252,48991,0.541,39397,0.435
"3283","merced",3283,"2021-03-24",1414,79423,881,45071,498,31577,35,2775,937,34258,472,23860,973,58118,"California",287420,0.0830144040080718,48991,0.541,39397,0.435
"3284","merced",3284,"2021-03-25",3301,82724,2269,47340,1011,32588,21,2796,2079,35147,1214,25074,2103,60221,"California",287420,0.0872381880175353,48991,0.541,39397,0.435
"3285","merced",3285,"2021-03-26",1930,84654,1084,48424,812,33400,34,2830,890,35038,1032,26106,923,61144,"California",287420,0.0908287523484796,48991,0.541,39397,0.435
"3286","merced",3286,"2021-03-27",3130,87784,1797,50221,1200,34600,133,2963,1411,34876,1707,27813,1545,62689,"California",287420,0.0967677962563496,48991,0.541,39397,0.435
"3287","merced",3287,"2021-03-28",516,88300,213,50434,296,34896,7,2970,213,34796,301,28114,221,62910,"California",287420,0.0978150441862083,48991,0.541,39397,0.435
"3288","merced",3288,"2021-03-29",1764,90064,723,51157,876,35772,165,3135,666,34539,1092,29206,835,63745,"California",287420,0.101614362257324,48991,0.541,39397,0.435
"3289","merced",3289,"2021-03-30",2142,92206,799,51956,1284,37056,59,3194,988,34437,1150,30356,1048,64793,"California",287420,0.105615475610605,48991,0.541,39397,0.435
"3290","merced",3290,"2021-03-31",2123,94329,1400,53356,685,37741,38,3232,952,34272,1156,31512,991,65784,"California",287420,0.109637464337903,48991,0.541,39397,0.435
"3291","merced",3291,"2021-04-01",2179,96508,1019,54375,1036,38777,124,3356,997,34219,1176,32688,1123,66907,"California",287420,0.113729037645258,48991,0.541,39397,0.435
"3292","merced",3292,"2021-04-02",2327,98835,635,55010,1289,40066,403,3759,779,33871,1531,34219,1183,68090,"California",287420,0.119055737248626,48991,0.541,39397,0.435
"3293","merced",3293,"2021-04-03",903,99738,426,55436,464,40530,13,3772,496,33979,403,34622,511,68601,"California",287420,0.120457866536775,48991,0.541,39397,0.435
"3294","merced",3294,"2021-04-04",369,100107,143,55579,222,40752,4,3776,141,33899,227,34849,147,68748,"California",287420,0.121247651520423,48991,0.541,39397,0.435
"3295","merced",3295,"2021-04-05",1259,101366,598,56177,450,41202,211,3987,414,33684,839,35688,624,69372,"California",287420,0.124166724653817,48991,0.541,39397,0.435
"3296","merced",3296,"2021-04-06",2412,103778,890,57067,696,41898,826,4813,898,33897,1510,37198,1723,71095,"California",287420,0.129420360448125,48991,0.541,39397,0.435
"3297","merced",3297,"2021-04-07",1649,105427,885,57952,657,42555,107,4920,584,33538,1052,38250,693,71788,"California",287420,0.133080509359126,48991,0.541,39397,0.435
"3298","merced",3298,"2021-04-08",2272,107699,1169,59121,888,43443,215,5135,813,33135,1429,39679,1026,72814,"California",287420,0.138052327604203,48991,0.541,39397,0.435
"3299","merced",3299,"2021-04-09",1679,109378,474,59595,630,44073,575,5710,563,33175,1100,40779,1140,73954,"California",287420,0.141879479507341,48991,0.541,39397,0.435
"3300","merced",3300,"2021-04-10",694,110072,362,59957,144,44217,188,5898,176,33024,513,41292,362,74316,"California",287420,0.143664323985805,48991,0.541,39397,0.435
"3301","merced",3301,"2021-04-11",486,110558,280,60237,72,44289,134,6032,146,32967,338,41630,281,74597,"California",287420,0.144840303388769,48991,0.541,39397,0.435
"3302","merced",3302,"2021-04-12",1414,111972,927,61164,364,44653,123,6155,812,33335,567,42197,935,75532,"California",287420,0.146813026233387,48991,0.541,39397,0.435
"3303","merced",3303,"2021-04-13",2025,113997,1448,62612,574,45227,3,6158,936,33276,1001,43198,942,76474,"California",287420,0.150295734465242,48991,0.541,39397,0.435
"3304","merced",3304,"2021-04-14",2040,116037,1207,63819,833,46060,0,6158,904,33177,1005,44203,906,77380,"California",287420,0.15379235961311,48991,0.541,39397,0.435
"3305","merced",3305,"2021-04-15",3007,119044,1971,65790,1036,47096,0,6158,955,32309,1827,46030,959,78339,"California",287420,0.160148911001322,48991,0.541,39397,0.435
"3306","merced",3306,"2021-04-16",2354,121398,1147,66937,1207,48303,0,6158,962,31975,1296,47326,962,79301,"California",287420,0.16465799178902,48991,0.541,39397,0.435
"3307","merced",3307,"2021-04-17",1453,122851,806,67743,647,48950,0,6158,372,31272,1076,48402,373,79674,"California",287420,0.168401642196089,48991,0.541,39397,0.435
"3308","merced",3308,"2021-04-18",467,123318,248,67991,219,49169,0,6158,190,31212,250,48652,190,79864,"California",287420,0.169271449446803,48991,0.541,39397,0.435
"3309","merced",3309,"2021-04-19",1321,124639,741,68732,580,49749,0,6158,703,31391,524,49176,703,80567,"California",287420,0.171094565444298,48991,0.541,39397,0.435
"3310","merced",3310,"2021-04-20",1409,126048,733,69465,676,50425,0,6158,785,31620,557,49733,786,81353,"California",287420,0.173032495998887,48991,0.541,39397,0.435
"3311","merced",3311,"2021-04-21",1463,127511,880,70345,583,51008,0,6158,748,31764,604,50337,748,82101,"California",287420,0.17513395031661,48991,0.541,39397,0.435
"3312","merced",3312,"2021-04-22",1603,129114,739,71084,864,51872,0,6158,774,31790,748,51085,774,82875,"California",287420,0.177736413610744,48991,0.541,39397,0.435
"3313","merced",3313,"2021-04-23",1629,130743,670,71754,959,52831,0,6158,884,31976,699,51784,885,83760,"California",287420,0.180168394683738,48991,0.541,39397,0.435
"3314","merced",3314,"2021-04-24",567,131310,398,72152,169,53000,0,6158,388,32190,175,51959,389,84149,"California",287420,0.180777259759237,48991,0.541,39397,0.435
"3315","merced",3315,"2021-04-25",325,131635,185,72337,140,53140,0,6158,191,32249,132,52091,191,84340,"California",287420,0.181236517987614,48991,0.541,39397,0.435
"3316","merced",3316,"2021-04-26",1138,132773,476,72813,662,53802,0,6158,604,32354,501,52592,606,84946,"California",287420,0.182979611718043,48991,0.541,39397,0.435
"3317","merced",3317,"2021-04-27",1474,134247,623,73436,841,54643,10,6168,610,32176,799,53391,621,85567,"California",287420,0.185759515691323,48991,0.541,39397,0.435
"3318","merced",3318,"2021-04-28",1361,135608,673,74109,679,55322,9,6177,780,32405,561,53952,790,86357,"California",287420,0.187711363161923,48991,0.541,39397,0.435
"3319","merced",3319,"2021-04-29",1387,136995,587,74696,775,56097,25,6202,648,32347,732,54684,674,87031,"California",287420,0.190258158792012,48991,0.541,39397,0.435
"3320","merced",3320,"2021-04-30",1398,138393,579,75275,775,56872,44,6246,703,32403,692,55376,748,87779,"California",287420,0.192665785261986,48991,0.541,39397,0.435
"3321","merced",3321,"2021-05-01",556,138949,241,75516,311,57183,4,6250,258,32370,295,55671,262,88041,"California",287420,0.193692157817828,48991,0.541,39397,0.435
"3322","merced",3322,"2021-05-02",291,139240,117,75633,159,57342,15,6265,128,32351,163,55834,144,88185,"California",287420,0.194259272145293,48991,0.541,39397,0.435
"3323","merced",3323,"2021-05-03",768,140008,528,76161,194,57536,46,6311,267,32189,496,56330,334,88519,"California",287420,0.195984969730708,48991,0.541,39397,0.435
"3324","merced",3324,"2021-05-04",989,140997,534,76695,402,57938,53,6364,349,31954,636,56966,401,88920,"California",287420,0.198197759376522,48991,0.541,39397,0.435
"3325","merced",3325,"2021-05-05",1132,142129,703,77398,356,58294,73,6437,471,31847,652,57618,545,89465,"California",287420,0.200466216686382,48991,0.541,39397,0.435
"3326","merced",3326,"2021-05-06",888,143017,458,77856,381,58675,49,6486,293,31599,590,58208,342,89807,"California",287420,0.202518961798066,48991,0.541,39397,0.435
"3327","merced",3327,"2021-05-07",832,143849,236,78092,558,59233,38,6524,342,31493,487,58695,381,90188,"California",287420,0.204213346322455,48991,0.541,39397,0.435
"3328","merced",3328,"2021-05-08",390,144239,199,78291,155,59388,36,6560,172,31485,216,58911,208,90396,"California",287420,0.204964859787071,48991,0.541,39397,0.435
"3329","modoc",3329,"2020-12-16",1,1,1,1,0,0,0,0,1,1,0,0,1,1,"California",9475,0,1150,0.265,3109,0.717
"3330","modoc",3330,"2020-12-21",99,100,99,100,0,0,0,0,99,100,0,0,99,100,"California",9475,0,1150,0.265,3109,0.717
"3331","modoc",3331,"2020-12-22",14,114,14,114,0,0,0,0,14,114,0,0,14,114,"California",9475,0,1150,0.265,3109,0.717
"3332","modoc",3332,"2020-12-23",4,118,4,118,0,0,0,0,4,118,0,0,4,118,"California",9475,0,1150,0.265,3109,0.717
"3333","modoc",3333,"2020-12-24",1,119,1,119,0,0,0,0,1,119,0,0,1,119,"California",9475,0,1150,0.265,3109,0.717
"3334","modoc",3334,"2020-12-28",2,121,2,121,0,0,0,0,2,121,0,0,2,121,"California",9475,0,1150,0.265,3109,0.717
"3335","modoc",3335,"2020-12-29",10,131,1,122,9,9,0,0,10,131,0,0,10,131,"California",9475,0,1150,0.265,3109,0.717
"3336","modoc",3336,"2020-12-30",7,138,0,122,7,16,0,0,7,138,0,0,7,138,"California",9475,0,1150,0.265,3109,0.717
"3337","modoc",3337,"2021-01-02",3,141,1,123,2,18,0,0,3,141,0,0,3,141,"California",9475,0,1150,0.265,3109,0.717
"3338","modoc",3338,"2021-01-04",8,149,0,123,8,26,0,0,8,149,0,0,8,149,"California",9475,0,1150,0.265,3109,0.717
"3339","modoc",3339,"2021-01-05",2,151,1,124,1,27,0,0,2,151,0,0,2,151,"California",9475,0,1150,0.265,3109,0.717
"3340","modoc",3340,"2021-01-06",3,154,2,126,1,28,0,0,2,152,1,1,2,153,"California",9475,0.000105540897097625,1150,0.265,3109,0.717
"3341","modoc",3341,"2021-01-07",72,226,0,126,72,100,0,0,72,224,0,1,72,225,"California",9475,0.000105540897097625,1150,0.265,3109,0.717
"3342","modoc",3342,"2021-01-08",105,331,0,126,105,205,0,0,105,329,0,1,105,330,"California",9475,0.000105540897097625,1150,0.265,3109,0.717
"3343","modoc",3343,"2021-01-10",1,332,1,127,0,205,0,0,0,328,1,2,0,330,"California",9475,0.000211081794195251,1150,0.265,3109,0.717
"3344","modoc",3344,"2021-01-11",90,422,81,208,9,214,0,0,19,276,71,73,19,349,"California",9475,0.00770448548812665,1150,0.265,3109,0.717
"3345","modoc",3345,"2021-01-12",94,516,25,233,69,283,0,0,68,318,26,99,68,417,"California",9475,0.0104485488126649,1150,0.265,3109,0.717
"3346","modoc",3346,"2021-01-13",24,540,4,237,20,303,0,0,22,338,2,101,22,439,"California",9475,0.0106596306068602,1150,0.265,3109,0.717
"3347","modoc",3347,"2021-01-14",129,669,6,243,123,426,0,0,124,457,5,106,124,563,"California",9475,0.0111873350923483,1150,0.265,3109,0.717
"3348","modoc",3348,"2021-01-15",6,675,1,244,5,431,0,0,6,463,0,106,6,569,"California",9475,0.0111873350923483,1150,0.265,3109,0.717
"3349","modoc",3349,"2021-01-16",1,676,1,245,0,431,0,0,1,464,0,106,1,570,"California",9475,0.0111873350923483,1150,0.265,3109,0.717
"3350","modoc",3350,"2021-01-18",1,677,1,246,0,431,0,0,1,465,0,106,1,571,"California",9475,0.0111873350923483,1150,0.265,3109,0.717
"3351","modoc",3351,"2021-01-19",5,682,3,249,2,433,0,0,3,466,2,108,3,574,"California",9475,0.0113984168865435,1150,0.265,3109,0.717
"3352","modoc",3352,"2021-01-20",11,693,1,250,10,443,0,0,11,477,0,108,11,585,"California",9475,0.0113984168865435,1150,0.265,3109,0.717
"3353","modoc",3353,"2021-01-21",157,850,2,252,155,598,0,0,157,634,0,108,157,742,"California",9475,0.0113984168865435,1150,0.265,3109,0.717
"3354","modoc",3354,"2021-01-22",2,852,0,252,2,600,0,0,2,636,0,108,2,744,"California",9475,0.0113984168865435,1150,0.265,3109,0.717
"3355","modoc",3355,"2021-01-25",11,863,0,252,11,611,0,0,11,647,0,108,11,755,"California",9475,0.0113984168865435,1150,0.265,3109,0.717
"3356","modoc",3356,"2021-01-26",65,928,1,253,64,675,0,0,65,712,0,108,65,820,"California",9475,0.0113984168865435,1150,0.265,3109,0.717
"3357","modoc",3357,"2021-01-27",41,969,2,255,39,714,0,0,25,721,16,124,25,845,"California",9475,0.0130870712401055,1150,0.265,3109,0.717
"3358","modoc",3358,"2021-01-28",145,1114,2,257,143,857,0,0,144,864,1,125,144,989,"California",9475,0.0131926121372032,1150,0.265,3109,0.717
"3359","modoc",3359,"2021-01-29",3,1117,1,258,2,859,0,0,3,867,0,125,3,992,"California",9475,0.0131926121372032,1150,0.265,3109,0.717
"3360","modoc",3360,"2021-02-01",26,1143,13,271,13,872,0,0,12,865,14,139,12,1004,"California",9475,0.0146701846965699,1150,0.265,3109,0.717
"3361","modoc",3361,"2021-02-02",170,1313,2,273,168,1040,0,0,167,1029,3,142,167,1171,"California",9475,0.0149868073878628,1150,0.265,3109,0.717
"3362","modoc",3362,"2021-02-03",18,1331,13,286,5,1045,0,0,11,1033,7,149,11,1182,"California",9475,0.0157255936675462,1150,0.265,3109,0.717
"3363","modoc",3363,"2021-02-04",155,1486,4,290,151,1196,0,0,27,932,128,277,27,1209,"California",9475,0.0292348284960422,1150,0.265,3109,0.717
"3364","modoc",3364,"2021-02-05",4,1490,3,293,1,1197,0,0,3,934,1,278,3,1212,"California",9475,0.0293403693931398,1150,0.265,3109,0.717
"3365","modoc",3365,"2021-02-08",9,1499,2,295,7,1204,0,0,8,941,1,279,8,1220,"California",9475,0.0294459102902375,1150,0.265,3109,0.717
"3366","modoc",3366,"2021-02-09",197,1696,13,308,184,1388,0,0,65,874,132,411,65,1285,"California",9475,0.043377308707124,1150,0.265,3109,0.717
"3367","modoc",3367,"2021-02-10",5,1701,2,310,3,1391,0,0,4,877,1,412,4,1289,"California",9475,0.0434828496042216,1150,0.265,3109,0.717
"3368","modoc",3368,"2021-02-11",201,1902,3,313,198,1589,0,0,83,842,118,530,83,1372,"California",9475,0.0559366754617414,1150,0.265,3109,0.717
"3369","modoc",3369,"2021-02-12",4,1906,0,313,4,1593,0,0,2,842,2,532,2,1374,"California",9475,0.0561477572559367,1150,0.265,3109,0.717
"3370","modoc",3370,"2021-02-13",1,1907,0,313,1,1594,0,0,1,843,0,532,1,1375,"California",9475,0.0561477572559367,1150,0.265,3109,0.717
"3371","modoc",3371,"2021-02-16",147,2054,6,319,141,1735,0,0,143,982,4,536,143,1518,"California",9475,0.0565699208443272,1150,0.265,3109,0.717
"3372","modoc",3372,"2021-02-17",24,2078,1,320,23,1758,0,0,12,982,12,548,12,1530,"California",9475,0.0578364116094987,1150,0.265,3109,0.717
"3373","modoc",3373,"2021-02-18",188,2266,2,322,186,1944,0,0,25,846,162,710,26,1556,"California",9475,0.074934036939314,1150,0.265,3109,0.717
"3374","modoc",3374,"2021-02-19",2,2268,2,324,0,1944,0,0,2,848,0,710,2,1558,"California",9475,0.074934036939314,1150,0.265,3109,0.717
"3375","modoc",3375,"2021-02-20",1,2269,1,325,0,1944,0,0,0,847,1,711,0,1558,"California",9475,0.0750395778364116,1150,0.265,3109,0.717
"3376","modoc",3376,"2021-02-22",17,2286,9,334,8,1952,0,0,3,836,14,725,3,1561,"California",9475,0.0765171503957784,1150,0.265,3109,0.717
"3377","modoc",3377,"2021-02-23",20,2306,2,336,18,1970,0,0,1,818,19,744,1,1562,"California",9475,0.0785224274406332,1150,0.265,3109,0.717
"3378","modoc",3378,"2021-02-24",90,2396,1,337,89,2059,0,0,30,788,60,804,30,1592,"California",9475,0.0848548812664908,1150,0.265,3109,0.717
"3379","modoc",3379,"2021-02-25",169,2565,1,338,168,2227,0,0,13,645,156,960,13,1605,"California",9475,0.10131926121372,1150,0.265,3109,0.717
"3380","modoc",3380,"2021-02-26",3,2568,0,338,3,2230,0,0,1,644,2,962,1,1606,"California",9475,0.101530343007916,1150,0.265,3109,0.717
"3381","modoc",3381,"2021-02-27",5,2573,5,343,0,2230,0,0,2,643,3,965,2,1608,"California",9475,0.101846965699208,1150,0.265,3109,0.717
"3382","modoc",3382,"2021-03-01",5,2578,0,343,5,2235,0,0,0,639,4,969,0,1608,"California",9475,0.102269129287599,1150,0.265,3109,0.717
"3383","modoc",3383,"2021-03-02",193,2771,12,355,181,2416,0,0,26,498,167,1136,26,1634,"California",9475,0.119894459102902,1150,0.265,3109,0.717
"3384","modoc",3384,"2021-03-03",12,2783,6,361,6,2422,0,0,2,490,10,1146,2,1636,"California",9475,0.120949868073879,1150,0.265,3109,0.717
"3385","modoc",3385,"2021-03-04",175,2958,2,363,173,2595,0,0,148,611,27,1173,148,1784,"California",9475,0.123799472295515,1150,0.265,3109,0.717
"3386","modoc",3386,"2021-03-05",4,2962,3,366,1,2596,0,0,2,611,2,1175,2,1786,"California",9475,0.12401055408971,1150,0.265,3109,0.717
"3387","modoc",3387,"2021-03-06",11,2973,0,366,1,2597,10,10,1,612,10,1185,11,1797,"California",9475,0.125065963060686,1150,0.265,3109,0.717
"3388","modoc",3388,"2021-03-07",6,2979,1,367,0,2597,5,15,1,613,5,1190,6,1803,"California",9475,0.125593667546174,1150,0.265,3109,0.717
"3389","modoc",3389,"2021-03-08",8,2987,1,368,3,2600,4,19,1,612,6,1196,5,1808,"California",9475,0.12622691292876,1150,0.265,3109,0.717
"3390","modoc",3390,"2021-03-09",126,3113,10,378,108,2708,8,27,61,616,65,1261,69,1877,"California",9475,0.133087071240106,1150,0.265,3109,0.717
"3391","modoc",3391,"2021-03-10",9,3122,3,381,2,2710,4,31,4,619,5,1266,8,1885,"California",9475,0.133614775725594,1150,0.265,3109,0.717
"3392","modoc",3392,"2021-03-11",207,3329,0,381,99,2809,108,139,22,564,185,1451,130,2015,"California",9475,0.153139841688654,1150,0.265,3109,0.717
"3393","modoc",3393,"2021-03-12",10,3339,1,382,4,2813,5,144,4,567,6,1457,9,2024,"California",9475,0.15377308707124,1150,0.265,3109,0.717
"3394","modoc",3394,"2021-03-13",4,3343,0,382,1,2814,3,147,1,568,3,1460,4,2028,"California",9475,0.154089709762533,1150,0.265,3109,0.717
"3395","modoc",3395,"2021-03-15",12,3355,1,383,10,2824,1,148,10,577,2,1462,11,2039,"California",9475,0.154300791556728,1150,0.265,3109,0.717
"3396","modoc",3396,"2021-03-16",173,3528,1,384,168,2992,4,152,42,491,131,1593,45,2084,"California",9475,0.168126649076517,1150,0.265,3109,0.717
"3397","modoc",3397,"2021-03-17",10,3538,1,385,4,2996,5,157,2,490,8,1601,7,2091,"California",9475,0.168970976253298,1150,0.265,3109,0.717
"3398","modoc",3398,"2021-03-18",67,3605,2,387,58,3054,7,164,35,500,32,1633,42,2133,"California",9475,0.172348284960422,1150,0.265,3109,0.717
"3399","modoc",3399,"2021-03-19",5,3610,0,387,0,3054,5,169,0,500,5,1638,5,2138,"California",9475,0.17287598944591,1150,0.265,3109,0.717
"3400","modoc",3400,"2021-03-20",6,3616,2,389,1,3055,3,172,1,499,5,1643,4,2142,"California",9475,0.173403693931398,1150,0.265,3109,0.717
"3401","modoc",3401,"2021-03-21",4,3620,1,390,1,3056,2,174,2,501,2,1645,4,2146,"California",9475,0.173614775725594,1150,0.265,3109,0.717
"3402","modoc",3402,"2021-03-22",18,3638,1,391,11,3067,6,180,12,513,6,1651,18,2164,"California",9475,0.174248021108179,1150,0.265,3109,0.717
"3403","modoc",3403,"2021-03-23",37,3675,7,398,27,3094,3,183,28,535,9,1660,31,2195,"California",9475,0.175197889182058,1150,0.265,3109,0.717
"3404","modoc",3404,"2021-03-24",29,3704,1,399,18,3112,10,193,2,520,27,1687,12,2207,"California",9475,0.178047493403694,1150,0.265,3109,0.717
"3405","modoc",3405,"2021-03-25",77,3781,1,400,74,3186,2,195,45,535,32,1719,47,2254,"California",9475,0.181424802110818,1150,0.265,3109,0.717
"3406","modoc",3406,"2021-03-26",7,3788,2,402,2,3188,3,198,2,535,5,1724,5,2259,"California",9475,0.181952506596306,1150,0.265,3109,0.717
"3407","modoc",3407,"2021-03-27",2,3790,0,402,1,3189,1,199,1,536,1,1725,2,2261,"California",9475,0.182058047493404,1150,0.265,3109,0.717
"3408","modoc",3408,"2021-03-28",2,3792,1,403,0,3189,1,200,0,535,2,1727,1,2262,"California",9475,0.182269129287599,1150,0.265,3109,0.717
"3409","modoc",3409,"2021-03-29",14,3806,1,404,5,3194,8,208,5,539,9,1736,13,2275,"California",9475,0.183218997361478,1150,0.265,3109,0.717
"3410","modoc",3410,"2021-03-30",55,3861,10,414,38,3232,7,215,21,533,34,1770,28,2303,"California",9475,0.186807387862797,1150,0.265,3109,0.717
"3411","modoc",3411,"2021-03-31",9,3870,3,417,2,3234,4,219,3,534,6,1776,7,2310,"California",9475,0.187440633245383,1150,0.265,3109,0.717
"3412","modoc",3412,"2021-04-01",167,4037,2,419,160,3394,5,224,32,436,135,1911,37,2347,"California",9475,0.201688654353562,1150,0.265,3109,0.717
"3413","modoc",3413,"2021-04-02",5,4042,0,419,2,3396,3,227,1,437,3,1914,4,2351,"California",9475,0.202005277044855,1150,0.265,3109,0.717
"3414","modoc",3414,"2021-04-03",5,4047,2,421,0,3396,3,230,2,439,2,1916,4,2355,"California",9475,0.20221635883905,1150,0.265,3109,0.717
"3415","modoc",3415,"2021-04-05",9,4056,0,421,9,3405,0,230,9,448,0,1916,9,2364,"California",9475,0.20221635883905,1150,0.265,3109,0.717
"3416","modoc",3416,"2021-04-06",24,4080,5,426,9,3414,10,240,6,446,18,1934,16,2380,"California",9475,0.204116094986807,1150,0.265,3109,0.717
"3417","modoc",3417,"2021-04-07",12,4092,1,427,4,3418,7,247,3,447,9,1943,10,2390,"California",9475,0.205065963060686,1150,0.265,3109,0.717
"3418","modoc",3418,"2021-04-08",97,4189,1,428,93,3511,3,250,26,405,71,2014,29,2419,"California",9475,0.212559366754617,1150,0.265,3109,0.717
"3419","modoc",3419,"2021-04-09",11,4200,2,430,6,3517,3,253,2,400,9,2023,4,2423,"California",9475,0.213509234828496,1150,0.265,3109,0.717
"3420","modoc",3420,"2021-04-10",5,4205,0,430,1,3518,4,257,0,399,5,2028,4,2427,"California",9475,0.214036939313984,1150,0.265,3109,0.717
"3421","modoc",3421,"2021-04-11",2,4207,2,432,0,3518,0,257,1,399,1,2029,1,2428,"California",9475,0.214142480211082,1150,0.265,3109,0.717
"3422","modoc",3422,"2021-04-12",15,4222,1,433,10,3528,4,261,2,394,11,2040,6,2434,"California",9475,0.215303430079156,1150,0.265,3109,0.717
"3423","modoc",3423,"2021-04-13",30,4252,29,462,1,3529,0,261,21,406,9,2049,21,2455,"California",9475,0.216253298153034,1150,0.265,3109,0.717
"3424","modoc",3424,"2021-04-14",2,4254,2,464,0,3529,0,261,1,406,1,2050,1,2456,"California",9475,0.216358839050132,1150,0.265,3109,0.717
"3425","modoc",3425,"2021-04-15",100,4354,0,464,100,3629,0,261,27,360,73,2123,27,2483,"California",9475,0.224063324538259,1150,0.265,3109,0.717
"3426","modoc",3426,"2021-04-16",4,4358,4,468,0,3629,0,261,3,362,1,2124,3,2486,"California",9475,0.224168865435356,1150,0.265,3109,0.717
"3427","modoc",3427,"2021-04-17",3,4361,2,470,1,3630,0,261,2,363,1,2125,2,2488,"California",9475,0.224274406332454,1150,0.265,3109,0.717
"3428","modoc",3428,"2021-04-18",1,4362,0,470,1,3631,0,261,1,364,0,2125,1,2489,"California",9475,0.224274406332454,1150,0.265,3109,0.717
"3429","modoc",3429,"2021-04-19",7,4369,1,471,6,3637,0,261,2,361,5,2130,2,2491,"California",9475,0.224802110817942,1150,0.265,3109,0.717
"3430","modoc",3430,"2021-04-20",27,4396,2,473,25,3662,0,261,9,352,18,2148,9,2500,"California",9475,0.226701846965699,1150,0.265,3109,0.717
"3431","modoc",3431,"2021-04-21",3,4399,3,476,0,3662,0,261,1,351,2,2150,1,2501,"California",9475,0.226912928759894,1150,0.265,3109,0.717
"3432","modoc",3432,"2021-04-22",98,4497,4,480,94,3756,0,261,41,335,57,2207,41,2542,"California",9475,0.232928759894459,1150,0.265,3109,0.717
"3433","modoc",3433,"2021-04-23",5,4502,1,481,4,3760,0,261,4,338,1,2208,4,2546,"California",9475,0.233034300791557,1150,0.265,3109,0.717
"3434","modoc",3434,"2021-04-24",3,4505,1,482,1,3761,1,262,2,340,1,2209,3,2549,"California",9475,0.233139841688654,1150,0.265,3109,0.717
"3435","modoc",3435,"2021-04-25",1,4506,1,483,0,3761,0,262,1,341,0,2209,1,2550,"California",9475,0.233139841688654,1150,0.265,3109,0.717
"3436","modoc",3436,"2021-04-26",8,4514,1,484,7,3768,0,262,3,339,5,2214,3,2553,"California",9475,0.233667546174142,1150,0.265,3109,0.717
"3437","modoc",3437,"2021-04-27",6,4520,4,488,1,3769,1,263,1,336,5,2219,2,2555,"California",9475,0.234195250659631,1150,0.265,3109,0.717
"3438","modoc",3438,"2021-04-28",5,4525,1,489,3,3772,1,264,1,334,4,2223,2,2557,"California",9475,0.234617414248021,1150,0.265,3109,0.717
"3439","modoc",3439,"2021-04-29",65,4590,2,491,63,3835,0,264,24,317,41,2264,24,2581,"California",9475,0.238944591029024,1150,0.265,3109,0.717
"3440","modoc",3440,"2021-04-30",5,4595,4,495,1,3836,0,264,3,318,2,2266,3,2584,"California",9475,0.239155672823219,1150,0.265,3109,0.717
"3441","modoc",3441,"2021-05-01",1,4596,1,496,0,3836,0,264,0,317,1,2267,0,2584,"California",9475,0.239261213720317,1150,0.265,3109,0.717
"3442","modoc",3442,"2021-05-02",4,4600,3,499,1,3837,0,264,3,319,1,2268,3,2587,"California",9475,0.239366754617414,1150,0.265,3109,0.717
"3443","modoc",3443,"2021-05-03",10,4610,0,499,9,3846,1,265,0,310,10,2278,1,2588,"California",9475,0.24042216358839,1150,0.265,3109,0.717
"3444","modoc",3444,"2021-05-04",11,4621,3,502,6,3852,2,267,5,311,6,2284,7,2595,"California",9475,0.241055408970976,1150,0.265,3109,0.717
"3445","modoc",3445,"2021-05-05",27,4648,24,526,2,3854,1,268,8,301,19,2303,9,2604,"California",9475,0.243060686015831,1150,0.265,3109,0.717
"3446","modoc",3446,"2021-05-06",53,4701,4,530,47,3901,2,270,20,290,33,2336,22,2626,"California",9475,0.246543535620053,1150,0.265,3109,0.717
"3447","modoc",3447,"2021-05-07",7,4708,3,533,2,3903,2,272,1,287,6,2342,3,2629,"California",9475,0.247176781002639,1150,0.265,3109,0.717
"3448","modoc",3448,"2021-05-08",2,4710,1,534,0,3903,1,273,0,286,2,2344,1,2630,"California",9475,0.247387862796834,1150,0.265,3109,0.717
"3449","mono",3449,"2020-12-18",1,1,1,1,0,0,0,0,1,1,0,0,1,1,"California",13961,0,4013,0.596,2513,0.373
"3450","mono",3450,"2020-12-19",5,6,5,6,0,0,0,0,5,6,0,0,5,6,"California",13961,0,4013,0.596,2513,0.373
"3451","mono",3451,"2020-12-20",7,13,7,13,0,0,0,0,7,13,0,0,7,13,"California",13961,0,4013,0.596,2513,0.373
"3452","mono",3452,"2020-12-21",24,37,17,30,7,7,0,0,24,37,0,0,24,37,"California",13961,0,4013,0.596,2513,0.373
"3453","mono",3453,"2020-12-22",66,103,65,95,1,8,0,0,66,103,0,0,66,103,"California",13961,0,4013,0.596,2513,0.373
"3454","mono",3454,"2020-12-23",70,173,42,137,28,36,0,0,70,173,0,0,70,173,"California",13961,0,4013,0.596,2513,0.373
"3455","mono",3455,"2020-12-24",3,176,1,138,2,38,0,0,3,176,0,0,3,176,"California",13961,0,4013,0.596,2513,0.373
"3456","mono",3456,"2020-12-26",3,179,3,141,0,38,0,0,3,179,0,0,3,179,"California",13961,0,4013,0.596,2513,0.373
"3457","mono",3457,"2020-12-28",94,273,63,204,31,69,0,0,94,273,0,0,94,273,"California",13961,0,4013,0.596,2513,0.373
"3458","mono",3458,"2020-12-29",29,302,29,233,0,69,0,0,29,302,0,0,29,302,"California",13961,0,4013,0.596,2513,0.373
"3459","mono",3459,"2020-12-30",77,379,36,269,41,110,0,0,77,379,0,0,77,379,"California",13961,0,4013,0.596,2513,0.373
"3460","mono",3460,"2020-12-31",4,383,1,270,3,113,0,0,4,383,0,0,4,383,"California",13961,0,4013,0.596,2513,0.373
"3461","mono",3461,"2021-01-01",4,387,4,274,0,113,0,0,4,387,0,0,4,387,"California",13961,0,4013,0.596,2513,0.373
"3462","mono",3462,"2021-01-02",2,389,2,276,0,113,0,0,2,389,0,0,2,389,"California",13961,0,4013,0.596,2513,0.373
"3463","mono",3463,"2021-01-04",1,390,0,276,1,114,0,0,1,390,0,0,1,390,"California",13961,0,4013,0.596,2513,0.373
"3464","mono",3464,"2021-01-05",45,435,2,278,43,157,0,0,44,433,1,1,44,434,"California",13961,7.16281068691354e-05,4013,0.596,2513,0.373
"3465","mono",3465,"2021-01-06",44,479,0,278,44,201,0,0,44,477,0,1,44,478,"California",13961,7.16281068691354e-05,4013,0.596,2513,0.373
"3466","mono",3466,"2021-01-07",55,534,3,281,52,253,0,0,54,530,1,2,54,532,"California",13961,0.000143256213738271,4013,0.596,2513,0.373
"3467","mono",3467,"2021-01-08",2,536,1,282,1,254,0,0,1,530,1,3,1,533,"California",13961,0.000214884320607406,4013,0.596,2513,0.373
"3468","mono",3468,"2021-01-09",4,540,4,286,0,254,0,0,0,526,4,7,0,533,"California",13961,0.000501396748083948,4013,0.596,2513,0.373
"3469","mono",3469,"2021-01-10",5,545,5,291,0,254,0,0,0,521,5,12,0,533,"California",13961,0.000859537282429625,4013,0.596,2513,0.373
"3470","mono",3470,"2021-01-11",8,553,5,296,3,257,0,0,4,521,4,16,4,537,"California",13961,0.00114604970990617,4013,0.596,2513,0.373
"3471","mono",3471,"2021-01-12",282,835,75,371,207,464,0,0,218,676,63,79,218,755,"California",13961,0.0056586204426617,4013,0.596,2513,0.373
"3472","mono",3472,"2021-01-13",233,1068,73,444,160,624,0,0,178,799,55,134,178,933,"California",13961,0.00959816632046415,4013,0.596,2513,0.373
"3473","mono",3473,"2021-01-14",73,1141,71,515,2,626,0,0,73,872,0,134,73,1006,"California",13961,0.00959816632046415,4013,0.596,2513,0.373
"3474","mono",3474,"2021-01-15",62,1203,2,517,60,686,0,0,62,934,0,134,62,1068,"California",13961,0.00959816632046415,4013,0.596,2513,0.373
"3475","mono",3475,"2021-01-16",4,1207,3,520,1,687,0,0,1,932,3,137,1,1069,"California",13961,0.00981305064107156,4013,0.596,2513,0.373
"3476","mono",3476,"2021-01-18",64,1271,55,575,9,696,0,0,2,872,62,199,2,1071,"California",13961,0.014253993266958,4013,0.596,2513,0.373
"3477","mono",3477,"2021-01-19",210,1481,208,783,2,698,0,0,172,1007,38,237,173,1244,"California",13961,0.0169758613279851,4013,0.596,2513,0.373
"3478","mono",3478,"2021-01-20",231,1712,199,982,32,730,0,0,170,1116,61,298,170,1414,"California",13961,0.0213451758470024,4013,0.596,2513,0.373
"3479","mono",3479,"2021-01-21",3,1715,3,985,0,730,0,0,3,1119,0,298,3,1417,"California",13961,0.0213451758470024,4013,0.596,2513,0.373
"3480","mono",3480,"2021-01-22",4,1719,0,985,4,734,0,0,4,1123,0,298,4,1421,"California",13961,0.0213451758470024,4013,0.596,2513,0.373
"3481","mono",3481,"2021-01-23",595,2314,595,1580,0,734,0,0,594,1716,1,299,594,2015,"California",13961,0.0214168039538715,4013,0.596,2513,0.373
"3482","mono",3482,"2021-01-25",203,2517,165,1745,38,772,0,0,164,1841,39,338,164,2179,"California",13961,0.0242103001217678,4013,0.596,2513,0.373
"3483","mono",3483,"2021-01-26",505,3022,503,2248,2,774,0,0,499,2334,6,344,499,2678,"California",13961,0.0246400687629826,4013,0.596,2513,0.373
"3484","mono",3484,"2021-01-27",5,3027,1,2249,4,778,0,0,5,2339,0,344,5,2683,"California",13961,0.0246400687629826,4013,0.596,2513,0.373
"3485","mono",3485,"2021-01-28",6,3033,2,2251,4,782,0,0,2,2337,4,348,2,2685,"California",13961,0.0249265811904591,4013,0.596,2513,0.373
"3486","mono",3486,"2021-01-30",202,3235,200,2451,2,784,0,0,201,2537,1,349,201,2886,"California",13961,0.0249982092973283,4013,0.596,2513,0.373
"3487","mono",3487,"2021-01-31",243,3478,138,2589,105,889,0,0,139,2572,104,453,139,3025,"California",13961,0.0324475324117184,4013,0.596,2513,0.373
"3488","mono",3488,"2021-02-01",27,3505,27,2616,0,889,0,0,0,2545,27,480,0,3025,"California",13961,0.034381491297185,4013,0.596,2513,0.373
"3489","mono",3489,"2021-02-02",5,3510,0,2616,5,894,0,0,2,2544,3,483,2,3027,"California",13961,0.0345963756177924,4013,0.596,2513,0.373
"3490","mono",3490,"2021-02-03",4,3514,2,2618,2,896,0,0,2,2544,2,485,2,3029,"California",13961,0.0347396318315307,4013,0.596,2513,0.373
"3491","mono",3491,"2021-02-04",211,3725,158,2776,53,949,0,0,90,2513,121,606,90,3119,"California",13961,0.0434066327626961,4013,0.596,2513,0.373
"3492","mono",3492,"2021-02-05",616,4341,610,3386,6,955,0,0,613,3123,3,609,613,3732,"California",13961,0.0436215170833035,4013,0.596,2513,0.373
"3493","mono",3493,"2021-02-06",139,4480,138,3524,1,956,0,0,138,3260,1,610,138,3870,"California",13961,0.0436931451901726,4013,0.596,2513,0.373
"3494","mono",3494,"2021-02-07",2,4482,0,3524,2,958,0,0,2,3262,0,610,2,3872,"California",13961,0.0436931451901726,4013,0.596,2513,0.373
"3495","mono",3495,"2021-02-08",172,4654,172,3696,0,958,0,0,15,3121,156,766,15,3887,"California",13961,0.0548671298617578,4013,0.596,2513,0.373
"3496","mono",3496,"2021-02-09",226,4880,6,3702,220,1178,0,0,14,2923,212,978,14,3901,"California",13961,0.0700522885180145,4013,0.596,2513,0.373
"3497","mono",3497,"2021-02-10",537,5417,187,3889,350,1528,0,0,194,2775,343,1321,195,4096,"California",13961,0.0946207291741279,4013,0.596,2513,0.373
"3498","mono",3498,"2021-02-11",7,5424,4,3893,3,1531,0,0,2,2772,5,1326,2,4098,"California",13961,0.0949788697084736,4013,0.596,2513,0.373
"3499","mono",3499,"2021-02-12",84,5508,20,3913,64,1595,0,0,26,2740,58,1384,26,4124,"California",13961,0.0991332999068835,4013,0.596,2513,0.373
"3500","mono",3500,"2021-02-13",586,6094,586,4499,0,1595,0,0,25,2205,560,1944,25,4149,"California",13961,0.139245039753599,4013,0.596,2513,0.373
"3501","mono",3501,"2021-02-15",167,6261,165,4664,2,1597,0,0,3,2046,162,2106,3,4152,"California",13961,0.150848793066399,4013,0.596,2513,0.373
"3502","mono",3502,"2021-02-16",516,6777,513,5177,3,1600,0,0,45,1623,468,2574,45,4197,"California",13961,0.184370747081155,4013,0.596,2513,0.373
"3503","mono",3503,"2021-02-17",6,6783,1,5178,5,1605,0,0,1,1619,5,2579,1,4198,"California",13961,0.1847288876155,4013,0.596,2513,0.373
"3504","mono",3504,"2021-02-18",3,6786,2,5180,1,1606,0,0,2,1620,1,2580,2,4200,"California",13961,0.184800515722369,4013,0.596,2513,0.373
"3505","mono",3505,"2021-02-19",54,6840,53,5233,1,1607,0,0,54,1674,0,2580,54,4254,"California",13961,0.184800515722369,4013,0.596,2513,0.373
"3506","mono",3506,"2021-02-20",4,6844,4,5237,0,1607,0,0,4,1678,0,2580,4,4258,"California",13961,0.184800515722369,4013,0.596,2513,0.373
"3507","mono",3507,"2021-02-21",5,6849,5,5242,0,1607,0,0,3,1679,2,2582,3,4261,"California",13961,0.184943771936108,4013,0.596,2513,0.373
"3508","mono",3508,"2021-02-22",285,7134,284,5526,1,1608,0,0,24,1443,260,2842,24,4285,"California",13961,0.203567079722083,4013,0.596,2513,0.373
"3509","mono",3509,"2021-02-23",135,7269,115,5641,20,1628,0,0,22,1352,113,2955,22,4307,"California",13961,0.211661055798295,4013,0.596,2513,0.373
"3510","mono",3510,"2021-02-24",8,7277,3,5644,5,1633,0,0,2,1348,6,2961,2,4309,"California",13961,0.21209082443951,4013,0.596,2513,0.373
"3511","mono",3511,"2021-02-25",5,7282,2,5646,3,1636,0,0,3,1350,1,2962,3,4312,"California",13961,0.212162452546379,4013,0.596,2513,0.373
"3512","mono",3512,"2021-02-26",597,7879,595,6241,2,1638,0,0,21,796,575,3537,21,4333,"California",13961,0.253348613996132,4013,0.596,2513,0.373
"3513","mono",3513,"2021-02-27",141,8020,137,6378,4,1642,0,0,4,665,135,3672,4,4337,"California",13961,0.263018408423465,4013,0.596,2513,0.373
"3514","mono",3514,"2021-03-01",2,8022,2,6380,0,1642,0,0,1,666,0,3672,1,4338,"California",13961,0.263018408423465,4013,0.596,2513,0.373
"3515","mono",3515,"2021-03-02",5,8027,3,6383,2,1644,0,0,3,667,2,3674,3,4341,"California",13961,0.263161664637204,4013,0.596,2513,0.373
"3516","mono",3516,"2021-03-03",82,8109,2,6385,80,1724,0,0,79,744,2,3676,79,4420,"California",13961,0.263304920850942,4013,0.596,2513,0.373
"3517","mono",3517,"2021-03-04",5,8114,1,6386,4,1728,0,0,3,745,2,3678,3,4423,"California",13961,0.26344817706468,4013,0.596,2513,0.373
"3518","mono",3518,"2021-03-05",37,8151,27,6413,10,1738,0,0,14,736,23,3701,14,4437,"California",13961,0.26509562352267,4013,0.596,2513,0.373
"3519","mono",3519,"2021-03-06",508,8659,17,6430,491,2229,0,0,500,1231,6,3707,501,4938,"California",13961,0.265525392163885,4013,0.596,2513,0.373
"3520","mono",3520,"2021-03-07",1,8660,0,6430,1,2230,0,0,0,1230,1,3708,0,4938,"California",13961,0.265597020270754,4013,0.596,2513,0.373
"3521","mono",3521,"2021-03-08",539,9199,11,6441,525,2755,3,3,530,1754,9,3717,533,5471,"California",13961,0.266241673232576,4013,0.596,2513,0.373
"3522","mono",3522,"2021-03-09",6,9205,2,6443,3,2758,1,4,3,1756,2,3719,4,5475,"California",13961,0.266384929446315,4013,0.596,2513,0.373
"3523","mono",3523,"2021-03-10",286,9491,90,6533,193,2951,3,7,9,1493,275,3994,12,5487,"California",13961,0.286082658835327,4013,0.596,2513,0.373
"3524","mono",3524,"2021-03-11",10,9501,0,6533,1,2952,9,16,0,1492,10,4004,9,5496,"California",13961,0.286798939904018,4013,0.596,2513,0.373
"3525","mono",3525,"2021-03-12",7,9508,1,6534,1,2953,5,21,0,1490,7,4011,5,5501,"California",13961,0.287300336652102,4013,0.596,2513,0.373
"3526","mono",3526,"2021-03-13",823,10331,386,6920,437,3390,0,21,815,2297,8,4019,815,6316,"California",13961,0.287873361507055,4013,0.596,2513,0.373
"3527","mono",3527,"2021-03-14",4,10335,4,6924,0,3390,0,21,1,2295,3,4022,1,6317,"California",13961,0.288088245827663,4013,0.596,2513,0.373
"3528","mono",3528,"2021-03-15",31,10366,23,6947,3,3393,5,26,14,2298,16,4038,19,6336,"California",13961,0.289234295537569,4013,0.596,2513,0.373
"3529","mono",3529,"2021-03-16",16,10382,6,6953,4,3397,6,32,8,2304,8,4046,14,6350,"California",13961,0.289807320392522,4013,0.596,2513,0.373
"3530","mono",3530,"2021-03-17",34,10416,5,6958,21,3418,8,40,22,2322,12,4058,30,6380,"California",13961,0.290666857674952,4013,0.596,2513,0.373
"3531","mono",3531,"2021-03-18",21,10437,2,6960,11,3429,8,48,9,2327,12,4070,17,6397,"California",13961,0.291526394957381,4013,0.596,2513,0.373
"3532","mono",3532,"2021-03-19",21,10458,1,6961,17,3446,3,51,17,2344,3,4073,20,6417,"California",13961,0.291741279277989,4013,0.596,2513,0.373
"3533","mono",3533,"2021-03-20",5,10463,3,6964,1,3447,1,52,4,2348,1,4074,5,6422,"California",13961,0.291812907384858,4013,0.596,2513,0.373
"3534","mono",3534,"2021-03-21",1,10464,1,6965,0,3447,0,52,1,2349,0,4074,1,6423,"California",13961,0.291812907384858,4013,0.596,2513,0.373
"3535","mono",3535,"2021-03-22",11,10475,0,6965,6,3453,5,57,5,2353,6,4080,10,6433,"California",13961,0.292242676026073,4013,0.596,2513,0.373
"3536","mono",3536,"2021-03-23",41,10516,5,6970,31,3484,5,62,18,2353,23,4103,23,6456,"California",13961,0.293890122484063,4013,0.596,2513,0.373
"3537","mono",3537,"2021-03-24",11,10527,1,6971,5,3489,5,67,5,2357,6,4109,10,6466,"California",13961,0.294319891125278,4013,0.596,2513,0.373
"3538","mono",3538,"2021-03-25",19,10546,3,6974,12,3501,4,71,12,2366,7,4116,16,6482,"California",13961,0.294821287873361,4013,0.596,2513,0.373
"3539","mono",3539,"2021-03-26",19,10565,3,6977,11,3512,5,76,10,2373,8,4124,15,6497,"California",13961,0.295394312728315,4013,0.596,2513,0.373
"3540","mono",3540,"2021-03-27",350,10915,347,7324,3,3515,0,76,324,2671,26,4150,324,6821,"California",13961,0.297256643506912,4013,0.596,2513,0.373
"3541","mono",3541,"2021-03-28",1,10916,1,7325,0,3515,0,76,1,2672,0,4150,1,6822,"California",13961,0.297256643506912,4013,0.596,2513,0.373
"3542","mono",3542,"2021-03-29",10,10926,3,7328,6,3521,1,77,8,2679,2,4152,9,6831,"California",13961,0.29739989972065,4013,0.596,2513,0.373
"3543","mono",3543,"2021-03-30",12,10938,0,7328,8,3529,4,81,7,2685,5,4157,11,6842,"California",13961,0.297758040254996,4013,0.596,2513,0.373
"3544","mono",3544,"2021-03-31",126,11064,7,7335,118,3647,1,82,47,2655,78,4235,48,6890,"California",13961,0.303345032590789,4013,0.596,2513,0.373
"3545","mono",3545,"2021-04-01",8,11072,0,7335,7,3654,1,83,3,2654,5,4240,4,6894,"California",13961,0.303703173125134,4013,0.596,2513,0.373
"3546","mono",3546,"2021-04-02",18,11090,2,7337,16,3670,0,83,7,2650,11,4251,7,6901,"California",13961,0.304491082300695,4013,0.596,2513,0.373
"3547","mono",3547,"2021-04-03",846,11936,365,7702,481,4151,0,83,34,1874,810,5061,34,6935,"California",13961,0.362509848864695,4013,0.596,2513,0.373
"3548","mono",3548,"2021-04-05",529,12465,17,7719,511,4662,1,84,30,1407,498,5559,31,6966,"California",13961,0.398180646085524,4013,0.596,2513,0.373
"3549","mono",3549,"2021-04-06",20,12485,2,7721,5,4667,13,97,2,1404,18,5577,15,6981,"California",13961,0.399469952009168,4013,0.596,2513,0.373
"3550","mono",3550,"2021-04-07",25,12510,3,7724,3,4670,19,116,4,1406,21,5598,23,7004,"California",13961,0.40097414225342,4013,0.596,2513,0.373
"3551","mono",3551,"2021-04-08",22,12532,3,7727,2,4672,17,133,4,1409,18,5616,21,7025,"California",13961,0.402263448177065,4013,0.596,2513,0.373
"3552","mono",3552,"2021-04-09",37,12569,4,7731,4,4676,29,162,7,1415,30,5646,36,7061,"California",13961,0.404412291383139,4013,0.596,2513,0.373
"3553","mono",3553,"2021-04-10",446,13015,2,7733,437,5113,7,169,28,1032,418,6064,35,7096,"California",13961,0.434352840054437,4013,0.596,2513,0.373
"3554","mono",3554,"2021-04-11",1,13016,1,7734,0,5113,0,169,0,1031,1,6065,0,7096,"California",13961,0.434424468161306,4013,0.596,2513,0.373
"3555","mono",3555,"2021-04-12",6,13022,0,7734,3,5116,3,172,3,1034,3,6068,6,7102,"California",13961,0.434639352481914,4013,0.596,2513,0.373
"3556","mono",3556,"2021-04-13",18,13040,2,7736,15,5131,1,173,12,1041,6,6074,13,7115,"California",13961,0.435069121123129,4013,0.596,2513,0.373
"3557","mono",3557,"2021-04-14",26,13066,1,7737,25,5156,0,173,7,1029,19,6093,7,7122,"California",13961,0.436430055153642,4013,0.596,2513,0.373
"3558","mono",3558,"2021-04-15",18,13084,3,7740,15,5171,0,173,9,1029,9,6102,9,7131,"California",13961,0.437074708115465,4013,0.596,2513,0.373
"3559","mono",3559,"2021-04-16",16,13100,1,7741,15,5186,0,173,5,1023,11,6113,5,7136,"California",13961,0.437862617291025,4013,0.596,2513,0.373
"3560","mono",3560,"2021-04-17",51,13151,2,7743,49,5235,0,173,44,1060,7,6120,44,7180,"California",13961,0.438364014039109,4013,0.596,2513,0.373
"3561","mono",3561,"2021-04-18",2,13153,1,7744,1,5236,0,173,2,1062,0,6120,2,7182,"California",13961,0.438364014039109,4013,0.596,2513,0.373
"3562","mono",3562,"2021-04-19",527,13680,319,8063,208,5444,0,173,201,939,324,6444,201,7383,"California",13961,0.461571520664709,4013,0.596,2513,0.373
"3563","mono",3563,"2021-04-20",17,13697,2,8065,15,5459,0,173,12,946,5,6449,12,7395,"California",13961,0.461929661199054,4013,0.596,2513,0.373
"3564","mono",3564,"2021-04-21",9,13706,1,8066,8,5467,0,173,4,945,5,6454,4,7399,"California",13961,0.4622878017334,4013,0.596,2513,0.373
"3565","mono",3565,"2021-04-22",27,13733,13,8079,14,5481,0,173,13,944,14,6468,13,7412,"California",13961,0.463290595229568,4013,0.596,2513,0.373
"3566","mono",3566,"2021-04-23",21,13754,2,8081,19,5500,0,173,11,945,10,6478,11,7423,"California",13961,0.464006876298259,4013,0.596,2513,0.373
"3567","mono",3567,"2021-04-24",34,13788,20,8101,14,5514,0,173,19,949,15,6493,19,7442,"California",13961,0.465081297901296,4013,0.596,2513,0.373
"3568","mono",3568,"2021-04-25",3,13791,2,8103,1,5515,0,173,3,952,0,6493,3,7445,"California",13961,0.465081297901296,4013,0.596,2513,0.373
"3569","mono",3569,"2021-04-26",8,13799,1,8104,7,5522,0,173,2,948,6,6499,2,7447,"California",13961,0.465511066542511,4013,0.596,2513,0.373
"3570","mono",3570,"2021-04-27",63,13862,40,8144,18,5540,5,178,49,988,14,6513,54,7501,"California",13961,0.466513860038679,4013,0.596,2513,0.373
"3571","mono",3571,"2021-04-28",63,13925,41,8185,18,5558,4,182,48,1027,13,6526,52,7553,"California",13961,0.467445025427978,4013,0.596,2513,0.373
"3572","mono",3572,"2021-04-29",8,13933,1,8186,4,5562,3,185,2,1026,6,6532,5,7558,"California",13961,0.467874794069193,4013,0.596,2513,0.373
"3573","mono",3573,"2021-04-30",16,13949,3,8189,10,5572,3,188,8,1029,8,6540,11,7569,"California",13961,0.468447818924146,4013,0.596,2513,0.373
"3574","mono",3574,"2021-05-01",110,14059,4,8193,106,5678,0,188,98,1115,12,6552,98,7667,"California",13961,0.469307356206575,4013,0.596,2513,0.373
"3575","mono",3575,"2021-05-03",2,14061,0,8193,1,5679,1,189,0,1114,2,6554,1,7668,"California",13961,0.469450612420314,4013,0.596,2513,0.373
"3576","mono",3576,"2021-05-04",23,14084,1,8194,16,5695,6,195,14,1125,9,6563,20,7688,"California",13961,0.470095265382136,4013,0.596,2513,0.373
"3577","mono",3577,"2021-05-05",52,14136,8,8202,41,5736,3,198,45,1166,7,6570,48,7736,"California",13961,0.47059666213022,4013,0.596,2513,0.373
"3578","mono",3578,"2021-05-06",13,14149,4,8206,8,5744,1,199,8,1170,5,6575,9,7745,"California",13961,0.470954802664566,4013,0.596,2513,0.373
"3579","mono",3579,"2021-05-07",28,14177,22,8228,6,5750,0,199,24,1190,4,6579,24,7769,"California",13961,0.471241315092042,4013,0.596,2513,0.373
"3580","mono",3580,"2021-05-08",50,14227,5,8233,45,5795,0,199,21,1182,29,6608,21,7790,"California",13961,0.473318530191247,4013,0.596,2513,0.373
"3581","monterey",3581,"2020-12-16",4,4,4,4,0,0,0,0,4,4,0,0,4,4,"California",448732,0,113953,0.695,46299,0.283
"3582","monterey",3582,"2020-12-17",83,87,83,87,0,0,0,0,83,87,0,0,83,87,"California",448732,0,113953,0.695,46299,0.283
"3583","monterey",3583,"2020-12-18",482,569,482,569,0,0,0,0,482,569,0,0,482,569,"California",448732,0,113953,0.695,46299,0.283
"3584","monterey",3584,"2020-12-19",581,1150,581,1150,0,0,0,0,581,1150,0,0,581,1150,"California",448732,0,113953,0.695,46299,0.283
"3585","monterey",3585,"2020-12-20",422,1572,422,1572,0,0,0,0,422,1572,0,0,422,1572,"California",448732,0,113953,0.695,46299,0.283
"3586","monterey",3586,"2020-12-21",719,2291,719,2291,0,0,0,0,719,2291,0,0,719,2291,"California",448732,0,113953,0.695,46299,0.283
"3587","monterey",3587,"2020-12-22",533,2824,520,2811,13,13,0,0,533,2824,0,0,533,2824,"California",448732,0,113953,0.695,46299,0.283
"3588","monterey",3588,"2020-12-23",437,3261,262,3073,175,188,0,0,437,3261,0,0,437,3261,"California",448732,0,113953,0.695,46299,0.283
"3589","monterey",3589,"2020-12-24",84,3345,10,3083,74,262,0,0,84,3345,0,0,84,3345,"California",448732,0,113953,0.695,46299,0.283
"3590","monterey",3590,"2020-12-25",6,3351,0,3083,6,268,0,0,6,3351,0,0,6,3351,"California",448732,0,113953,0.695,46299,0.283
"3591","monterey",3591,"2020-12-26",92,3443,5,3088,87,355,0,0,92,3443,0,0,92,3443,"California",448732,0,113953,0.695,46299,0.283
"3592","monterey",3592,"2020-12-27",7,3450,4,3092,3,358,0,0,7,3450,0,0,7,3450,"California",448732,0,113953,0.695,46299,0.283
"3593","monterey",3593,"2020-12-28",475,3925,25,3117,450,808,0,0,475,3925,0,0,475,3925,"California",448732,0,113953,0.695,46299,0.283
"3594","monterey",3594,"2020-12-29",898,4823,167,3284,731,1539,0,0,898,4823,0,0,898,4823,"California",448732,0,113953,0.695,46299,0.283
"3595","monterey",3595,"2020-12-30",568,5391,98,3382,470,2009,0,0,568,5391,0,0,568,5391,"California",448732,0,113953,0.695,46299,0.283
"3596","monterey",3596,"2020-12-31",33,5424,11,3393,22,2031,0,0,33,5424,0,0,33,5424,"California",448732,0,113953,0.695,46299,0.283
"3597","monterey",3597,"2021-01-01",12,5436,2,3395,10,2041,0,0,12,5436,0,0,12,5436,"California",448732,0,113953,0.695,46299,0.283
"3598","monterey",3598,"2021-01-02",137,5573,134,3529,3,2044,0,0,137,5573,0,0,137,5573,"California",448732,0,113953,0.695,46299,0.283
"3599","monterey",3599,"2021-01-03",30,5603,29,3558,1,2045,0,0,30,5603,0,0,30,5603,"California",448732,0,113953,0.695,46299,0.283
"3600","monterey",3600,"2021-01-04",411,6014,18,3576,393,2438,0,0,411,6014,0,0,411,6014,"California",448732,0,113953,0.695,46299,0.283
"3601","monterey",3601,"2021-01-05",752,6766,327,3903,425,2863,0,0,738,6738,14,14,738,6752,"California",448732,3.1199023024879e-05,113953,0.695,46299,0.283
"3602","monterey",3602,"2021-01-06",656,7422,172,4075,484,3347,0,0,634,7350,22,36,634,7386,"California",448732,8.02260592068317e-05,113953,0.695,46299,0.283
"3603","monterey",3603,"2021-01-07",746,8168,572,4647,174,3521,0,0,422,7450,322,358,422,7808,"California",448732,0.000797803588779049,113953,0.695,46299,0.283
"3604","monterey",3604,"2021-01-08",1087,9255,734,5381,353,3874,0,0,394,7151,693,1051,394,8202,"California",448732,0.00234215522851056,113953,0.695,46299,0.283
"3605","monterey",3605,"2021-01-09",965,10220,937,6318,28,3902,0,0,313,6812,652,1703,313,8515,"California",448732,0.00379513830081207,113953,0.695,46299,0.283
"3606","monterey",3606,"2021-01-10",274,10494,271,6589,3,3905,0,0,9,6556,265,1968,9,8524,"California",448732,0.00438569123664013,113953,0.695,46299,0.283
"3607","monterey",3607,"2021-01-11",1065,11559,985,7574,80,3985,0,0,362,6215,703,2671,362,8886,"California",448732,0.00595232789281798,113953,0.695,46299,0.283
"3608","monterey",3608,"2021-01-12",464,12023,387,7961,77,4062,0,0,203,6157,261,2932,203,9089,"California",448732,0.00653396682206751,113953,0.695,46299,0.283
"3609","monterey",3609,"2021-01-13",1217,13240,593,8554,624,4686,0,0,1171,7282,46,2978,1171,10260,"California",448732,0.00663647789772069,113953,0.695,46299,0.283
"3610","monterey",3610,"2021-01-14",1120,14360,165,8719,955,5641,0,0,1101,8368,19,2997,1105,11365,"California",448732,0.00667881942896874,113953,0.695,46299,0.283
"3611","monterey",3611,"2021-01-15",1046,15406,44,8763,1002,6643,0,0,1033,9388,13,3010,1033,12398,"California",448732,0.00670778995034898,113953,0.695,46299,0.283
"3612","monterey",3612,"2021-01-16",363,15769,300,9063,63,6706,0,0,358,9741,5,3015,358,12756,"California",448732,0.00671893245857215,113953,0.695,46299,0.283
"3613","monterey",3613,"2021-01-17",309,16078,288,9351,21,6727,0,0,296,10024,13,3028,296,13052,"California",448732,0.0067479029799524,113953,0.695,46299,0.283
"3614","monterey",3614,"2021-01-18",401,16479,50,9401,351,7078,0,0,380,10383,21,3049,380,13432,"California",448732,0.00679470151448972,113953,0.695,46299,0.283
"3615","monterey",3615,"2021-01-19",578,17057,396,9797,182,7260,0,0,419,10645,157,3206,419,13851,"California",448732,0.00714457627269729,113953,0.695,46299,0.283
"3616","monterey",3616,"2021-01-20",532,17589,270,10067,262,7522,0,0,326,10765,206,3412,326,14177,"California",448732,0.00760364761149194,113953,0.695,46299,0.283
"3617","monterey",3617,"2021-01-21",840,18429,92,10159,748,8270,0,0,730,11389,110,3522,734,14911,"California",448732,0.0078487827924017,113953,0.695,46299,0.283
"3618","monterey",3618,"2021-01-22",1050,19479,193,10352,857,9127,0,0,1011,12361,39,3561,1011,15922,"California",448732,0.00793569435654243,113953,0.695,46299,0.283
"3619","monterey",3619,"2021-01-23",240,19719,174,10526,66,9193,0,0,117,12357,122,3683,118,16040,"California",448732,0.00820757155718781,113953,0.695,46299,0.283
"3620","monterey",3620,"2021-01-24",56,19775,38,10564,18,9211,0,0,22,12345,34,3717,22,16062,"California",448732,0.00828334061310537,113953,0.695,46299,0.283
"3621","monterey",3621,"2021-01-25",782,20557,173,10737,609,9820,0,0,157,11884,618,4335,157,16219,"California",448732,0.00966055462948932,113953,0.695,46299,0.283
"3622","monterey",3622,"2021-01-26",928,21485,224,10961,704,10524,0,0,236,11428,692,5027,236,16455,"California",448732,0.0112026777675762,113953,0.695,46299,0.283
"3623","monterey",3623,"2021-01-27",858,22343,308,11269,550,11074,0,0,379,11328,479,5506,379,16834,"California",448732,0.012270130055356,113953,0.695,46299,0.283
"3624","monterey",3624,"2021-01-28",2021,24364,737,12006,1284,12358,0,0,1681,12671,340,5846,1683,18517,"California",448732,0.0130278206145316,113953,0.695,46299,0.283
"3625","monterey",3625,"2021-01-29",1229,25593,707,12713,522,12880,0,0,1112,13668,116,5962,1113,19630,"California",448732,0.0132863268053092,113953,0.695,46299,0.283
"3626","monterey",3626,"2021-01-30",442,26035,295,13008,147,13027,0,0,185,13596,257,6219,185,19815,"California",448732,0.0138590517279802,113953,0.695,46299,0.283
"3627","monterey",3627,"2021-01-31",493,26528,71,13079,422,13449,0,0,483,14070,10,6229,484,20299,"California",448732,0.0138813367444265,113953,0.695,46299,0.283
"3628","monterey",3628,"2021-02-01",1651,28179,1139,14218,512,13961,0,0,1088,14596,562,6791,1088,21387,"California",448732,0.0151337546687109,113953,0.695,46299,0.283
"3629","monterey",3629,"2021-02-02",2160,30339,463,14681,1697,15658,0,0,1553,15543,606,7397,1553,22940,"California",448732,0.0164842266653593,113953,0.695,46299,0.283
"3630","monterey",3630,"2021-02-03",2327,32666,1045,15726,1282,16940,0,0,1552,16324,771,8168,1552,24492,"California",448732,0.0182024014333723,113953,0.695,46299,0.283
"3631","monterey",3631,"2021-02-04",2771,35437,2087,17813,684,17624,0,0,2462,18479,307,8475,2462,26954,"California",448732,0.018886551438275,113953,0.695,46299,0.283
"3632","monterey",3632,"2021-02-05",3641,39078,2819,20632,822,18446,0,0,3206,21255,430,8905,3206,30160,"California",448732,0.0198448071454677,113953,0.695,46299,0.283
"3633","monterey",3633,"2021-02-06",1097,40175,379,21011,718,19164,0,0,755,21670,340,9245,755,30915,"California",448732,0.0206024977046433,113953,0.695,46299,0.283
"3634","monterey",3634,"2021-02-07",315,40490,270,21281,45,19209,0,0,96,21547,219,9464,96,31011,"California",448732,0.0210905395648182,113953,0.695,46299,0.283
"3635","monterey",3635,"2021-02-08",515,41005,290,21571,225,19434,0,0,426,21884,89,9553,426,31437,"California",448732,0.0212888762111906,113953,0.695,46299,0.283
"3636","monterey",3636,"2021-02-09",862,41867,674,22245,188,19622,0,0,552,22128,310,9863,554,31991,"California",448732,0.0219797117210273,113953,0.695,46299,0.283
"3637","monterey",3637,"2021-02-10",2083,43950,1113,23358,970,20592,0,0,1233,22512,850,10713,1234,33225,"California",448732,0.0238739381189663,113953,0.695,46299,0.283
"3638","monterey",3638,"2021-02-11",2498,46448,970,24328,1528,22120,0,0,1544,23106,952,11665,1546,34771,"California",448732,0.0259954716846581,113953,0.695,46299,0.283
"3639","monterey",3639,"2021-02-12",2586,49034,428,24756,2158,24278,0,0,1517,23556,1068,12733,1518,36289,"California",448732,0.0283755114411274,113953,0.695,46299,0.283
"3640","monterey",3640,"2021-02-13",1068,50102,50,24806,1018,25296,0,0,977,24442,91,12824,977,37266,"California",448732,0.0285783050907892,113953,0.695,46299,0.283
"3641","monterey",3641,"2021-02-14",591,50693,73,24879,518,25814,0,0,518,24887,73,12897,518,37784,"California",448732,0.0287409857108475,113953,0.695,46299,0.283
"3642","monterey",3642,"2021-02-15",1367,52060,160,25039,1207,27021,0,0,982,25487,383,13280,983,38767,"California",448732,0.0295945018407424,113953,0.695,46299,0.283
"3643","monterey",3643,"2021-02-16",1090,53150,244,25283,846,27867,0,0,866,26129,224,13504,866,39633,"California",448732,0.0300936862091404,113953,0.695,46299,0.283
"3644","monterey",3644,"2021-02-17",1937,55087,1164,26447,773,28640,0,0,1639,27474,296,13800,1641,41274,"California",448732,0.0307533226959521,113953,0.695,46299,0.283
"3645","monterey",3645,"2021-02-18",2226,57313,1177,27624,1049,29689,0,0,909,27082,1303,15103,911,42185,"California",448732,0.0336570603389105,113953,0.695,46299,0.283
"3646","monterey",3646,"2021-02-19",2938,60251,1534,29158,1404,31093,0,0,1346,26838,1591,16694,1347,43532,"California",448732,0.0372026064555236,113953,0.695,46299,0.283
"3647","monterey",3647,"2021-02-20",1007,61258,607,29765,400,31493,0,0,952,27736,54,16748,952,44484,"California",448732,0.0373229455443338,113953,0.695,46299,0.283
"3648","monterey",3648,"2021-02-21",1240,62498,1212,30977,28,31521,0,0,1170,28838,68,16816,1170,45654,"California",448732,0.0374744836561689,113953,0.695,46299,0.283
"3649","monterey",3649,"2021-02-22",976,63474,843,31820,133,31654,0,0,643,29150,331,17147,643,46297,"California",448732,0.0382121177005429,113953,0.695,46299,0.283
"3650","monterey",3650,"2021-02-23",953,64427,621,32441,332,31986,0,0,302,28803,650,17797,303,46600,"California",448732,0.0396606437695551,113953,0.695,46299,0.283
"3651","monterey",3651,"2021-02-24",2464,66891,1315,33756,1149,33135,0,0,1851,30047,608,18405,1852,48452,"California",448732,0.0410155727694927,113953,0.695,46299,0.283
"3652","monterey",3652,"2021-02-25",4402,71293,2412,36168,1990,35125,0,0,1472,28597,2923,21328,1473,49925,"California",448732,0.0475294830767585,113953,0.695,46299,0.283
"3653","monterey",3653,"2021-02-26",5246,76539,3080,39248,2166,37291,0,0,2625,28605,2618,23946,2626,52551,"California",448732,0.0533637003824109,113953,0.695,46299,0.283
"3654","monterey",3654,"2021-02-27",996,77535,182,39430,814,38105,0,0,805,29224,186,24132,805,53356,"California",448732,0.0537782016883128,113953,0.695,46299,0.283
"3655","monterey",3655,"2021-02-28",1528,79063,81,39511,1447,39552,0,0,1066,29833,457,24589,1066,54422,"California",448732,0.0547966269399107,113953,0.695,46299,0.283
"3656","monterey",3656,"2021-03-01",1281,80344,139,39650,1139,40691,3,3,744,30048,533,25122,748,55170,"California",448732,0.0559844183165007,113953,0.695,46299,0.283
"3657","monterey",3657,"2021-03-02",2730,83074,1721,41371,1009,41700,0,3,1878,31078,848,25970,1878,57048,"California",448732,0.0578741877111505,113953,0.695,46299,0.283
"3658","monterey",3658,"2021-03-03",3201,86275,1241,42612,1960,43660,0,3,1262,30404,1937,27907,1263,58311,"California",448732,0.062190795396807,113953,0.695,46299,0.283
"3659","monterey",3659,"2021-03-04",4550,90825,1468,44080,3082,46742,0,3,2951,31760,1595,29502,2951,61262,"California",448732,0.0657452555199986,113953,0.695,46299,0.283
"3660","monterey",3660,"2021-03-05",3589,94414,1623,45703,1689,48431,277,280,2957,34363,631,30133,3234,64496,"California",448732,0.0671514400577628,113953,0.695,46299,0.283
"3661","monterey",3661,"2021-03-06",5037,99451,1067,46770,3667,52098,303,583,4133,37896,901,31034,4434,68930,"California",448732,0.0691593200395782,113953,0.695,46299,0.283
"3662","monterey",3662,"2021-03-07",520,99971,108,46878,167,52265,245,828,233,38085,287,31321,476,69406,"California",448732,0.0697989000115882,113953,0.695,46299,0.283
"3663","monterey",3663,"2021-03-08",1658,101629,326,47204,943,53208,389,1217,1119,39052,539,31860,1506,70912,"California",448732,0.071000062398046,113953,0.695,46299,0.283
"3664","monterey",3664,"2021-03-09",1906,103535,678,47882,952,54160,276,1493,1417,40255,488,32348,1691,72603,"California",448732,0.0720875712006275,113953,0.695,46299,0.283
"3665","monterey",3665,"2021-03-10",3123,106658,1022,48904,1613,55773,488,1981,1418,40462,1698,34046,1905,74508,"California",448732,0.0758715669932164,113953,0.695,46299,0.283
"3666","monterey",3666,"2021-03-11",4106,110764,1407,50311,2326,58099,373,2354,2345,41426,1754,35800,2718,77226,"California",448732,0.0797803588779049,113953,0.695,46299,0.283
"3667","monterey",3667,"2021-03-12",4319,115083,2047,52358,2137,60236,135,2489,2636,42516,1680,37480,2770,79996,"California",448732,0.0835242416408903,113953,0.695,46299,0.283
"3668","monterey",3668,"2021-03-13",5241,120324,960,53318,3934,64170,347,2836,3934,45491,1307,38787,4282,84278,"California",448732,0.0864368932904273,113953,0.695,46299,0.283
"3669","monterey",3669,"2021-03-14",2147,122471,1325,54643,797,64967,25,2861,576,44533,1559,40346,601,84879,"California",448732,0.089911127354412,113953,0.695,46299,0.283
"3670","monterey",3670,"2021-03-15",3940,126411,1265,55908,2386,67353,289,3150,2255,45395,1681,42027,2543,87422,"California",448732,0.0936572386190421,113953,0.695,46299,0.283
"3671","monterey",3671,"2021-03-16",3491,129902,573,56481,2543,69896,375,3525,2080,46436,1410,43437,2451,89873,"California",448732,0.0967994259379763,113953,0.695,46299,0.283
"3672","monterey",3672,"2021-03-17",5706,135608,2336,58817,3117,73013,253,3778,4111,49217,1588,45025,4369,94242,"California",448732,0.100338286549655,113953,0.695,46299,0.283
"3673","monterey",3673,"2021-03-18",4354,139962,2154,60971,2033,75046,167,3945,2999,51072,1349,46374,3204,97446,"California",448732,0.103344535268267,113953,0.695,46299,0.283
"3674","monterey",3674,"2021-03-19",5391,145353,2557,63528,2691,77737,143,4088,4118,54066,1268,47642,4262,101708,"California",448732,0.106170275353663,113953,0.695,46299,0.283
"3675","monterey",3675,"2021-03-20",3310,148663,420,63948,2195,79932,695,4783,2232,55918,1075,48717,2927,104635,"California",448732,0.108565914621645,113953,0.695,46299,0.283
"3676","monterey",3676,"2021-03-21",624,149287,201,64149,415,80347,8,4791,557,56417,65,48782,564,105199,"California",448732,0.108710767228546,113953,0.695,46299,0.283
"3677","monterey",3677,"2021-03-22",2459,151746,1434,65583,963,81310,62,4853,2250,58522,205,48987,2310,107509,"California",448732,0.109167610065696,113953,0.695,46299,0.283
"3678","monterey",3678,"2021-03-23",3973,155719,2351,67934,1579,82889,43,4896,2517,59630,1451,50438,2559,110068,"California",448732,0.11240116595206,113953,0.695,46299,0.283
"3679","monterey",3679,"2021-03-24",4988,160707,2088,70022,2591,85480,309,5205,3633,62219,1351,51789,3940,114008,"California",448732,0.115411871673961,113953,0.695,46299,0.283
"3680","monterey",3680,"2021-03-25",5213,165920,1212,71234,3644,89124,357,5562,2589,62550,2617,54406,2948,116956,"California",448732,0.121243860477969,113953,0.695,46299,0.283
"3681","monterey",3681,"2021-03-26",5293,171213,2603,73837,2624,91748,66,5628,2654,62642,2630,57036,2722,119678,"California",448732,0.127104819803357,113953,0.695,46299,0.283
"3682","monterey",3682,"2021-03-27",4761,175974,1419,75256,3086,94834,256,5884,3050,64240,1708,58744,3306,122984,"California",448732,0.130911100612392,113953,0.695,46299,0.283
"3683","monterey",3683,"2021-03-28",1107,177081,334,75590,764,95598,9,5893,623,64393,479,59223,632,123616,"California",448732,0.131978552900172,113953,0.695,46299,0.283
"3684","monterey",3684,"2021-03-29",3168,180249,1404,76994,1750,97348,14,5907,1951,65151,1210,60433,1968,125584,"California",448732,0.134675039890179,113953,0.695,46299,0.283
"3685","monterey",3685,"2021-03-30",4437,184686,2131,79125,2263,99611,43,5950,2751,66273,1676,62109,2798,128382,"California",448732,0.138410008646586,113953,0.695,46299,0.283
"3686","monterey",3686,"2021-03-31",5290,189976,2379,81504,2122,101733,789,6739,3344,68454,1943,64052,4124,132506,"California",448732,0.142739987342111,113953,0.695,46299,0.283
"3687","monterey",3687,"2021-04-01",6037,196013,2070,83574,3559,105292,408,7147,3027,68890,2995,67047,3431,135937,"California",448732,0.14941434976779,113953,0.695,46299,0.283
"3688","monterey",3688,"2021-04-02",4666,200679,2241,85815,2364,107656,61,7208,3170,70629,1495,68542,3234,139171,"California",448732,0.152745959726518,113953,0.695,46299,0.283
"3689","monterey",3689,"2021-04-03",5776,206455,1106,86921,3649,111305,1021,8229,1187,68258,4573,73115,2202,141373,"California",448732,0.162936897747431,113953,0.695,46299,0.283
"3690","monterey",3690,"2021-04-04",753,207208,156,87077,583,111888,14,8243,485,68491,268,73383,501,141874,"California",448732,0.163534136188193,113953,0.695,46299,0.283
"3691","monterey",3691,"2021-04-05",3973,211181,2465,89542,1280,113168,228,8471,1463,67676,2505,75888,1690,143564,"California",448732,0.169116532808001,113953,0.695,46299,0.283
"3692","monterey",3692,"2021-04-06",3344,214525,1321,90863,1550,114718,473,8944,1122,67048,2220,78108,1592,145156,"California",448732,0.174063806459089,113953,0.695,46299,0.283
"3693","monterey",3693,"2021-04-07",5486,220011,1366,92229,3609,118327,511,9455,2645,67370,2830,80938,3152,148308,"California",448732,0.180370466113404,113953,0.695,46299,0.283
"3694","monterey",3694,"2021-04-08",6466,226477,3447,95676,2217,120544,802,10257,3168,68049,3292,84230,3971,152279,"California",448732,0.18770669352754,113953,0.695,46299,0.283
"3695","monterey",3695,"2021-04-09",5505,231982,3351,99027,1522,122066,632,10889,2219,67616,3283,87513,2850,155129,"California",448732,0.195022864426874,113953,0.695,46299,0.283
"3696","monterey",3696,"2021-04-10",10021,242003,4874,103901,3000,125066,2147,13036,4895,69538,5117,92630,7039,162168,"California",448732,0.206426107342467,113953,0.695,46299,0.283
"3697","monterey",3697,"2021-04-11",5414,247417,4247,108148,566,125632,601,13637,4371,73470,1037,93667,4969,167137,"California",448732,0.208737063547953,113953,0.695,46299,0.283
"3698","monterey",3698,"2021-04-12",4057,251474,1843,109991,1903,127535,311,13948,905,71672,3014,96681,1216,168353,"California",448732,0.21545376750488,113953,0.695,46299,0.283
"3699","monterey",3699,"2021-04-13",3123,254597,720,110711,2398,129933,5,13953,1497,71567,1608,98289,1503,169856,"California",448732,0.219037198149452,113953,0.695,46299,0.283
"3700","monterey",3700,"2021-04-14",6562,261159,3111,113822,3449,133382,2,13955,1798,68616,4751,103040,1800,171656,"California",448732,0.229624809463109,113953,0.695,46299,0.283
"3701","monterey",3701,"2021-04-15",5741,266900,3885,117707,1856,135238,0,13955,3825,70555,1886,104926,3825,175481,"California",448732,0.23382776356489,113953,0.695,46299,0.283
"3702","monterey",3702,"2021-04-16",4665,271565,2391,120098,2260,137498,14,13969,2175,70265,2479,107405,2189,177670,"California",448732,0.239352219141938,113953,0.695,46299,0.283
"3703","monterey",3703,"2021-04-17",5511,277076,1340,121438,4171,141669,0,13969,3686,72140,1811,109216,3686,181356,"California",448732,0.24338803562037,113953,0.695,46299,0.283
"3704","monterey",3704,"2021-04-18",834,277910,253,121691,581,142250,0,13969,235,71780,595,109811,235,181591,"California",448732,0.244713994098928,113953,0.695,46299,0.283
"3705","monterey",3705,"2021-04-19",3667,281577,1283,122974,2384,144634,0,13969,1751,71623,1908,111719,1751,183342,"California",448732,0.24896597523689,113953,0.695,46299,0.283
"3706","monterey",3706,"2021-04-20",3749,285326,1568,124542,2181,146815,0,13969,1544,70984,2184,113903,1545,184887,"California",448732,0.253833022828771,113953,0.695,46299,0.283
"3707","monterey",3707,"2021-04-21",5776,291102,3151,127693,2625,149440,0,13969,2831,70907,2910,116813,2833,187720,"California",448732,0.260317962614656,113953,0.695,46299,0.283
"3708","monterey",3708,"2021-04-22",4694,295796,1011,128704,3683,153123,0,13969,1947,70145,2709,119522,1947,189667,"California",448732,0.266354973569971,113953,0.695,46299,0.283
"3709","monterey",3709,"2021-04-23",5625,301421,2627,131331,2997,156120,1,13970,2210,68962,3397,122919,2214,191881,"California",448732,0.273925193656793,113953,0.695,46299,0.283
"3710","monterey",3710,"2021-04-24",4132,305553,583,131914,3549,159669,0,13970,1530,67921,2571,125490,1530,193411,"California",448732,0.279654671385147,113953,0.695,46299,0.283
"3711","monterey",3711,"2021-04-25",1230,306783,602,132516,628,160297,0,13970,786,68272,435,125925,786,194197,"California",448732,0.280624069600563,113953,0.695,46299,0.283
"3712","monterey",3712,"2021-04-26",3402,310185,2143,134659,1242,161539,17,13987,858,66628,2519,128444,875,195072,"California",448732,0.286237665243397,113953,0.695,46299,0.283
"3713","monterey",3713,"2021-04-27",2499,312684,864,135523,1518,163057,117,14104,1091,66433,1402,129846,1207,196279,"California",448732,0.289362024549174,113953,0.695,46299,0.283
"3714","monterey",3714,"2021-04-28",3493,316177,1357,136880,1998,165055,138,14242,2172,67432,1308,131154,2307,198586,"California",448732,0.292276904700356,113953,0.695,46299,0.283
"3715","monterey",3715,"2021-04-29",4376,320553,2404,139284,1896,166951,76,14318,1631,66405,2735,133889,1708,200294,"California",448732,0.29837185669843,113953,0.695,46299,0.283
"3716","monterey",3716,"2021-04-30",3075,323628,1654,140938,1345,168296,76,14394,759,64930,2308,136197,833,201127,"California",448732,0.303515238494246,113953,0.695,46299,0.283
"3717","monterey",3717,"2021-05-01",5604,329232,4229,145167,1335,169631,40,14434,679,60737,4910,141107,717,201844,"California",448732,0.3144571815694,113953,0.695,46299,0.283
"3718","monterey",3718,"2021-05-02",4349,333581,3925,149092,397,170028,27,14461,324,57076,4012,145119,351,202195,"California",448732,0.323397930167672,113953,0.695,46299,0.283
"3719","monterey",3719,"2021-05-03",2523,336104,1567,150659,839,170867,117,14578,583,55847,1929,147048,700,202895,"California",448732,0.327696709840172,113953,0.695,46299,0.283
"3720","monterey",3720,"2021-05-04",1726,337830,590,151249,1045,171912,91,14669,624,55475,1088,148136,716,203611,"California",448732,0.330121319629534,113953,0.695,46299,0.283
"3721","monterey",3721,"2021-05-05",3217,341047,1184,152433,1948,173860,85,14754,1033,54420,2173,150309,1118,204729,"California",448732,0.334963853703324,113953,0.695,46299,0.283
"3722","monterey",3722,"2021-05-06",4072,345119,2709,155142,1152,175012,211,14965,1115,52802,2944,153253,1326,206055,"California",448732,0.341524562545127,113953,0.695,46299,0.283
"3723","monterey",3723,"2021-05-07",1911,347030,934,156076,882,175894,95,15060,695,52381,1209,154462,788,206843,"California",448732,0.34421882103349,113953,0.695,46299,0.283
"3724","monterey",3724,"2021-05-08",2509,349539,1348,157424,840,176734,321,15381,865,51929,1634,156096,1182,208025,"California",448732,0.347860192720822,113953,0.695,46299,0.283
"3725","napa",3725,"2020-12-16",12,12,12,12,0,0,0,0,12,12,0,0,12,12,"California",139652,0,49817,0.691,20676,0.287
"3726","napa",3726,"2020-12-17",44,56,44,56,0,0,0,0,44,56,0,0,44,56,"California",139652,0,49817,0.691,20676,0.287
"3727","napa",3727,"2020-12-18",101,157,101,157,0,0,0,0,101,157,0,0,101,157,"California",139652,0,49817,0.691,20676,0.287
"3728","napa",3728,"2020-12-19",221,378,221,378,0,0,0,0,221,378,0,0,221,378,"California",139652,0,49817,0.691,20676,0.287
"3729","napa",3729,"2020-12-20",189,567,189,567,0,0,0,0,189,567,0,0,189,567,"California",139652,0,49817,0.691,20676,0.287
"3730","napa",3730,"2020-12-21",311,878,311,878,0,0,0,0,312,879,0,0,312,879,"California",139652,0,49817,0.691,20676,0.287
"3731","napa",3731,"2020-12-22",340,1218,331,1209,9,9,0,0,340,1219,0,0,340,1219,"California",139652,0,49817,0.691,20676,0.287
"3732","napa",3732,"2020-12-23",428,1646,318,1527,110,119,0,0,428,1647,0,0,428,1647,"California",139652,0,49817,0.691,20676,0.287
"3733","napa",3733,"2020-12-24",139,1785,78,1605,61,180,0,0,139,1786,0,0,139,1786,"California",139652,0,49817,0.691,20676,0.287
"3734","napa",3734,"2020-12-25",1,1786,1,1606,0,180,0,0,1,1787,0,0,1,1787,"California",139652,0,49817,0.691,20676,0.287
"3735","napa",3735,"2020-12-26",39,1825,11,1617,28,208,0,0,39,1826,0,0,39,1826,"California",139652,0,49817,0.691,20676,0.287
"3736","napa",3736,"2020-12-27",32,1857,16,1633,16,224,0,0,32,1858,0,0,32,1858,"California",139652,0,49817,0.691,20676,0.287
"3737","napa",3737,"2020-12-28",252,2109,186,1819,66,290,0,0,281,2139,0,0,281,2139,"California",139652,0,49817,0.691,20676,0.287
"3738","napa",3738,"2020-12-29",273,2382,214,2033,59,349,0,0,307,2446,0,0,307,2446,"California",139652,0,49817,0.691,20676,0.287
"3739","napa",3739,"2020-12-30",628,3010,485,2518,143,492,0,0,636,3082,0,0,636,3082,"California",139652,0,49817,0.691,20676,0.287
"3740","napa",3740,"2020-12-31",459,3469,371,2889,88,580,0,0,459,3541,0,0,459,3541,"California",139652,0,49817,0.691,20676,0.287
"3741","napa",3741,"2021-01-01",1,3470,1,2890,0,580,0,0,1,3542,0,0,1,3542,"California",139652,0,49817,0.691,20676,0.287
"3742","napa",3742,"2021-01-02",98,3568,93,2983,5,585,0,0,98,3640,0,0,98,3640,"California",139652,0,49817,0.691,20676,0.287
"3743","napa",3743,"2021-01-03",13,3581,11,2994,2,587,0,0,9,3649,0,0,9,3649,"California",139652,0,49817,0.691,20676,0.287
"3744","napa",3744,"2021-01-04",107,3688,64,3058,43,630,0,0,107,3756,0,0,107,3756,"California",139652,0,49817,0.691,20676,0.287
"3745","napa",3745,"2021-01-05",162,3850,85,3143,77,707,0,0,145,3877,24,24,145,3901,"California",139652,0.000171855755735686,49817,0.691,20676,0.287
"3746","napa",3746,"2021-01-06",460,4310,115,3258,345,1052,0,0,396,4211,62,86,396,4297,"California",139652,0.000615816458052874,49817,0.691,20676,0.287
"3747","napa",3747,"2021-01-07",499,4809,235,3493,264,1316,0,0,398,4509,100,186,398,4695,"California",139652,0.00133188210695157,49817,0.691,20676,0.287
"3748","napa",3748,"2021-01-08",443,5252,227,3720,216,1532,0,0,262,4591,180,366,262,4957,"California",139652,0.00262080027496921,49817,0.691,20676,0.287
"3749","napa",3749,"2021-01-09",325,5577,300,4020,25,1557,0,0,189,4644,136,502,189,5146,"California",139652,0.00359464955747143,49817,0.691,20676,0.287
"3750","napa",3750,"2021-01-10",186,5763,103,4123,83,1640,0,0,109,4676,77,579,109,5255,"California",139652,0.00414602010712342,49817,0.691,20676,0.287
"3751","napa",3751,"2021-01-11",883,6646,426,4549,457,2097,0,0,510,4814,374,953,512,5767,"California",139652,0.00682410563400453,49817,0.691,20676,0.287
"3752","napa",3752,"2021-01-12",1313,7959,370,4919,943,3040,0,0,998,5497,315,1268,998,6765,"California",139652,0.0090797124280354,49817,0.691,20676,0.287
"3753","napa",3753,"2021-01-13",1311,9270,264,5183,1047,4087,0,0,1149,6486,161,1429,1150,7915,"California",139652,0.0102325781227623,49817,0.691,20676,0.287
"3754","napa",3754,"2021-01-14",1053,10323,173,5356,880,4967,0,0,935,7305,116,1545,935,8850,"California",139652,0.0110632142754848,49817,0.691,20676,0.287
"3755","napa",3755,"2021-01-15",1457,11780,385,5741,1072,6039,0,0,1308,8457,157,1702,1309,10159,"California",139652,0.0121874373442557,49817,0.691,20676,0.287
"3756","napa",3756,"2021-01-16",357,12137,134,5875,223,6262,0,0,339,8778,18,1720,339,10498,"California",139652,0.0123163291610575,49817,0.691,20676,0.287
"3757","napa",3757,"2021-01-17",341,12478,176,6051,165,6427,0,0,331,9099,10,1730,331,10829,"California",139652,0.0123879357259474,49817,0.691,20676,0.287
"3758","napa",3758,"2021-01-18",1081,13559,197,6248,884,7311,0,0,990,9998,91,1821,990,11819,"California",139652,0.0130395554664452,49817,0.691,20676,0.287
"3759","napa",3759,"2021-01-19",1009,14568,404,6652,605,7916,0,0,767,10524,241,2062,767,12586,"California",139652,0.014765273680291,49817,0.691,20676,0.287
"3760","napa",3760,"2021-01-20",826,15394,185,6837,641,8557,0,0,643,10986,181,2243,643,13229,"California",139652,0.0160613525047976,49817,0.691,20676,0.287
"3761","napa",3761,"2021-01-21",1336,16730,374,7211,962,9519,0,0,1081,11814,254,2497,1082,14311,"California",139652,0.0178801592530003,49817,0.691,20676,0.287
"3762","napa",3762,"2021-01-22",1541,18271,412,7623,1129,10648,0,0,1214,12703,326,2823,1215,15526,"California",139652,0.02021453326841,49817,0.691,20676,0.287
"3763","napa",3763,"2021-01-23",398,18669,318,7941,80,10728,0,0,336,12977,62,2885,336,15862,"California",139652,0.0206584939707272,49817,0.691,20676,0.287
"3764","napa",3764,"2021-01-24",265,18934,188,8129,77,10805,0,0,208,13128,57,2942,208,16070,"California",139652,0.0210666513905995,49817,0.691,20676,0.287
"3765","napa",3765,"2021-01-25",1521,20455,231,8360,1290,12095,0,0,1431,14469,90,3032,1431,17501,"California",139652,0.0217111104746083,49817,0.691,20676,0.287
"3766","napa",3766,"2021-01-26",882,21337,286,8646,596,12691,0,0,788,15164,94,3126,789,18290,"California",139652,0.0223842121845731,49817,0.691,20676,0.287
"3767","napa",3767,"2021-01-27",627,21964,221,8867,406,13097,0,0,471,15480,156,3282,472,18762,"California",139652,0.023501274596855,49817,0.691,20676,0.287
"3768","napa",3768,"2021-01-28",389,22353,176,9043,213,13310,0,0,197,15487,190,3472,197,18959,"California",139652,0.0248617993297626,49817,0.691,20676,0.287
"3769","napa",3769,"2021-01-29",256,22609,65,9108,191,13501,0,0,161,15553,95,3567,161,19120,"California",139652,0.0255420616962163,49817,0.691,20676,0.287
"3770","napa",3770,"2021-01-30",805,23414,696,9804,109,13610,0,0,641,16030,164,3731,641,19761,"California",139652,0.0267164093604102,49817,0.691,20676,0.287
"3771","napa",3771,"2021-01-31",656,24070,625,10429,31,13641,0,0,630,16634,26,3757,630,20391,"California",139652,0.0269025864291238,49817,0.691,20676,0.287
"3772","napa",3772,"2021-02-01",315,24385,110,10539,205,13846,0,0,163,16645,152,3909,163,20554,"California",139652,0.0279910062154498,49817,0.691,20676,0.287
"3773","napa",3773,"2021-02-02",608,24993,281,10820,327,14173,0,0,298,16636,307,4216,298,20852,"California",139652,0.0301893277575688,49817,0.691,20676,0.287
"3774","napa",3774,"2021-02-03",746,25739,310,11130,436,14609,0,0,431,16753,314,4530,431,21283,"California",139652,0.0324377738951107,49817,0.691,20676,0.287
"3775","napa",3775,"2021-02-04",789,26528,373,11503,416,15025,0,0,441,16848,346,4876,441,21724,"California",139652,0.0349153610403002,49817,0.691,20676,0.287
"3776","napa",3776,"2021-02-05",711,27239,311,11814,400,15425,0,0,343,16823,368,5244,343,22067,"California",139652,0.0375504826282474,49817,0.691,20676,0.287
"3777","napa",3777,"2021-02-06",434,27673,146,11960,288,15713,0,0,328,17045,106,5350,328,22395,"California",139652,0.03830951221608,49817,0.691,20676,0.287
"3778","napa",3778,"2021-02-07",176,27849,163,12123,13,15726,0,0,71,17011,105,5455,71,22466,"California",139652,0.0390613811474236,49817,0.691,20676,0.287
"3779","napa",3779,"2021-02-08",837,28686,191,12314,646,16372,0,0,274,16725,560,6015,274,22740,"California",139652,0.0430713487812563,49817,0.691,20676,0.287
"3780","napa",3780,"2021-02-09",1079,29765,444,12758,635,17007,0,0,438,16522,641,6656,438,23178,"California",139652,0.0476613295906969,49817,0.691,20676,0.287
"3781","napa",3781,"2021-02-10",1720,31485,193,12951,1527,18534,0,0,452,15710,1265,7921,453,23631,"California",139652,0.0567195600492653,49817,0.691,20676,0.287
"3782","napa",3782,"2021-02-11",1496,32981,195,13146,1301,19835,0,0,407,15042,1076,8997,408,24039,"California",139652,0.0644244264314152,49817,0.691,20676,0.287
"3783","napa",3783,"2021-02-12",2166,35147,843,13989,1323,21158,0,0,725,14330,1437,10434,725,24764,"California",139652,0.0747142898060894,49817,0.691,20676,0.287
"3784","napa",3784,"2021-02-13",499,35646,52,14041,447,21605,0,0,313,14457,186,10620,313,25077,"California",139652,0.076046171913041,49817,0.691,20676,0.287
"3785","napa",3785,"2021-02-14",356,36002,89,14130,267,21872,0,0,194,14489,162,10782,194,25271,"California",139652,0.0772061982642569,49817,0.691,20676,0.287
"3786","napa",3786,"2021-02-15",876,36878,183,14313,693,22565,0,0,221,14057,653,11435,221,25492,"California",139652,0.0818821069515653,49817,0.691,20676,0.287
"3787","napa",3787,"2021-02-16",1288,38166,597,14910,691,23256,0,0,612,13995,674,12109,612,26104,"California",139652,0.0867083894251425,49817,0.691,20676,0.287
"3788","napa",3788,"2021-02-17",1051,39217,534,15444,517,23773,0,0,481,13908,568,12677,481,26585,"California",139652,0.0907756423108871,49817,0.691,20676,0.287
"3789","napa",3789,"2021-02-18",1902,41119,486,15930,1416,25189,0,0,659,13327,1240,13917,659,27244,"California",139652,0.0996548563572308,49817,0.691,20676,0.287
"3790","napa",3790,"2021-02-19",1483,42602,588,16518,895,26084,0,0,677,13199,805,14722,677,27921,"California",139652,0.105419184830865,49817,0.691,20676,0.287
"3791","napa",3791,"2021-02-20",823,43425,597,17115,226,26310,0,0,274,12924,549,15271,274,28195,"California",139652,0.109350385243319,49817,0.691,20676,0.287
"3792","napa",3792,"2021-02-21",799,44224,736,17851,63,26373,0,0,197,12519,602,15873,197,28392,"California",139652,0.113661100449689,49817,0.691,20676,0.287
"3793","napa",3793,"2021-02-22",444,44668,187,18038,257,26630,0,0,138,12351,306,16179,138,28530,"California",139652,0.115852261335319,49817,0.691,20676,0.287
"3794","napa",3794,"2021-02-23",1125,45793,301,18339,824,27454,0,0,308,11842,817,16996,308,28838,"California",139652,0.121702517686822,49817,0.691,20676,0.287
"3795","napa",3795,"2021-02-24",1164,46957,644,18983,520,27974,0,0,576,11832,586,17582,576,29414,"California",139652,0.125898662389368,49817,0.691,20676,0.287
"3796","napa",3796,"2021-02-25",2554,49511,1223,20206,1331,29305,0,0,1844,12967,709,18291,1844,31258,"California",139652,0.13097556784006,49817,0.691,20676,0.287
"3797","napa",3797,"2021-02-26",1508,51019,529,20735,979,30284,0,0,594,12649,912,19203,594,31852,"California",139652,0.137506086558016,49817,0.691,20676,0.287
"3798","napa",3798,"2021-02-27",1119,52138,379,21114,740,31024,0,0,867,13266,250,19453,867,32719,"California",139652,0.139296250680262,49817,0.691,20676,0.287
"3799","napa",3799,"2021-02-28",560,52698,459,21573,101,31125,0,0,461,13630,97,19550,461,33180,"California",139652,0.139990834359694,49817,0.691,20676,0.287
"3800","napa",3800,"2021-03-01",1102,53800,816,22389,286,31411,0,0,832,14193,269,19819,832,34012,"California",139652,0.141917050955232,49817,0.691,20676,0.287
"3801","napa",3801,"2021-03-02",1485,55285,1026,23415,459,31870,0,0,1143,14995,341,20160,1143,35155,"California",139652,0.144358834817976,49817,0.691,20676,0.287
"3802","napa",3802,"2021-03-03",1554,56839,690,24105,864,32734,0,0,1370,16182,183,20343,1370,36525,"California",139652,0.145669234955461,49817,0.691,20676,0.287
"3803","napa",3803,"2021-03-04",1708,58547,784,24889,924,33658,0,0,1470,17417,235,20578,1470,37995,"California",139652,0.147351989230373,49817,0.691,20676,0.287
"3804","napa",3804,"2021-03-05",1895,60442,788,25677,1103,34761,4,4,1476,18480,417,20995,1480,39475,"California",139652,0.15033798298628,49817,0.691,20676,0.287
"3805","napa",3805,"2021-03-06",648,61090,281,25958,336,35097,31,35,535,18935,111,21106,566,40041,"California",139652,0.151132815856558,49817,0.691,20676,0.287
"3806","napa",3806,"2021-03-07",520,61610,318,26276,187,35284,15,50,370,19170,150,21256,385,40426,"California",139652,0.152206914329906,49817,0.691,20676,0.287
"3807","napa",3807,"2021-03-08",706,62316,330,26606,323,35607,53,103,529,19577,175,21431,582,41008,"California",139652,0.153460029215478,49817,0.691,20676,0.287
"3808","napa",3808,"2021-03-09",1635,63951,572,27178,1017,36624,46,149,1203,20397,429,21860,1249,42257,"California",139652,0.156531950849254,49817,0.691,20676,0.287
"3809","napa",3809,"2021-03-10",1479,65430,917,28095,468,37092,94,243,777,20569,698,22558,870,43127,"California",139652,0.161530089078567,49817,0.691,20676,0.287
"3810","napa",3810,"2021-03-11",1877,67307,1060,29155,688,37780,129,372,986,20793,891,23449,1115,44242,"California",139652,0.167910234010254,49817,0.691,20676,0.287
"3811","napa",3811,"2021-03-12",1506,68813,914,30069,496,38276,96,468,801,20986,703,24152,896,45138,"California",139652,0.172944175522012,49817,0.691,20676,0.287
"3812","napa",3812,"2021-03-13",1167,69980,302,30371,840,39116,25,493,829,21504,336,24488,854,45992,"California",139652,0.175350156102311,49817,0.691,20676,0.287
"3813","napa",3813,"2021-03-14",613,70593,331,30702,134,39250,148,641,229,21497,383,24871,376,46368,"California",139652,0.178092687537593,49817,0.691,20676,0.287
"3814","napa",3814,"2021-03-15",949,71542,408,31110,472,39722,69,710,480,21579,467,25338,549,46917,"California",139652,0.18143671411795,49817,0.691,20676,0.287
"3815","napa",3815,"2021-03-16",1840,73382,389,31499,1325,41047,126,836,1378,22626,458,25796,1505,48422,"California",139652,0.184716294789906,49817,0.691,20676,0.287
"3816","napa",3816,"2021-03-17",2499,75881,1849,33348,471,41518,179,1015,1588,23482,911,26707,1767,50189,"California",139652,0.191239652851373,49817,0.691,20676,0.287
"3817","napa",3817,"2021-03-18",2107,77988,920,34268,1177,42695,10,1025,1283,23953,822,27529,1293,51482,"California",139652,0.197125712485321,49817,0.691,20676,0.287
"3818","napa",3818,"2021-03-19",1444,79432,872,35140,544,43239,28,1053,711,23962,730,28259,739,52221,"California",139652,0.202352991722281,49817,0.691,20676,0.287
"3819","napa",3819,"2021-03-20",1007,80439,529,35669,325,43564,153,1206,433,23975,573,28832,586,52807,"California",139652,0.206456047890471,49817,0.691,20676,0.287
"3820","napa",3820,"2021-03-21",701,81140,680,36349,19,43583,2,1208,349,23975,351,29183,351,53158,"California",139652,0.208969438318105,49817,0.691,20676,0.287
"3821","napa",3821,"2021-03-22",1291,82431,1115,37464,165,43748,11,1219,490,23680,796,29979,501,53659,"California",139652,0.214669320883339,49817,0.691,20676,0.287
"3822","napa",3822,"2021-03-23",1819,84250,1128,38592,674,44422,17,1236,1019,23920,796,30775,1036,54695,"California",139652,0.220369203448572,49817,0.691,20676,0.287
"3823","napa",3823,"2021-03-24",1709,85959,945,39537,755,45177,9,1245,822,23865,886,31661,831,55526,"California",139652,0.226713545097815,49817,0.691,20676,0.287
"3824","napa",3824,"2021-03-25",1637,87596,1051,40588,532,45709,54,1299,749,23784,885,32546,804,56330,"California",139652,0.233050726090568,49817,0.691,20676,0.287
"3825","napa",3825,"2021-03-26",1298,88894,831,41419,461,46170,6,1305,592,23680,702,33248,598,56928,"California",139652,0.238077506945837,49817,0.691,20676,0.287
"3826","napa",3826,"2021-03-27",950,89844,432,41851,491,46661,27,1332,318,23393,632,33880,345,57273,"California",139652,0.242603041846877,49817,0.691,20676,0.287
"3827","napa",3827,"2021-03-28",483,90327,373,42224,103,46764,7,1339,184,23286,298,34178,191,57464,"California",139652,0.244736917480595,49817,0.691,20676,0.287
"3828","napa",3828,"2021-03-29",1195,91522,871,43095,319,47083,5,1344,735,23567,459,34637,740,58204,"California",139652,0.24802365880904,49817,0.691,20676,0.287
"3829","napa",3829,"2021-03-30",2544,94066,929,44024,1611,48694,4,1348,1758,24543,786,35423,1762,59966,"California",139652,0.253651934809383,49817,0.691,20676,0.287
"3830","napa",3830,"2021-03-31",1965,96031,959,44983,937,49631,69,1417,802,24252,1160,36583,869,60835,"California",139652,0.261958296336608,49817,0.691,20676,0.287
"3831","napa",3831,"2021-04-01",1732,97763,831,45814,785,50416,116,1533,470,23581,1256,37839,585,61420,"California",139652,0.270952080886776,49817,0.691,20676,0.287
"3832","napa",3832,"2021-04-02",1833,99596,822,46636,869,51285,142,1675,458,22809,1372,39211,600,62020,"California",139652,0.280776501589666,49817,0.691,20676,0.287
"3833","napa",3833,"2021-04-03",625,100221,362,46998,204,51489,59,1734,210,22662,415,39626,268,62288,"California",139652,0.283748174032595,49817,0.691,20676,0.287
"3834","napa",3834,"2021-04-04",354,100575,144,47142,152,51641,58,1792,125,22617,228,39854,183,62471,"California",139652,0.285380803712084,49817,0.691,20676,0.287
"3835","napa",3835,"2021-04-05",1264,101839,755,47897,291,51932,218,2010,574,22720,689,40543,792,63263,"California",139652,0.290314496032996,49817,0.691,20676,0.287
"3836","napa",3836,"2021-04-06",2230,104069,560,48457,1415,53347,255,2265,529,21806,1698,42241,784,64047,"California",139652,0.302473290751296,49817,0.691,20676,0.287
"3837","napa",3837,"2021-04-07",1723,105792,703,49160,799,54146,221,2486,523,21354,1195,43436,743,64790,"California",139652,0.311030275255635,49817,0.691,20676,0.287
"3838","napa",3838,"2021-04-08",1846,107638,1057,50217,419,54565,370,2856,957,21794,885,44321,1325,66115,"California",139652,0.317367456248389,49817,0.691,20676,0.287
"3839","napa",3839,"2021-04-09",1530,109168,919,51136,309,54874,302,3158,676,21919,852,45173,977,67092,"California",139652,0.323468335577006,49817,0.691,20676,0.287
"3840","napa",3840,"2021-04-10",1031,110199,346,51482,584,55458,101,3259,239,21467,791,45964,339,67431,"California",139652,0.329132414859794,49817,0.691,20676,0.287
"3841","napa",3841,"2021-04-11",384,110583,299,51781,62,55520,23,3282,155,21416,229,46193,178,67609,"California",139652,0.330772205195772,49817,0.691,20676,0.287
"3842","napa",3842,"2021-04-12",784,111367,301,52082,359,55879,124,3406,292,21338,491,46684,413,68022,"California",139652,0.334288087531865,49817,0.691,20676,0.287
"3843","napa",3843,"2021-04-13",2522,113889,843,52925,1679,57558,0,3406,920,20661,1597,48281,920,68942,"California",139652,0.345723655944777,49817,0.691,20676,0.287
"3844","napa",3844,"2021-04-14",2063,115952,978,53903,1085,58643,0,3406,1007,20620,1048,49329,1007,69949,"California",139652,0.353228023945235,49817,0.691,20676,0.287
"3845","napa",3845,"2021-04-15",2046,117998,526,54429,1520,60163,0,3406,875,20329,1166,50495,875,70824,"California",139652,0.361577349411394,49817,0.691,20676,0.287
"3846","napa",3846,"2021-04-16",2900,120898,1571,56000,1329,61492,0,3406,2186,21803,712,51207,2186,73010,"California",139652,0.366675736831553,49817,0.691,20676,0.287
"3847","napa",3847,"2021-04-17",1127,122025,267,56267,860,62352,0,3406,830,22337,296,51503,830,73840,"California",139652,0.368795291152293,49817,0.691,20676,0.287
"3848","napa",3848,"2021-04-18",265,122290,173,56440,92,62444,0,3406,118,22309,146,51649,118,73958,"California",139652,0.369840746999685,49817,0.691,20676,0.287
"3849","napa",3849,"2021-04-19",609,122899,339,56779,270,62714,0,3406,266,22233,342,51991,266,74224,"California",139652,0.372289691518918,49817,0.691,20676,0.287
"3850","napa",3850,"2021-04-20",3038,125937,2065,58844,973,63687,0,3406,2087,23371,950,52941,2088,76312,"California",139652,0.379092315183456,49817,0.691,20676,0.287
"3851","napa",3851,"2021-04-21",2910,128847,2150,60994,760,64447,0,3406,1856,24180,1048,53989,1857,78169,"California",139652,0.386596683183914,49817,0.691,20676,0.287
"3852","napa",3852,"2021-04-22",1628,130475,1130,62124,498,64945,0,3406,834,24224,790,54779,834,79003,"California",139652,0.392253601810214,49817,0.691,20676,0.287
"3853","napa",3853,"2021-04-23",1625,132100,1246,63370,377,65322,2,3408,1153,24909,468,55247,1153,80156,"California",139652,0.39560478904706,49817,0.691,20676,0.287
"3854","napa",3854,"2021-04-24",545,132645,315,63685,230,65552,0,3408,284,24935,258,55505,284,80440,"California",139652,0.397452238421218,49817,0.691,20676,0.287
"3855","napa",3855,"2021-04-25",248,132893,191,63876,57,65609,0,3408,129,24946,118,55623,129,80569,"California",139652,0.398297195886919,49817,0.691,20676,0.287
"3856","napa",3856,"2021-04-26",493,133386,256,64132,237,65846,0,3408,251,24959,238,55861,251,80820,"California",139652,0.400001432131298,49817,0.691,20676,0.287
"3857","napa",3857,"2021-04-27",1501,134887,426,64558,1064,66910,11,3419,622,24716,876,56737,633,81453,"California",139652,0.40627416721565,49817,0.691,20676,0.287
"3858","napa",3858,"2021-04-28",969,135856,426,64984,526,67436,17,3436,319,24403,649,57386,336,81789,"California",139652,0.410921433277003,49817,0.691,20676,0.287
"3859","napa",3859,"2021-04-29",636,136492,324,65308,293,67729,19,3455,199,24189,431,57817,217,82006,"California",139652,0.414007676223756,49817,0.691,20676,0.287
"3860","napa",3860,"2021-04-30",597,137089,299,65607,234,67963,64,3519,247,24150,349,58166,310,82316,"California",139652,0.416506745338413,49817,0.691,20676,0.287
"3861","napa",3861,"2021-05-01",318,137407,264,65871,44,68007,10,3529,116,24074,202,58368,126,82442,"California",139652,0.417953197949188,49817,0.691,20676,0.287
"3862","napa",3862,"2021-05-02",237,137644,193,66064,38,68045,6,3535,99,24042,137,58505,105,82547,"California",139652,0.418934207888179,49817,0.691,20676,0.287
"3863","napa",3863,"2021-05-03",620,138264,494,66558,92,68137,34,3569,101,23662,516,59021,136,82683,"California",139652,0.422629106636496,49817,0.691,20676,0.287
"3864","napa",3864,"2021-05-04",1125,139389,715,67273,301,68438,109,3678,297,23243,825,59846,406,83089,"California",139652,0.428536648239911,49817,0.691,20676,0.287
"3865","napa",3865,"2021-05-05",1018,140407,684,67957,299,68737,35,3713,258,22779,757,60603,293,83382,"California",139652,0.433957265202074,49817,0.691,20676,0.287
"3866","napa",3866,"2021-05-06",708,141115,315,68272,370,69107,23,3736,367,22835,334,60937,390,83772,"California",139652,0.436348924469395,49817,0.691,20676,0.287
"3867","napa",3867,"2021-05-07",547,141662,350,68622,152,69259,45,3781,167,22670,376,61313,211,83983,"California",139652,0.439041331309254,49817,0.691,20676,0.287
"3868","napa",3868,"2021-05-08",263,141925,166,68788,86,69345,11,3792,96,22611,166,61479,107,84090,"California",139652,0.440230000286426,49817,0.691,20676,0.287
"3869","nevada",3869,"2020-12-16",3,3,3,3,0,0,0,0,3,3,0,0,3,3,"California",98710,0,36359,0.562,26779,0.414
"3870","nevada",3870,"2020-12-17",6,9,6,9,0,0,0,0,6,9,0,0,6,9,"California",98710,0,36359,0.562,26779,0.414
"3871","nevada",3871,"2020-12-18",52,61,52,61,0,0,0,0,52,61,0,0,52,61,"California",98710,0,36359,0.562,26779,0.414
"3872","nevada",3872,"2020-12-19",55,116,55,116,0,0,0,0,55,116,0,0,55,116,"California",98710,0,36359,0.562,26779,0.414
"3873","nevada",3873,"2020-12-20",12,128,12,128,0,0,0,0,12,128,0,0,12,128,"California",98710,0,36359,0.562,26779,0.414
"3874","nevada",3874,"2020-12-21",69,197,69,197,0,0,0,0,69,197,0,0,69,197,"California",98710,0,36359,0.562,26779,0.414
"3875","nevada",3875,"2020-12-22",91,288,89,286,2,2,0,0,91,288,0,0,91,288,"California",98710,0,36359,0.562,26779,0.414
"3876","nevada",3876,"2020-12-23",233,521,202,488,31,33,0,0,233,521,0,0,233,521,"California",98710,0,36359,0.562,26779,0.414
"3877","nevada",3877,"2020-12-24",13,534,11,499,2,35,0,0,13,534,0,0,13,534,"California",98710,0,36359,0.562,26779,0.414
"3878","nevada",3878,"2020-12-25",3,537,3,502,0,35,0,0,3,537,0,0,3,537,"California",98710,0,36359,0.562,26779,0.414
"3879","nevada",3879,"2020-12-26",6,543,4,506,2,37,0,0,6,543,0,0,6,543,"California",98710,0,36359,0.562,26779,0.414
"3880","nevada",3880,"2020-12-27",88,631,88,594,0,37,0,0,88,631,0,0,88,631,"California",98710,0,36359,0.562,26779,0.414
"3881","nevada",3881,"2020-12-28",170,801,93,687,77,114,0,0,170,801,0,0,170,801,"California",98710,0,36359,0.562,26779,0.414
"3882","nevada",3882,"2020-12-29",100,901,74,761,26,140,0,0,100,901,0,0,100,901,"California",98710,0,36359,0.562,26779,0.414
"3883","nevada",3883,"2020-12-30",86,987,66,827,20,160,0,0,86,987,0,0,86,987,"California",98710,0,36359,0.562,26779,0.414
"3884","nevada",3884,"2020-12-31",39,1026,9,836,30,190,0,0,39,1026,0,0,39,1026,"California",98710,0,36359,0.562,26779,0.414
"3885","nevada",3885,"2021-01-01",2,1028,0,836,2,192,0,0,2,1028,0,0,2,1028,"California",98710,0,36359,0.562,26779,0.414
"3886","nevada",3886,"2021-01-02",1,1029,1,837,0,192,0,0,1,1029,0,0,1,1029,"California",98710,0,36359,0.562,26779,0.414
"3887","nevada",3887,"2021-01-03",129,1158,126,963,3,195,0,0,129,1158,0,0,129,1158,"California",98710,0,36359,0.562,26779,0.414
"3888","nevada",3888,"2021-01-04",71,1229,47,1010,24,219,0,0,71,1229,0,0,71,1229,"California",98710,0,36359,0.562,26779,0.414
"3889","nevada",3889,"2021-01-05",273,1502,132,1142,141,360,0,0,272,1500,1,1,272,1501,"California",98710,1.01306858474319e-05,36359,0.562,26779,0.414
"3890","nevada",3890,"2021-01-06",91,1593,43,1185,48,408,0,0,83,1575,8,9,83,1584,"California",98710,9.11761726268868e-05,36359,0.562,26779,0.414
"3891","nevada",3891,"2021-01-07",215,1808,43,1228,172,580,0,0,208,1778,6,15,209,1793,"California",98710,0.000151960287711478,36359,0.562,26779,0.414
"3892","nevada",3892,"2021-01-08",223,2031,129,1357,94,674,0,0,170,1896,53,68,171,1964,"California",98710,0.000688886637625367,36359,0.562,26779,0.414
"3893","nevada",3893,"2021-01-09",64,2095,56,1413,8,682,0,0,16,1864,48,116,16,1980,"California",98710,0.0011751595583021,36359,0.562,26779,0.414
"3894","nevada",3894,"2021-01-10",18,2113,9,1422,9,691,0,0,10,1866,8,124,10,1990,"California",98710,0.00125620504508155,36359,0.562,26779,0.414
"3895","nevada",3895,"2021-01-11",185,2298,131,1553,54,745,0,0,57,1795,128,252,57,2047,"California",98710,0.00255293283355283,36359,0.562,26779,0.414
"3896","nevada",3896,"2021-01-12",597,2895,451,2004,146,891,0,0,531,2260,66,318,531,2578,"California",98710,0.00322155809948333,36359,0.562,26779,0.414
"3897","nevada",3897,"2021-01-13",260,3155,147,2151,113,1004,0,0,125,2250,135,453,125,2703,"California",98710,0.00458920068888664,36359,0.562,26779,0.414
"3898","nevada",3898,"2021-01-14",238,3393,127,2278,111,1115,0,0,220,2453,17,470,220,2923,"California",98710,0.00476142234829298,36359,0.562,26779,0.414
"3899","nevada",3899,"2021-01-15",395,3788,170,2448,225,1340,0,0,297,2652,98,568,297,3220,"California",98710,0.0057542295613413,36359,0.562,26779,0.414
"3900","nevada",3900,"2021-01-16",296,4084,15,2463,281,1621,0,0,292,2940,4,572,292,3512,"California",98710,0.00579475230473103,36359,0.562,26779,0.414
"3901","nevada",3901,"2021-01-17",35,4119,31,2494,4,1625,0,0,33,2971,2,574,33,3545,"California",98710,0.00581501367642589,36359,0.562,26779,0.414
"3902","nevada",3902,"2021-01-18",151,4270,41,2535,110,1735,0,0,141,3102,10,584,141,3686,"California",98710,0.00591632053490021,36359,0.562,26779,0.414
"3903","nevada",3903,"2021-01-19",244,4514,85,2620,159,1894,0,0,225,3308,19,603,225,3911,"California",98710,0.00610880356600142,36359,0.562,26779,0.414
"3904","nevada",3904,"2021-01-20",258,4772,153,2773,105,1999,0,0,245,3540,13,616,245,4156,"California",98710,0.00624050248201803,36359,0.562,26779,0.414
"3905","nevada",3905,"2021-01-21",338,5110,207,2980,131,2130,0,0,325,3852,13,629,325,4481,"California",98710,0.00637220139803465,36359,0.562,26779,0.414
"3906","nevada",3906,"2021-01-22",346,5456,209,3189,137,2267,0,0,316,4138,30,659,316,4797,"California",98710,0.0066761219734576,36359,0.562,26779,0.414
"3907","nevada",3907,"2021-01-23",177,5633,104,3293,73,2340,0,0,177,4315,0,659,177,4974,"California",98710,0.0066761219734576,36359,0.562,26779,0.414
"3908","nevada",3908,"2021-01-24",105,5738,98,3391,7,2347,0,0,66,4342,39,698,66,5040,"California",98710,0.00707121872150745,36359,0.562,26779,0.414
"3909","nevada",3909,"2021-01-25",267,6005,137,3528,130,2477,0,0,206,4487,61,759,206,5246,"California",98710,0.00768919055820079,36359,0.562,26779,0.414
"3910","nevada",3910,"2021-01-26",403,6408,141,3669,262,2739,0,0,299,4682,104,863,299,5545,"California",98710,0.0087427818863337,36359,0.562,26779,0.414
"3911","nevada",3911,"2021-01-27",420,6828,249,3918,171,2910,0,0,396,5054,24,887,396,5941,"California",98710,0.00898591834667207,36359,0.562,26779,0.414
"3912","nevada",3912,"2021-01-28",470,7298,319,4237,151,3061,0,0,426,5437,43,930,426,6367,"California",98710,0.00942153783811164,36359,0.562,26779,0.414
"3913","nevada",3913,"2021-01-29",603,7901,392,4629,211,3272,0,0,576,5988,26,956,577,6944,"California",98710,0.00968493567014487,36359,0.562,26779,0.414
"3914","nevada",3914,"2021-01-30",232,8133,105,4734,127,3399,0,0,229,6214,3,959,229,7173,"California",98710,0.00971532772768717,36359,0.562,26779,0.414
"3915","nevada",3915,"2021-01-31",103,8236,86,4820,17,3416,0,0,101,6315,1,960,102,7275,"California",98710,0.0097254584135346,36359,0.562,26779,0.414
"3916","nevada",3916,"2021-02-01",291,8527,71,4891,220,3636,0,0,277,6578,14,974,277,7552,"California",98710,0.00986728801539864,36359,0.562,26779,0.414
"3917","nevada",3917,"2021-02-02",511,9038,173,5064,338,3974,0,0,323,6713,188,1162,323,7875,"California",98710,0.0117718569547158,36359,0.562,26779,0.414
"3918","nevada",3918,"2021-02-03",812,9850,572,5636,240,4214,0,0,758,7418,53,1215,758,8633,"California",98710,0.0123087833046297,36359,0.562,26779,0.414
"3919","nevada",3919,"2021-02-04",738,10588,392,6028,346,4560,0,0,488,7657,249,1464,488,9121,"California",98710,0.0148313240806403,36359,0.562,26779,0.414
"3920","nevada",3920,"2021-02-05",646,11234,367,6395,279,4839,0,0,455,7923,189,1653,455,9576,"California",98710,0.0167460237058049,36359,0.562,26779,0.414
"3921","nevada",3921,"2021-02-06",269,11503,83,6478,186,5025,0,0,242,8138,27,1680,242,9818,"California",98710,0.0170195522236855,36359,0.562,26779,0.414
"3922","nevada",3922,"2021-02-07",244,11747,191,6669,53,5078,0,0,190,8274,54,1734,190,10008,"California",98710,0.0175666092594469,36359,0.562,26779,0.414
"3923","nevada",3923,"2021-02-08",651,12398,408,7077,243,5321,0,0,553,8729,98,1832,553,10561,"California",98710,0.0185594164724952,36359,0.562,26779,0.414
"3924","nevada",3924,"2021-02-09",602,13000,337,7414,265,5586,0,0,463,9053,139,1971,463,11024,"California",98710,0.0199675818052882,36359,0.562,26779,0.414
"3925","nevada",3925,"2021-02-10",647,13647,322,7736,325,5911,0,0,416,9239,231,2202,417,11441,"California",98710,0.022307770236045,36359,0.562,26779,0.414
"3926","nevada",3926,"2021-02-11",871,14518,505,8241,366,6277,0,0,542,9453,328,2530,542,11983,"California",98710,0.0256306351940026,36359,0.562,26779,0.414
"3927","nevada",3927,"2021-02-12",937,15455,437,8678,500,6777,0,0,616,9751,318,2848,616,12599,"California",98710,0.028852193293486,36359,0.562,26779,0.414
"3928","nevada",3928,"2021-02-13",600,16055,235,8913,365,7142,0,0,389,9934,207,3055,390,12989,"California",98710,0.0309492452639044,36359,0.562,26779,0.414
"3929","nevada",3929,"2021-02-14",229,16284,119,9032,110,7252,0,0,201,10107,28,3083,201,13190,"California",98710,0.0312329044676325,36359,0.562,26779,0.414
"3930","nevada",3930,"2021-02-15",709,16993,438,9470,271,7523,0,0,535,10468,174,3257,535,13725,"California",98710,0.0329956438050856,36359,0.562,26779,0.414
"3931","nevada",3931,"2021-02-16",621,17614,197,9667,424,7947,0,0,451,10750,169,3426,451,14176,"California",98710,0.0347077297133016,36359,0.562,26779,0.414
"3932","nevada",3932,"2021-02-17",1186,18800,764,10431,422,8369,0,0,856,11276,330,3756,856,15032,"California",98710,0.0380508560429541,36359,0.562,26779,0.414
"3933","nevada",3933,"2021-02-18",1007,19807,548,10979,459,8828,0,0,600,11471,405,4161,600,15632,"California",98710,0.042153783811164,36359,0.562,26779,0.414
"3934","nevada",3934,"2021-02-19",1014,20821,630,11609,384,9212,0,0,652,11763,361,4522,653,16285,"California",98710,0.0458109614020869,36359,0.562,26779,0.414
"3935","nevada",3935,"2021-02-20",298,21119,106,11715,192,9404,0,0,173,11812,124,4646,173,16458,"California",98710,0.0470671664471685,36359,0.562,26779,0.414
"3936","nevada",3936,"2021-02-21",90,21209,85,11800,5,9409,0,0,8,11739,81,4727,8,16466,"California",98710,0.0478877520008105,36359,0.562,26779,0.414
"3937","nevada",3937,"2021-02-22",494,21703,327,12127,167,9576,0,0,346,11938,147,4874,346,16812,"California",98710,0.0493769628203829,36359,0.562,26779,0.414
"3938","nevada",3938,"2021-02-23",469,22172,220,12347,249,9825,0,0,206,11884,260,5134,206,17018,"California",98710,0.0520109411407152,36359,0.562,26779,0.414
"3939","nevada",3939,"2021-02-24",474,22646,235,12582,239,10064,0,0,248,11908,226,5360,250,17268,"California",98710,0.0543004761422348,36359,0.562,26779,0.414
"3940","nevada",3940,"2021-02-25",863,23509,468,13050,395,10459,0,0,433,11913,428,5788,433,17701,"California",98710,0.0586364096849357,36359,0.562,26779,0.414
"3941","nevada",3941,"2021-02-26",1237,24746,881,13931,356,10815,0,0,408,11495,826,6614,408,18109,"California",98710,0.0670043561949144,36359,0.562,26779,0.414
"3942","nevada",3942,"2021-02-27",354,25100,110,14041,244,11059,0,0,184,11509,170,6784,184,18293,"California",98710,0.0687265727889778,36359,0.562,26779,0.414
"3943","nevada",3943,"2021-02-28",265,25365,152,14193,113,11172,0,0,123,11491,141,6925,123,18416,"California",98710,0.0701549994934657,36359,0.562,26779,0.414
"3944","nevada",3944,"2021-03-01",822,26187,427,14620,395,11567,0,0,356,11383,464,7389,356,18772,"California",98710,0.0748556377266741,36359,0.562,26779,0.414
"3945","nevada",3945,"2021-03-02",708,26895,262,14882,446,12013,0,0,481,11641,223,7612,481,19253,"California",98710,0.0771147806706514,36359,0.562,26779,0.414
"3946","nevada",3946,"2021-03-03",965,27860,492,15374,472,12485,1,1,493,11664,471,8083,494,19747,"California",98710,0.0818863337047918,36359,0.562,26779,0.414
"3947","nevada",3947,"2021-03-04",1105,28965,616,15990,489,12974,0,1,466,11494,636,8719,466,20213,"California",98710,0.0883294499037585,36359,0.562,26779,0.414
"3948","nevada",3948,"2021-03-05",821,29786,461,16451,350,13324,10,11,363,11411,456,9175,373,20586,"California",98710,0.0929490426501874,36359,0.562,26779,0.414
"3949","nevada",3949,"2021-03-06",359,30145,121,16572,211,13535,27,38,145,11369,214,9389,172,20758,"California",98710,0.0951170094215378,36359,0.562,26779,0.414
"3950","nevada",3950,"2021-03-07",211,30356,109,16681,82,13617,20,58,69,11316,142,9531,89,20847,"California",98710,0.0965555668118732,36359,0.562,26779,0.414
"3951","nevada",3951,"2021-03-08",806,31162,538,17219,223,13840,45,103,359,11275,446,9977,405,21252,"California",98710,0.101073852699828,36359,0.562,26779,0.414
"3952","nevada",3952,"2021-03-09",671,31833,320,17539,301,14141,50,153,368,11391,301,10278,417,21669,"California",98710,0.104123189139905,36359,0.562,26779,0.414
"3953","nevada",3953,"2021-03-10",961,32794,606,18145,298,14439,57,210,323,11137,634,10912,380,22049,"California",98710,0.110546043967177,36359,0.562,26779,0.414
"3954","nevada",3954,"2021-03-11",1104,33898,725,18870,354,14793,25,235,550,11166,546,11458,575,22624,"California",98710,0.116077398439874,36359,0.562,26779,0.414
"3955","nevada",3955,"2021-03-12",1192,35090,722,19592,440,15233,30,265,506,11017,684,12142,535,23159,"California",98710,0.123006787559518,36359,0.562,26779,0.414
"3956","nevada",3956,"2021-03-13",271,35361,52,19644,214,15447,5,270,100,10951,170,12312,104,23263,"California",98710,0.124729004153581,36359,0.562,26779,0.414
"3957","nevada",3957,"2021-03-14",155,35516,21,19665,128,15575,6,276,33,10868,122,12434,39,23302,"California",98710,0.125964947826968,36359,0.562,26779,0.414
"3958","nevada",3958,"2021-03-15",841,36357,456,20121,373,15948,12,288,358,10758,480,12914,370,23672,"California",98710,0.130827677033735,36359,0.562,26779,0.414
"3959","nevada",3959,"2021-03-16",994,37351,466,20587,467,16415,61,349,646,11119,346,13260,707,24379,"California",98710,0.134332894336947,36359,0.562,26779,0.414
"3960","nevada",3960,"2021-03-17",1016,38367,451,21038,555,16970,10,359,586,11288,427,13687,596,24975,"California",98710,0.1386586971938,36359,0.562,26779,0.414
"3961","nevada",3961,"2021-03-18",974,39341,529,21567,421,17391,24,383,478,11298,492,14179,502,25477,"California",98710,0.143642994630737,36359,0.562,26779,0.414
"3962","nevada",3962,"2021-03-19",758,40099,437,22004,284,17675,37,420,352,11285,402,14581,389,25866,"California",98710,0.147715530341404,36359,0.562,26779,0.414
"3963","nevada",3963,"2021-03-20",822,40921,92,22096,306,17981,424,844,235,11359,581,15162,655,26521,"California",98710,0.153601458818762,36359,0.562,26779,0.414
"3964","nevada",3964,"2021-03-21",58,40979,32,22128,25,18006,1,845,40,11383,17,15179,41,26562,"California",98710,0.153773680478168,36359,0.562,26779,0.414
"3965","nevada",3965,"2021-03-22",795,41774,513,22641,277,18283,5,850,536,11667,257,15436,541,27103,"California",98710,0.156377266740958,36359,0.562,26779,0.414
"3966","nevada",3966,"2021-03-23",852,42626,383,23024,443,18726,26,876,641,12126,208,15644,667,27770,"California",98710,0.158484449397224,36359,0.562,26779,0.414
"3967","nevada",3967,"2021-03-24",1021,43647,541,23565,473,19199,7,883,650,12417,365,16009,656,28426,"California",98710,0.162182149731537,36359,0.562,26779,0.414
"3968","nevada",3968,"2021-03-25",902,44549,454,24019,423,19622,25,908,495,12530,406,16415,519,28945,"California",98710,0.166295208185594,36359,0.562,26779,0.414
"3969","nevada",3969,"2021-03-26",1138,45687,433,24452,667,20289,38,946,826,13084,309,16724,863,29808,"California",98710,0.169425590112451,36359,0.562,26779,0.414
"3970","nevada",3970,"2021-03-27",568,46255,71,24523,481,20770,16,962,386,13304,182,16906,402,30210,"California",98710,0.171269374936683,36359,0.562,26779,0.414
"3971","nevada",3971,"2021-03-28",175,46430,50,24573,112,20882,13,975,39,13223,133,17039,52,30262,"California",98710,0.172616756154392,36359,0.562,26779,0.414
"3972","nevada",3972,"2021-03-29",821,47251,501,25074,298,21180,22,997,393,13212,425,17464,414,30676,"California",98710,0.17692229763955,36359,0.562,26779,0.414
"3973","nevada",3973,"2021-03-30",1043,48294,475,25549,534,21714,34,1031,539,13289,496,17960,573,31249,"California",98710,0.181947117819876,36359,0.562,26779,0.414
"3974","nevada",3974,"2021-03-31",1174,49468,658,26207,499,22213,17,1048,694,13528,471,18431,710,31959,"California",98710,0.186718670854017,36359,0.562,26779,0.414
"3975","nevada",3975,"2021-04-01",1228,50696,716,26923,459,22672,53,1101,541,13443,679,19110,594,32553,"California",98710,0.193597406544423,36359,0.562,26779,0.414
"3976","nevada",3976,"2021-04-02",1282,51978,655,27578,591,23263,36,1137,761,13723,517,19627,797,33350,"California",98710,0.198834971127545,36359,0.562,26779,0.414
"3977","nevada",3977,"2021-04-03",288,52266,89,27667,161,23424,38,1175,83,13640,204,19831,121,33471,"California",98710,0.200901631040421,36359,0.562,26779,0.414
"3978","nevada",3978,"2021-04-04",128,52394,42,27709,79,23503,7,1182,77,13673,51,19882,84,33555,"California",98710,0.20141829601864,36359,0.562,26779,0.414
"3979","nevada",3979,"2021-04-05",929,53323,610,28319,300,23803,19,1201,618,14002,308,20190,637,34192,"California",98710,0.204538547259649,36359,0.562,26779,0.414
"3980","nevada",3980,"2021-04-06",1070,54393,662,28981,264,24067,144,1345,471,14024,592,20782,614,34806,"California",98710,0.210535913281329,36359,0.562,26779,0.414
"3981","nevada",3981,"2021-04-07",1143,55536,815,29796,246,24313,82,1427,605,14179,531,21313,686,35492,"California",98710,0.215915307466315,36359,0.562,26779,0.414
"3982","nevada",3982,"2021-04-08",1278,56814,890,30686,305,24618,83,1510,706,14399,569,21882,789,36281,"California",98710,0.221679667713504,36359,0.562,26779,0.414
"3983","nevada",3983,"2021-04-09",1243,58057,846,31532,328,24946,69,1579,844,14914,398,22280,913,37194,"California",98710,0.225711680680782,36359,0.562,26779,0.414
"3984","nevada",3984,"2021-04-10",264,58321,76,31608,112,25058,76,1655,110,14947,153,22433,186,37380,"California",98710,0.227261675615439,36359,0.562,26779,0.414
"3985","nevada",3985,"2021-04-11",100,58421,31,31639,65,25123,4,1659,39,14929,61,22494,43,37423,"California",98710,0.227879647452133,36359,0.562,26779,0.414
"3986","nevada",3986,"2021-04-12",736,59157,536,32175,183,25306,17,1676,311,14836,421,22915,328,37751,"California",98710,0.232144666193901,36359,0.562,26779,0.414
"3987","nevada",3987,"2021-04-13",889,60046,351,32526,538,25844,0,1676,480,14909,407,23322,480,38231,"California",98710,0.236267855333806,36359,0.562,26779,0.414
"3988","nevada",3988,"2021-04-14",1051,61097,565,33091,486,26330,0,1676,540,14946,503,23825,540,38771,"California",98710,0.241363590315064,36359,0.562,26779,0.414
"3989","nevada",3989,"2021-04-15",1074,62171,710,33801,364,26694,0,1676,623,15128,441,24266,623,39394,"California",98710,0.245831222773782,36359,0.562,26779,0.414
"3990","nevada",3990,"2021-04-16",900,63071,698,34499,202,26896,0,1676,529,15287,370,24636,529,39923,"California",98710,0.249579576537332,36359,0.562,26779,0.414
"3991","nevada",3991,"2021-04-17",199,63270,52,34551,147,27043,0,1676,87,15263,111,24747,87,40010,"California",98710,0.250704082666396,36359,0.562,26779,0.414
"3992","nevada",3992,"2021-04-18",184,63454,20,34571,164,27207,0,1676,101,15281,83,24830,101,40111,"California",98710,0.251544929591733,36359,0.562,26779,0.414
"3993","nevada",3993,"2021-04-19",750,64204,481,35052,269,27476,0,1676,304,15147,438,25268,304,40415,"California",98710,0.255982169992909,36359,0.562,26779,0.414
"3994","nevada",3994,"2021-04-20",795,64999,307,35359,488,27964,0,1676,298,14953,492,25760,298,40713,"California",98710,0.260966467429845,36359,0.562,26779,0.414
"3995","nevada",3995,"2021-04-21",897,65896,490,35849,407,28371,0,1676,266,14597,622,26382,266,40979,"California",98710,0.267267754026948,36359,0.562,26779,0.414
"3996","nevada",3996,"2021-04-22",991,66887,619,36468,372,28743,0,1676,339,14295,641,27023,339,41318,"California",98710,0.273761523655151,36359,0.562,26779,0.414
"3997","nevada",3997,"2021-04-23",1215,68102,537,37005,678,29421,0,1676,395,13881,809,27832,395,41713,"California",98710,0.281957248505724,36359,0.562,26779,0.414
"3998","nevada",3998,"2021-04-24",520,68622,73,37078,447,29868,0,1676,169,13701,349,28181,169,41882,"California",98710,0.285492857866478,36359,0.562,26779,0.414
"3999","nevada",3999,"2021-04-25",116,68738,61,37139,50,29918,5,1681,51,13693,64,28245,56,41938,"California",98710,0.286141221760713,36359,0.562,26779,0.414
"4000","nevada",4000,"2021-04-26",696,69434,527,37666,161,30079,8,1689,196,13406,491,28736,204,42142,"California",98710,0.291115388511802,36359,0.562,26779,0.414
"4001","nevada",4001,"2021-04-27",758,70192,345,38011,408,30487,5,1694,393,13447,357,29093,398,42540,"California",98710,0.294732043359335,36359,0.562,26779,0.414
"4002","nevada",4002,"2021-04-28",983,71175,580,38591,398,30885,5,1699,387,13248,591,29684,392,42932,"California",98710,0.300719278695168,36359,0.562,26779,0.414
"4003","nevada",4003,"2021-04-29",1011,72186,708,39299,299,31184,4,1703,276,12795,733,30417,280,43212,"California",98710,0.308145071421335,36359,0.562,26779,0.414
"4004","nevada",4004,"2021-04-30",1222,73408,723,40022,490,31674,9,1712,200,11984,1020,31437,209,43421,"California",98710,0.318478370985716,36359,0.562,26779,0.414
"4005","nevada",4005,"2021-05-01",142,73550,64,40086,74,31748,4,1716,63,11974,77,31514,67,43488,"California",98710,0.319258433795968,36359,0.562,26779,0.414
"4006","nevada",4006,"2021-05-02",53,73603,29,40115,20,31768,4,1720,19,11963,34,31548,23,43511,"California",98710,0.319602877114781,36359,0.562,26779,0.414
"4007","nevada",4007,"2021-05-03",603,74206,402,40517,182,31950,19,1739,177,11735,423,31971,195,43706,"California",98710,0.323888157228244,36359,0.562,26779,0.414
"4008","nevada",4008,"2021-05-04",585,74791,172,40689,394,32344,19,1758,331,11836,249,32220,350,44056,"California",98710,0.326410698004255,36359,0.562,26779,0.414
"4009","nevada",4009,"2021-05-05",723,75514,379,41068,327,32671,17,1775,311,11760,404,32624,328,44384,"California",98710,0.330503495086617,36359,0.562,26779,0.414
"4010","nevada",4010,"2021-05-06",797,76311,566,41634,220,32891,11,1786,187,11356,602,33226,198,44582,"California",98710,0.336602167966771,36359,0.562,26779,0.414
"4011","nevada",4011,"2021-05-07",876,77187,487,42121,354,33245,35,1821,187,10889,689,33915,222,44804,"California",98710,0.343582210515652,36359,0.562,26779,0.414
"4012","nevada",4012,"2021-05-08",173,77360,21,42142,132,33377,20,1841,80,10896,93,34008,100,44904,"California",98710,0.344524364299463,36359,0.562,26779,0.414
"4013","orange",4013,"2020-12-15",16,16,16,16,0,0,0,0,16,16,0,0,16,16,"California",3228519,0,814009,0.535,676498,0.445
"4014","orange",4014,"2020-12-16",366,382,366,382,0,0,0,0,366,382,0,0,366,382,"California",3228519,0,814009,0.535,676498,0.445
"4015","orange",4015,"2020-12-17",3726,4108,3726,4108,0,0,0,0,3725,4107,0,0,3725,4107,"California",3228519,0,814009,0.535,676498,0.445
"4016","orange",4016,"2020-12-18",5054,9162,5047,9155,7,7,0,0,5053,9160,0,0,5053,9160,"California",3228519,0,814009,0.535,676498,0.445
"4017","orange",4017,"2020-12-19",2233,11395,2226,11381,7,14,0,0,2232,11392,0,0,2232,11392,"California",3228519,0,814009,0.535,676498,0.445
"4018","orange",4018,"2020-12-20",1985,13380,1982,13363,3,17,0,0,1986,13378,0,0,1986,13378,"California",3228519,0,814009,0.535,676498,0.445
"4019","orange",4019,"2020-12-21",4253,17633,4247,17610,6,23,0,0,4253,17631,0,0,4253,17631,"California",3228519,0,814009,0.535,676498,0.445
"4020","orange",4020,"2020-12-22",3983,21616,3947,21557,36,59,0,0,3983,21614,0,0,3983,21614,"California",3228519,0,814009,0.535,676498,0.445
"4021","orange",4021,"2020-12-23",3563,25179,3200,24757,363,422,0,0,3565,25179,0,0,3565,25179,"California",3228519,0,814009,0.535,676498,0.445
"4022","orange",4022,"2020-12-24",1380,26559,1079,25836,301,723,0,0,1380,26559,0,0,1380,26559,"California",3228519,0,814009,0.535,676498,0.445
"4023","orange",4023,"2020-12-25",17,26576,12,25848,5,728,0,0,17,26576,0,0,17,26576,"California",3228519,0,814009,0.535,676498,0.445
"4024","orange",4024,"2020-12-26",1023,27599,423,26271,600,1328,0,0,1023,27599,0,0,1023,27599,"California",3228519,0,814009,0.535,676498,0.445
"4025","orange",4025,"2020-12-27",582,28181,275,26546,307,1635,0,0,582,28181,0,0,582,28181,"California",3228519,0,814009,0.535,676498,0.445
"4026","orange",4026,"2020-12-28",3542,31723,2568,29114,974,2609,0,0,3542,31723,0,0,3542,31723,"California",3228519,0,814009,0.535,676498,0.445
"4027","orange",4027,"2020-12-29",3575,35298,2563,31677,1012,3621,0,0,3574,35296,1,1,3574,35297,"California",3228519,3.0973954311559e-07,814009,0.535,676498,0.445
"4028","orange",4028,"2020-12-30",5129,40427,3558,35235,1571,5192,0,0,5129,40425,0,1,5129,40426,"California",3228519,3.0973954311559e-07,814009,0.535,676498,0.445
"4029","orange",4029,"2020-12-31",1498,41925,801,36036,697,5889,0,0,1498,41923,0,1,1498,41924,"California",3228519,3.0973954311559e-07,814009,0.535,676498,0.445
"4030","orange",4030,"2021-01-01",546,42471,299,36335,247,6136,0,0,545,42467,1,2,545,42469,"California",3228519,6.19479086231179e-07,814009,0.535,676498,0.445
"4031","orange",4031,"2021-01-02",1415,43886,904,37239,511,6647,0,0,1415,43882,0,2,1415,43884,"California",3228519,6.19479086231179e-07,814009,0.535,676498,0.445
"4032","orange",4032,"2021-01-03",583,44469,323,37562,260,6907,0,0,583,44465,0,2,583,44467,"California",3228519,6.19479086231179e-07,814009,0.535,676498,0.445
"4033","orange",4033,"2021-01-04",2745,47214,1562,39124,1183,8090,0,0,2746,47210,1,3,2746,47213,"California",3228519,9.29218629346769e-07,814009,0.535,676498,0.445
"4034","orange",4034,"2021-01-05",3524,50738,2296,41420,1228,9318,0,0,3117,49927,403,406,3120,50333,"California",3228519,0.000125754254504929,814009,0.535,676498,0.445
"4035","orange",4035,"2021-01-06",5011,55749,3466,44886,1545,10863,0,0,3644,52216,1355,1761,3644,53977,"California",3228519,0.000545451335426553,814009,0.535,676498,0.445
"4036","orange",4036,"2021-01-07",9267,65016,5168,50054,4099,14962,0,0,5696,54358,3558,5319,5700,59677,"California",3228519,0.00164750462983182,814009,0.535,676498,0.445
"4037","orange",4037,"2021-01-08",9420,74436,5269,55323,4151,19113,0,0,5657,56265,3753,9072,5660,65337,"California",3228519,0.00280995713514463,814009,0.535,676498,0.445
"4038","orange",4038,"2021-01-09",5011,79447,1743,57066,3268,22381,0,0,3729,58712,1282,10354,3729,69066,"California",3228519,0.00320704322941881,814009,0.535,676498,0.445
"4039","orange",4039,"2021-01-10",4237,83684,1042,58108,3195,25576,0,0,3358,61196,878,11232,3362,72428,"California",3228519,0.0034789945482743,814009,0.535,676498,0.445
"4040","orange",4040,"2021-01-11",9442,93126,4903,63011,4539,30115,0,0,5819,63390,3626,14858,5820,78248,"California",3228519,0.00460211013161143,814009,0.535,676498,0.445
"4041","orange",4041,"2021-01-12",8820,101946,4724,67735,4096,34211,0,0,5356,65285,3462,18320,5357,83605,"California",3228519,0.0056744284298776,814009,0.535,676498,0.445
"4042","orange",4042,"2021-01-13",10258,112204,4924,72659,5334,39545,0,0,7056,69150,3198,21518,7063,90668,"California",3228519,0.00666497548876126,814009,0.535,676498,0.445
"4043","orange",4043,"2021-01-14",9971,122175,3778,76437,6193,45738,0,0,8378,75944,1590,23108,8384,99052,"California",3228519,0.00715746136231504,814009,0.535,676498,0.445
"4044","orange",4044,"2021-01-15",10172,132347,2628,79065,7544,53282,0,0,9293,84356,887,23995,9299,108351,"California",3228519,0.00743220033705857,814009,0.535,676498,0.445
"4045","orange",4045,"2021-01-16",8708,141055,2096,81161,6612,59894,0,0,8312,92278,395,24390,8317,116668,"California",3228519,0.00755454745658923,814009,0.535,676498,0.445
"4046","orange",4046,"2021-01-17",8157,149212,1484,82645,6673,66567,0,0,8010,100151,147,24537,8020,124688,"California",3228519,0.00760007916942722,814009,0.535,676498,0.445
"4047","orange",4047,"2021-01-18",9756,158968,4460,87105,5296,71863,0,0,7512,105420,2246,26783,7515,132203,"California",3228519,0.00829575418326483,814009,0.535,676498,0.445
"4048","orange",4048,"2021-01-19",7495,166463,5414,92519,2081,73944,0,0,4863,107652,2632,29415,4864,137067,"California",3228519,0.00911098866074507,814009,0.535,676498,0.445
"4049","orange",4049,"2021-01-20",8383,174846,5920,98439,2463,76407,0,0,5321,109919,3062,32477,5329,142396,"California",3228519,0.010059411141765,814009,0.535,676498,0.445
"4050","orange",4050,"2021-01-21",11013,185859,4905,103344,6108,82515,0,0,10200,119318,812,33289,10211,152607,"California",3228519,0.0103109196507749,814009,0.535,676498,0.445
"4051","orange",4051,"2021-01-22",13667,199526,5140,108484,8527,91042,0,0,12813,131292,847,34136,12821,165428,"California",3228519,0.0105732690437938,814009,0.535,676498,0.445
"4052","orange",4052,"2021-01-23",13137,212663,6187,114671,6950,97992,0,0,12154,142473,981,35117,12162,177590,"California",3228519,0.0108771235355902,814009,0.535,676498,0.445
"4053","orange",4053,"2021-01-24",9823,222486,4296,118967,5527,103519,0,0,9492,151640,328,35445,9495,187085,"California",3228519,0.0109787181057321,814009,0.535,676498,0.445
"4054","orange",4054,"2021-01-25",10450,232936,5868,124835,4582,108101,0,0,7721,156643,2723,38168,7726,194811,"California",3228519,0.0118221388816358,814009,0.535,676498,0.445
"4055","orange",4055,"2021-01-26",11905,244841,7723,132558,4182,112283,0,0,9734,164213,2167,40335,9737,204548,"California",3228519,0.0124933444715673,814009,0.535,676498,0.445
"4056","orange",4056,"2021-01-27",13435,258276,8010,140568,5425,117708,0,0,10731,172256,2693,43028,10736,215284,"California",3228519,0.0133274730611776,814009,0.535,676498,0.445
"4057","orange",4057,"2021-01-28",13036,271312,7208,147776,5828,123536,0,0,11170,181583,1851,44879,11178,226462,"California",3228519,0.0139008009554845,814009,0.535,676498,0.445
"4058","orange",4058,"2021-01-29",13649,284961,8457,156233,5192,128728,0,0,10749,189450,2886,47765,10753,237215,"California",3228519,0.0147947092769161,814009,0.535,676498,0.445
"4059","orange",4059,"2021-01-30",12933,297894,4444,160677,8489,137217,0,0,12188,200911,730,48495,12191,249406,"California",3228519,0.0150208191433905,814009,0.535,676498,0.445
"4060","orange",4060,"2021-01-31",13719,311613,4947,165624,8772,145989,0,0,13257,213719,456,48951,13264,262670,"California",3228519,0.0151620603750512,814009,0.535,676498,0.445
"4061","orange",4061,"2021-02-01",14091,325704,5811,171435,8280,154269,0,0,12073,223800,1997,50948,12078,274748,"California",3228519,0.0157806102426531,814009,0.535,676498,0.445
"4062","orange",4062,"2021-02-02",15436,341140,8377,179812,7059,161328,0,0,12680,233833,2650,53598,12683,287431,"California",3228519,0.0166014200319094,814009,0.535,676498,0.445
"4063","orange",4063,"2021-02-03",16768,357908,12585,192397,4183,165511,0,0,13735,244618,2955,56553,13740,301171,"California",3228519,0.0175167003818159,814009,0.535,676498,0.445
"4064","orange",4064,"2021-02-04",19881,377789,12999,205396,6882,172393,0,0,14790,254356,5060,61613,14798,315969,"California",3228519,0.0190839824699808,814009,0.535,676498,0.445
"4065","orange",4065,"2021-02-05",20766,398555,12026,217422,8740,181133,0,0,14472,262578,6253,67866,14475,330444,"California",3228519,0.0210207838330826,814009,0.535,676498,0.445
"4066","orange",4066,"2021-02-06",16337,414892,10795,228217,5542,186675,0,0,11074,268623,5247,73113,11292,341736,"California",3228519,0.0226459872158101,814009,0.535,676498,0.445
"4067","orange",4067,"2021-02-07",11527,426419,8104,236321,3423,190098,0,0,7551,272383,3960,77073,7720,349456,"California",3228519,0.0238725558065478,814009,0.535,676498,0.445
"4068","orange",4068,"2021-02-08",14956,441375,8587,244908,6369,196467,0,0,8929,275316,5997,83070,8930,358386,"California",3228519,0.025730063846612,814009,0.535,676498,0.445
"4069","orange",4069,"2021-02-09",17682,459057,12041,256949,5641,202108,0,0,10709,279131,6899,89969,10714,369100,"California",3228519,0.0278669569545665,814009,0.535,676498,0.445
"4070","orange",4070,"2021-02-10",20923,479980,11198,268147,9725,211833,0,0,12679,283671,8148,98117,12688,381788,"California",3228519,0.0303907147518723,814009,0.535,676498,0.445
"4071","orange",4071,"2021-02-11",22110,502090,11493,279640,10617,222450,0,0,12377,286465,9601,107718,12395,394183,"California",3228519,0.0333645241053251,814009,0.535,676498,0.445
"4072","orange",4072,"2021-02-12",24795,526885,11913,291553,12882,235332,0,0,14632,291000,10102,117820,14637,408820,"California",3228519,0.0364935129698788,814009,0.535,676498,0.445
"4073","orange",4073,"2021-02-13",22020,548905,11916,303469,10104,245436,0,0,11149,292121,10669,128489,11790,420610,"California",3228519,0.039798124155379,814009,0.535,676498,0.445
"4074","orange",4074,"2021-02-14",16196,565101,6575,310044,9621,255057,0,0,9550,295052,6620,135109,9551,430161,"California",3228519,0.0418485999308042,814009,0.535,676498,0.445
"4075","orange",4075,"2021-02-15",17231,582332,7396,317440,9835,264892,0,0,8882,295638,8305,143414,8891,439052,"California",3228519,0.0444209868363792,814009,0.535,676498,0.445
"4076","orange",4076,"2021-02-16",19938,602270,8989,326429,10949,275841,0,0,10722,297216,9168,152582,10746,449798,"California",3228519,0.0472606789676629,814009,0.535,676498,0.445
"4077","orange",4077,"2021-02-17",17898,620168,9334,335763,8564,284405,0,0,9191,297778,8660,161242,9222,459020,"California",3228519,0.0499430234110439,814009,0.535,676498,0.445
"4078","orange",4078,"2021-02-18",15035,635203,9876,345639,5159,289564,0,0,6780,296363,8203,169445,6788,465808,"California",3228519,0.0524838168832211,814009,0.535,676498,0.445
"4079","orange",4079,"2021-02-19",18194,653397,10895,356534,7299,296863,0,0,6936,292104,11207,180652,6948,472756,"California",3228519,0.0559550679429175,814009,0.535,676498,0.445
"4080","orange",4080,"2021-02-20",7528,660925,5620,362154,1908,298771,0,0,3778,292164,3728,184380,3788,476544,"California",3228519,0.0571097769596524,814009,0.535,676498,0.445
"4081","orange",4081,"2021-02-21",4381,665306,3698,365852,683,299454,0,0,792,289405,3551,187931,792,477336,"California",3228519,0.0582096620772559,814009,0.535,676498,0.445
"4082","orange",4082,"2021-02-22",9657,674963,7877,373729,1780,301234,0,0,3896,287585,5731,193662,3911,481247,"California",3228519,0.0599847793988513,814009,0.535,676498,0.445
"4083","orange",4083,"2021-02-23",13272,688235,7249,380978,6023,307257,0,0,3495,281375,9716,203378,3506,484753,"California",3228519,0.0629942087997624,814009,0.535,676498,0.445
"4084","orange",4084,"2021-02-24",21172,709407,12841,393819,8331,315588,0,0,5396,271078,15712,219090,5415,490168,"California",3228519,0.0678608365011945,814009,0.535,676498,0.445
"4085","orange",4085,"2021-02-25",22680,732087,12299,406118,10381,325969,0,0,7997,264480,14611,233701,8013,498181,"California",3228519,0.0723864409656564,814009,0.535,676498,0.445
"4086","orange",4086,"2021-02-26",27764,759851,14088,420206,13676,339645,0,0,11175,259213,16467,250168,11200,509381,"California",3228519,0.0774869220221408,814009,0.535,676498,0.445
"4087","orange",4087,"2021-02-27",25007,784858,10104,430310,14901,354546,2,2,7264,248857,17637,267805,7281,516662,"California",3228519,0.0829497983440705,814009,0.535,676498,0.445
"4088","orange",4088,"2021-02-28",19086,803944,7411,437721,11675,366221,0,2,4826,239559,14141,281946,4843,521505,"California",3228519,0.087329825223268,814009,0.535,676498,0.445
"4089","orange",4089,"2021-03-01",18449,822393,8411,446132,10031,376252,7,9,7137,235485,11230,293176,7156,528661,"California",3228519,0.0908082002924561,814009,0.535,676498,0.445
"4090","orange",4090,"2021-03-02",18852,841245,8910,455042,9939,386191,3,12,9190,235091,9614,302790,9220,537881,"California",3228519,0.0937860362599694,814009,0.535,676498,0.445
"4091","orange",4091,"2021-03-03",20529,861774,9651,464693,10875,397066,3,15,11008,236684,9441,312231,11034,548915,"California",3228519,0.0967102872865236,814009,0.535,676498,0.445
"4092","orange",4092,"2021-03-04",22343,884117,12862,477555,9467,406533,14,29,11604,237627,10701,322932,11644,560559,"California",3228519,0.100024810137404,814009,0.535,676498,0.445
"4093","orange",4093,"2021-03-05",20763,904880,10768,488323,9950,416483,45,74,12710,242432,8010,330942,12815,573374,"California",3228519,0.102505823877759,814009,0.535,676498,0.445
"4094","orange",4094,"2021-03-06",23971,928851,13142,501465,9965,426448,864,938,12675,244735,11260,342202,13563,586937,"California",3228519,0.105993491133241,814009,0.535,676498,0.445
"4095","orange",4095,"2021-03-07",14859,943710,8318,509783,6142,432590,399,1337,8672,247678,6148,348350,9091,596028,"California",3228519,0.107897769844316,814009,0.535,676498,0.445
"4096","orange",4096,"2021-03-08",16235,959945,7428,517211,7545,440135,1262,2599,10421,253624,5764,354114,11710,607738,"California",3228519,0.109683108570834,814009,0.535,676498,0.445
"4097","orange",4097,"2021-03-09",19748,979693,8592,525803,8721,448856,2435,5034,11332,259016,8376,362490,13768,621506,"California",3228519,0.11227748698397,814009,0.535,676498,0.445
"4098","orange",4098,"2021-03-10",24326,1004019,11773,537576,9103,457959,3450,8484,12157,262508,12111,374601,15603,637109,"California",3228519,0.116028742590643,814009,0.535,676498,0.445
"4099","orange",4099,"2021-03-11",28981,1033000,15687,553263,9075,467034,4219,12703,13429,264692,15461,390062,17645,654754,"California",3228519,0.120817625666753,814009,0.535,676498,0.445
"4100","orange",4100,"2021-03-12",29241,1062241,14231,567494,11157,478191,3853,16556,14675,268753,14488,404550,18549,673303,"California",3228519,0.125305132167412,814009,0.535,676498,0.445
"4101","orange",4101,"2021-03-13",27717,1089958,10163,577657,13626,491817,3928,20484,14022,273063,13638,418188,17948,691251,"California",3228519,0.129529360056422,814009,0.535,676498,0.445
"4102","orange",4102,"2021-03-14",18800,1108758,8149,585806,8126,499943,2525,23009,11869,280545,6901,425089,14383,705634,"California",3228519,0.131666872643463,814009,0.535,676498,0.445
"4103","orange",4103,"2021-03-15",22987,1131745,10119,595925,12110,512053,758,23767,14354,287094,8558,433647,15107,720741,"California",3228519,0.134317623653446,814009,0.535,676498,0.445
"4104","orange",4104,"2021-03-16",26340,1158085,11136,607061,14979,527032,225,23992,17142,295352,9116,442763,17374,738115,"California",3228519,0.137141209328488,814009,0.535,676498,0.445
"4105","orange",4105,"2021-03-17",27306,1185391,13549,620610,13168,540200,589,24581,19431,307566,7803,450566,20017,758132,"California",3228519,0.139558106983419,814009,0.535,676498,0.445
"4106","orange",4106,"2021-03-18",27706,1213097,13921,634531,13509,553709,276,24857,21582,323372,6057,456623,21863,779995,"California",3228519,0.14143419939607,814009,0.535,676498,0.445
"4107","orange",4107,"2021-03-19",33416,1246513,18361,652892,14615,568324,440,25297,24883,340282,8423,465046,25333,805328,"California",3228519,0.144043135567732,814009,0.535,676498,0.445
"4108","orange",4108,"2021-03-20",25746,1272259,13544,666436,11996,580320,206,25503,22031,358869,3653,468699,22240,827568,"California",3228519,0.145174614118734,814009,0.535,676498,0.445
"4109","orange",4109,"2021-03-21",18472,1290731,10668,677104,7077,587397,727,26230,15714,372581,2729,471428,16441,844009,"California",3228519,0.146019893331896,814009,0.535,676498,0.445
"4110","orange",4110,"2021-03-22",22710,1313441,11728,688832,10660,598057,322,26552,19193,388671,3433,474861,19523,863532,"California",3228519,0.147083229183412,814009,0.535,676498,0.445
"4111","orange",4111,"2021-03-23",25954,1339395,13456,702288,11863,609920,635,27187,20853,405142,5021,479882,21492,885024,"California",3228519,0.148638431429395,814009,0.535,676498,0.445
"4112","orange",4112,"2021-03-24",29050,1368445,16189,718477,11951,621871,910,28097,22000,421088,6966,486848,22912,907936,"California",3228519,0.150796077086739,814009,0.535,676498,0.445
"4113","orange",4113,"2021-03-25",32260,1400705,17176,735653,14381,636252,703,28800,24199,438017,7971,494819,24900,932836,"California",3228519,0.153265010984913,814009,0.535,676498,0.445
"4114","orange",4114,"2021-03-26",34719,1435424,18003,753656,15853,652105,863,29663,24985,454236,9631,504450,25850,958686,"California",3228519,0.156248112524659,814009,0.535,676498,0.445
"4115","orange",4115,"2021-03-27",28355,1463779,13562,767218,14479,666584,314,29977,19791,465872,8472,512922,20108,978794,"California",3228519,0.158872225933934,814009,0.535,676498,0.445
"4116","orange",4116,"2021-03-28",24709,1488488,12779,779997,11862,678446,68,30045,18626,478556,6013,518935,18697,997491,"California",3228519,0.160734689806688,814009,0.535,676498,0.445
"4117","orange",4117,"2021-03-29",26398,1514886,12062,792059,13770,692216,566,30611,17912,488632,8404,527339,18480,1015971,"California",3228519,0.163337740927032,814009,0.535,676498,0.445
"4118","orange",4118,"2021-03-30",30782,1545668,13849,805908,16297,708513,636,31247,21319,501200,9388,536727,21956,1037927,"California",3228519,0.166245575757801,814009,0.535,676498,0.445
"4119","orange",4119,"2021-03-31",36975,1582643,19381,825289,16883,725396,711,31958,24051,513142,12827,549554,24769,1062696,"California",3228519,0.170218604877345,814009,0.535,676498,0.445
"4120","orange",4120,"2021-04-01",40166,1622809,21064,846353,17264,742660,1838,33796,26053,527022,14003,563557,27883,1090579,"California",3228519,0.174555887699592,814009,0.535,676498,0.445
"4121","orange",4121,"2021-04-02",39802,1662611,20063,866416,17957,760617,1782,35578,22579,534286,17123,580680,24387,1114966,"California",3228519,0.179859557896361,814009,0.535,676498,0.445
"4122","orange",4122,"2021-04-03",30001,1692612,15630,882046,12675,773292,1696,37274,14213,534473,15717,596397,15904,1130870,"California",3228519,0.184727734295508,814009,0.535,676498,0.445
"4123","orange",4123,"2021-04-04",18331,1710943,10646,892692,6929,780221,756,38030,8178,533304,10099,606496,8930,1139800,"California",3228519,0.187855793941433,814009,0.535,676498,0.445
"4124","orange",4124,"2021-04-05",29795,1740738,13925,906617,12493,792714,3377,41407,13825,534592,15900,622396,17188,1156988,"California",3228519,0.19278065267697,814009,0.535,676498,0.445
"4125","orange",4125,"2021-04-06",33220,1773958,15555,922172,14245,806959,3420,44827,14365,533592,18764,641160,17764,1174752,"California",3228519,0.198592605463991,814009,0.535,676498,0.445
"4126","orange",4126,"2021-04-07",35845,1809803,19992,942164,11286,818245,4567,49394,15787,533938,19979,661139,20325,1195077,"California",3228519,0.204780891795898,814009,0.535,676498,0.445
"4127","orange",4127,"2021-04-08",38498,1848301,21425,963589,11644,829889,5429,54823,18756,538445,19648,680787,24155,1219232,"California",3228519,0.210866654339033,814009,0.535,676498,0.445
"4128","orange",4128,"2021-04-09",40469,1888770,23580,987169,11745,841634,5144,59967,17930,539038,22455,703242,23048,1242280,"California",3228519,0.217821855779693,814009,0.535,676498,0.445
"4129","orange",4129,"2021-04-10",34079,1922849,18071,1005240,11804,853438,4204,64171,14152,537518,19846,723088,18326,1260606,"California",3228519,0.223968946752365,814009,0.535,676498,0.445
"4130","orange",4130,"2021-04-11",25460,1948309,14377,1019617,7824,861262,3259,67430,9798,534944,15616,738704,13042,1273648,"California",3228519,0.228805839457658,814009,0.535,676498,0.445
"4131","orange",4131,"2021-04-12",30304,1978613,15345,1034962,11428,872690,3531,70961,11936,532071,18314,757018,15441,1289089,"California",3228519,0.234478409450277,814009,0.535,676498,0.445
"4132","orange",4132,"2021-04-13",32237,2010850,18125,1053087,14045,886735,67,71028,15036,530036,17136,774154,15101,1304190,"California",3228519,0.239786106261106,814009,0.535,676498,0.445
"4133","orange",4133,"2021-04-14",34233,2045083,20011,1073098,14192,900927,30,71058,15026,525976,19118,793272,15058,1319248,"California",3228519,0.24570770684639,814009,0.535,676498,0.445
"4134","orange",4134,"2021-04-15",39799,2084882,24285,1097383,15501,916428,13,71071,18493,523275,21209,814481,18508,1337756,"California",3228519,0.252276972816328,814009,0.535,676498,0.445
"4135","orange",4135,"2021-04-16",41082,2125964,24146,1121529,16906,933334,30,71101,18557,519439,22429,836910,18593,1356349,"California",3228519,0.259224121028868,814009,0.535,676498,0.445
"4136","orange",4136,"2021-04-17",29894,2155858,17246,1138775,12645,945979,3,71104,13003,515632,16817,853727,13010,1369359,"California",3228519,0.264433010925443,814009,0.535,676498,0.445
"4137","orange",4137,"2021-04-18",21360,2177218,12916,1151691,8444,954423,0,71104,8464,511248,12851,866578,8467,1377826,"California",3228519,0.268413473794021,814009,0.535,676498,0.445
"4138","orange",4138,"2021-04-19",32341,2209559,17820,1169511,14519,968942,2,71106,14856,508707,17402,883980,14861,1392687,"California",3228519,0.273803561323319,814009,0.535,676498,0.445
"4139","orange",4139,"2021-04-20",35075,2244634,18208,1187719,16864,985806,3,71109,17537,508781,17465,901445,17539,1410226,"California",3228519,0.279213162443833,814009,0.535,676498,0.445
"4140","orange",4140,"2021-04-21",40446,2285080,23277,1210996,17159,1002965,10,71119,19142,506720,21214,922659,19153,1429379,"California",3228519,0.285783977111487,814009,0.535,676498,0.445
"4141","orange",4141,"2021-04-22",39104,2324184,20667,1231663,18429,1021394,8,71127,16258,500262,22730,945389,16272,1445651,"California",3228519,0.292824356926504,814009,0.535,676498,0.445
"4142","orange",4142,"2021-04-23",39897,2364081,20554,1252217,19337,1040731,6,71133,17738,495952,22056,967445,17746,1463397,"California",3228519,0.299655972289462,814009,0.535,676498,0.445
"4143","orange",4143,"2021-04-24",31792,2395873,16651,1268868,15106,1055837,35,71168,13366,491003,18352,985797,13403,1476800,"California",3228519,0.305340312384719,814009,0.535,676498,0.445
"4144","orange",4144,"2021-04-25",22929,2418802,12929,1281797,9987,1065824,13,71181,9845,487836,13030,998827,9863,1486663,"California",3228519,0.309376218631515,814009,0.535,676498,0.445
"4145","orange",4145,"2021-04-26",25248,2444050,12041,1293838,13029,1078853,178,71359,11042,484935,14121,1012948,11220,1497883,"California",3228519,0.31375005071985,814009,0.535,676498,0.445
"4146","orange",4146,"2021-04-27",27727,2471777,12616,1306454,14622,1093475,489,71848,10533,478914,17048,1029996,11027,1508910,"California",3228519,0.319030490450885,814009,0.535,676498,0.445
"4147","orange",4147,"2021-04-28",30499,2502276,15173,1321627,14462,1107937,864,72712,12088,473550,18312,1048308,12948,1521858,"California",3228519,0.324702440964417,814009,0.535,676498,0.445
"4148","orange",4148,"2021-04-29",31398,2533674,17169,1338796,13277,1121214,952,73664,11229,465642,20084,1068392,12176,1534034,"California",3228519,0.330923249948351,814009,0.535,676498,0.445
"4149","orange",4149,"2021-04-30",29296,2562970,16644,1355440,11725,1132939,927,74591,12359,462070,16853,1085245,13281,1547315,"California",3228519,0.336143290468478,814009,0.535,676498,0.445
"4150","orange",4150,"2021-05-01",21747,2584717,14655,1370095,6107,1139046,985,75576,8668,458708,13009,1098254,9647,1556962,"California",3228519,0.340172692184869,814009,0.535,676498,0.445
"4151","orange",4151,"2021-05-02",15366,2600083,10215,1380310,4510,1143556,641,76217,5376,454794,9929,1108183,6015,1562977,"California",3228519,0.343248096108463,814009,0.535,676498,0.445
"4152","orange",4152,"2021-05-03",20409,2620492,12438,1392748,7217,1150773,754,76971,6381,447968,13956,1122139,7130,1570107,"California",3228519,0.347570821172185,814009,0.535,676498,0.445
"4153","orange",4153,"2021-05-04",23387,2643879,13335,1406083,9169,1159942,883,77854,8066,441683,15223,1137362,8938,1579045,"California",3228519,0.352285986237033,814009,0.535,676498,0.445
"4154","orange",4154,"2021-05-05",21944,2665823,12891,1418974,8168,1168110,885,78739,7155,435048,14671,1152033,8036,1587081,"California",3228519,0.356830175074082,814009,0.535,676498,0.445
"4155","orange",4155,"2021-05-06",23843,2689666,15004,1433978,7861,1175971,978,79717,6129,424547,17600,1169633,7099,1594180,"California",3228519,0.362281591032916,814009,0.535,676498,0.445
"4156","orange",4156,"2021-05-07",24723,2714389,15335,1449313,8357,1184328,1031,80748,6985,415003,17554,1187187,8010,1602190,"California",3228519,0.367718758972767,814009,0.535,676498,0.445
"4157","orange",4157,"2021-05-08",17068,2731457,11404,1460717,4910,1189238,754,81502,4619,408001,12377,1199564,5375,1607565,"California",3228519,0.371552405297909,814009,0.535,676498,0.445
"4158","placer",4158,"2020-12-15",29,29,29,29,0,0,0,0,29,29,0,0,29,29,"California",400434,0,106869,0.455,122488,0.521
"4159","placer",4159,"2020-12-16",54,83,54,83,0,0,0,0,54,83,0,0,54,83,"California",400434,0,106869,0.455,122488,0.521
"4160","placer",4160,"2020-12-17",140,223,140,223,0,0,0,0,140,223,0,0,140,223,"California",400434,0,106869,0.455,122488,0.521
"4161","placer",4161,"2020-12-18",332,555,332,555,0,0,0,0,332,555,0,0,332,555,"California",400434,0,106869,0.455,122488,0.521
"4162","placer",4162,"2020-12-19",252,807,252,807,0,0,0,0,252,807,0,0,252,807,"California",400434,0,106869,0.455,122488,0.521
"4163","placer",4163,"2020-12-20",234,1041,234,1041,0,0,0,0,234,1041,0,0,234,1041,"California",400434,0,106869,0.455,122488,0.521
"4164","placer",4164,"2020-12-21",493,1534,492,1533,1,1,0,0,493,1534,0,0,493,1534,"California",400434,0,106869,0.455,122488,0.521
"4165","placer",4165,"2020-12-22",675,2209,668,2201,7,8,0,0,675,2209,0,0,675,2209,"California",400434,0,106869,0.455,122488,0.521
"4166","placer",4166,"2020-12-23",748,2957,662,2863,86,94,0,0,748,2957,0,0,748,2957,"California",400434,0,106869,0.455,122488,0.521
"4167","placer",4167,"2020-12-24",398,3355,346,3209,52,146,0,0,398,3355,0,0,398,3355,"California",400434,0,106869,0.455,122488,0.521
"4168","placer",4168,"2020-12-26",156,3511,111,3320,45,191,0,0,156,3511,0,0,156,3511,"California",400434,0,106869,0.455,122488,0.521
"4169","placer",4169,"2020-12-27",186,3697,163,3483,23,214,0,0,186,3697,0,0,186,3697,"California",400434,0,106869,0.455,122488,0.521
"4170","placer",4170,"2020-12-28",663,4360,536,4019,127,341,0,0,663,4360,0,0,663,4360,"California",400434,0,106869,0.455,122488,0.521
"4171","placer",4171,"2020-12-29",762,5122,513,4532,249,590,0,0,762,5122,0,0,762,5122,"California",400434,0,106869,0.455,122488,0.521
"4172","placer",4172,"2020-12-30",728,5850,454,4986,274,864,0,0,726,5848,0,0,726,5848,"California",400434,0,106869,0.455,122488,0.521
"4173","placer",4173,"2020-12-31",529,6379,343,5329,186,1050,0,0,529,6377,0,0,529,6377,"California",400434,0,106869,0.455,122488,0.521
"4174","placer",4174,"2021-01-01",15,6394,11,5340,4,1054,0,0,15,6392,0,0,15,6392,"California",400434,0,106869,0.455,122488,0.521
"4175","placer",4175,"2021-01-02",184,6578,152,5492,32,1086,0,0,184,6576,0,0,184,6576,"California",400434,0,106869,0.455,122488,0.521
"4176","placer",4176,"2021-01-03",154,6732,79,5571,75,1161,0,0,154,6730,0,0,154,6730,"California",400434,0,106869,0.455,122488,0.521
"4177","placer",4177,"2021-01-04",619,7351,180,5751,439,1600,0,0,619,7349,0,0,619,7349,"California",400434,0,106869,0.455,122488,0.521
"4178","placer",4178,"2021-01-05",726,8077,159,5910,567,2167,0,0,643,7911,82,82,644,7993,"California",400434,0.000204777816069565,106869,0.455,122488,0.521
"4179","placer",4179,"2021-01-06",760,8837,244,6154,516,2683,0,0,618,8387,142,224,618,8611,"California",400434,0.000559393058531493,106869,0.455,122488,0.521
"4180","placer",4180,"2021-01-07",985,9822,368,6522,617,3300,0,0,780,8962,205,429,780,9391,"California",400434,0.0010713375987054,106869,0.455,122488,0.521
"4181","placer",4181,"2021-01-08",1184,11006,528,7050,656,3956,0,0,855,9491,326,755,855,10246,"California",400434,0.00188545428210392,106869,0.455,122488,0.521
"4182","placer",4182,"2021-01-09",450,11456,321,7371,129,4085,0,0,234,9510,215,970,234,10480,"California",400434,0.00242237172667656,106869,0.455,122488,0.521
"4183","placer",4183,"2021-01-10",329,11785,186,7557,143,4228,0,0,164,9509,165,1135,164,10644,"California",400434,0.00283442464925556,106869,0.455,122488,0.521
"4184","placer",4184,"2021-01-11",1425,13210,807,8364,618,4846,0,0,836,9757,589,1724,837,11481,"California",400434,0.0043053287183406,106869,0.455,122488,0.521
"4185","placer",4185,"2021-01-12",1651,14861,877,9241,774,5620,0,0,1049,10204,602,2326,1049,12530,"California",400434,0.00580869756314399,106869,0.455,122488,0.521
"4186","placer",4186,"2021-01-13",1634,16495,821,10062,813,6433,0,0,1210,10995,422,2748,1213,13743,"California",400434,0.00686255412877028,106869,0.455,122488,0.521
"4187","placer",4187,"2021-01-14",1775,18270,652,10714,1123,7556,0,0,1419,12062,353,3101,1420,15163,"California",400434,0.00774409765404536,106869,0.455,122488,0.521
"4188","placer",4188,"2021-01-15",1936,20206,722,11436,1214,8770,0,0,1586,13300,349,3450,1587,16750,"California",400434,0.00861565201756095,106869,0.455,122488,0.521
"4189","placer",4189,"2021-01-16",1470,21676,720,12156,750,9520,0,0,1349,14529,121,3571,1350,18100,"California",400434,0.00891782416078555,106869,0.455,122488,0.521
"4190","placer",4190,"2021-01-17",563,22239,397,12553,166,9686,0,0,430,14826,133,3704,430,18530,"California",400434,0.00924996378928862,106869,0.455,122488,0.521
"4191","placer",4191,"2021-01-18",976,23215,539,13092,437,10123,0,0,747,15345,229,3933,748,19278,"California",400434,0.00982184330001948,106869,0.455,122488,0.521
"4192","placer",4192,"2021-01-19",2611,25826,1948,15040,663,10786,0,0,2161,17056,450,4383,2161,21439,"California",400434,0.0109456239979622,106869,0.455,122488,0.521
"4193","placer",4193,"2021-01-20",2266,28092,1697,16737,569,11355,0,0,1937,18665,329,4712,1938,23377,"California",400434,0.0117672325526803,106869,0.455,122488,0.521
"4194","placer",4194,"2021-01-21",2557,30649,1113,17850,1444,12799,0,0,2164,20438,392,5104,2165,25542,"California",400434,0.0127461704051105,106869,0.455,122488,0.521
"4195","placer",4195,"2021-01-22",2304,32953,595,18445,1709,14508,0,0,2129,22395,173,5277,2130,27672,"California",400434,0.0131782016512084,106869,0.455,122488,0.521
"4196","placer",4196,"2021-01-23",1189,34142,380,18825,809,15317,0,0,1034,23274,155,5432,1034,28706,"California",400434,0.0135652816693887,106869,0.455,122488,0.521
"4197","placer",4197,"2021-01-24",507,34649,265,19090,242,15559,0,0,431,23630,76,5508,432,29138,"California",400434,0.013755075742819,106869,0.455,122488,0.521
"4198","placer",4198,"2021-01-25",1672,36321,802,19892,870,16429,0,0,1384,24727,288,5796,1385,30523,"California",400434,0.0144742953895024,106869,0.455,122488,0.521
"4199","placer",4199,"2021-01-26",1855,38176,1030,20922,825,17254,0,0,1591,26054,264,6060,1591,32114,"California",400434,0.0151335800656288,106869,0.455,122488,0.521
"4200","placer",4200,"2021-01-27",1841,40017,1153,22075,688,17942,0,0,1597,27410,242,6302,1598,33712,"California",400434,0.015737924352078,106869,0.455,122488,0.521
"4201","placer",4201,"2021-01-28",1806,41823,1116,23191,690,18632,0,0,1558,28722,246,6548,1558,35270,"California",400434,0.0163522578002867,106869,0.455,122488,0.521
"4202","placer",4202,"2021-01-29",1894,43717,1171,24362,723,19355,0,0,1702,30235,191,6739,1704,36974,"California",400434,0.0168292402743024,106869,0.455,122488,0.521
"4203","placer",4203,"2021-01-30",1727,45444,973,25335,754,20109,0,0,1606,31721,120,6859,1606,38580,"California",400434,0.0171289151270871,106869,0.455,122488,0.521
"4204","placer",4204,"2021-01-31",781,46225,624,25959,157,20266,0,0,713,32367,68,6927,714,39294,"California",400434,0.0172987308769985,106869,0.455,122488,0.521
"4205","placer",4205,"2021-02-01",2071,48296,1090,27049,981,21247,0,0,1757,33810,314,7241,1757,41051,"California",400434,0.0180828800751185,106869,0.455,122488,0.521
"4206","placer",4206,"2021-02-02",2379,50675,1542,28591,837,22084,0,0,1888,35210,488,7729,1888,42939,"California",400434,0.0193015578097764,106869,0.455,122488,0.521
"4207","placer",4207,"2021-02-03",2920,53595,1877,30468,1043,23127,0,0,2296,36886,620,8349,2296,45235,"California",400434,0.0208498778824975,106869,0.455,122488,0.521
"4208","placer",4208,"2021-02-04",2759,56354,1187,31655,1572,24699,0,0,1935,38002,820,9169,1936,47171,"California",400434,0.0228976560431931,106869,0.455,122488,0.521
"4209","placer",4209,"2021-02-05",2731,59085,1205,32860,1526,26225,0,0,1403,38082,1323,10492,1403,48574,"California",400434,0.0262015712951448,106869,0.455,122488,0.521
"4210","placer",4210,"2021-02-06",1954,61039,1313,34173,641,26866,0,0,1401,38930,553,11045,1401,49975,"California",400434,0.0275825729083944,106869,0.455,122488,0.521
"4211","placer",4211,"2021-02-07",1226,62265,915,35088,311,27177,0,0,939,39583,286,11331,939,50914,"California",400434,0.028296797974198,106869,0.455,122488,0.521
"4212","placer",4212,"2021-02-08",3301,65566,1767,36855,1534,28711,0,0,1978,40247,1315,12646,1979,52893,"California",400434,0.0315807349026306,106869,0.455,122488,0.521
"4213","placer",4213,"2021-02-09",3550,69116,2177,39032,1373,30084,0,0,1644,39987,1904,14550,1644,54537,"California",400434,0.0363355759001483,106869,0.455,122488,0.521
"4214","placer",4214,"2021-02-10",3749,72865,2190,41222,1559,31643,0,0,1744,39731,2002,16552,1746,56283,"California",400434,0.0413351513607736,106869,0.455,122488,0.521
"4215","placer",4215,"2021-02-11",3693,76558,1905,43127,1788,33431,0,0,1588,39228,2092,18644,1589,57872,"California",400434,0.0465594829609873,106869,0.455,122488,0.521
"4216","placer",4216,"2021-02-12",2849,79407,1324,44451,1525,34956,0,0,1669,39755,1143,19787,1670,59542,"California",400434,0.0494138859337619,106869,0.455,122488,0.521
"4217","placer",4217,"2021-02-13",2540,81947,1485,45936,1055,36011,0,0,1889,40993,651,20438,1889,61431,"California",400434,0.051039622010119,106869,0.455,122488,0.521
"4218","placer",4218,"2021-02-14",1083,83030,677,46613,406,36417,0,0,738,41389,342,20780,738,62169,"California",400434,0.0518936953405555,106869,0.455,122488,0.521
"4219","placer",4219,"2021-02-15",2244,85274,1043,47656,1201,37618,0,0,1532,42209,713,21493,1533,63702,"California",400434,0.0536742634241848,106869,0.455,122488,0.521
"4220","placer",4220,"2021-02-16",3574,88848,1780,49436,1794,39412,0,0,1588,41821,1977,23470,1589,65291,"California",400434,0.0586114066238132,106869,0.455,122488,0.521
"4221","placer",4221,"2021-02-17",3543,92391,1963,51399,1580,40992,0,0,1510,41302,2029,25499,1510,66801,"California",400434,0.0636784089263149,106869,0.455,122488,0.521
"4222","placer",4222,"2021-02-18",3797,96188,2047,53446,1750,42742,0,0,1626,40767,2162,27661,1627,68428,"California",400434,0.0690775508573198,106869,0.455,122488,0.521
"4223","placer",4223,"2021-02-19",3585,99773,1910,55356,1675,44417,0,0,1328,39843,2253,29914,1329,69757,"California",400434,0.0747039462183531,106869,0.455,122488,0.521
"4224","placer",4224,"2021-02-20",2003,101776,1258,56614,745,45162,0,0,914,39677,1083,30997,917,70674,"California",400434,0.0774085117647353,106869,0.455,122488,0.521
"4225","placer",4225,"2021-02-21",974,102750,731,57345,243,45405,0,0,281,39269,690,31687,282,70956,"California",400434,0.0791316421682474,106869,0.455,122488,0.521
"4226","placer",4226,"2021-02-22",2523,105273,1775,59120,748,46153,0,0,603,37953,1919,33606,603,71559,"California",400434,0.0839239425223632,106869,0.455,122488,0.521
"4227","placer",4227,"2021-02-23",2553,107826,1578,60698,975,47128,0,0,882,37165,1670,35276,882,72441,"California",400434,0.0880944175569507,106869,0.455,122488,0.521
"4228","placer",4228,"2021-02-24",3290,111116,1176,61874,2114,49242,0,0,1792,37471,1488,36764,1794,74235,"California",400434,0.0918103857314813,106869,0.455,122488,0.521
"4229","placer",4229,"2021-02-25",3630,114746,1517,63391,2113,51355,0,0,1969,37788,1653,38417,1970,76205,"California",400434,0.095938406828591,106869,0.455,122488,0.521
"4230","placer",4230,"2021-02-26",4098,118844,2376,65767,1722,53077,0,0,2354,38402,1740,40157,2354,78559,"California",400434,0.10028369219397,106869,0.455,122488,0.521
"4231","placer",4231,"2021-02-27",2823,121667,1494,67261,1329,54406,0,0,1455,38499,1361,41518,1458,80017,"California",400434,0.103682504482636,106869,0.455,122488,0.521
"4232","placer",4232,"2021-02-28",1401,123068,796,68057,605,55011,0,0,586,38276,809,42327,586,80603,"California",400434,0.105702812448493,106869,0.455,122488,0.521
"4233","placer",4233,"2021-03-01",3000,126068,1991,70048,1009,56020,0,0,1551,38383,1444,43771,1551,82154,"California",400434,0.10930889984367,106869,0.455,122488,0.521
"4234","placer",4234,"2021-03-02",2872,128940,1762,71810,1110,57130,0,0,1876,39268,991,44762,1876,84030,"California",400434,0.111783714669584,106869,0.455,122488,0.521
"4235","placer",4235,"2021-03-03",3319,132259,1423,73233,1896,59026,0,0,1815,39586,1498,46260,1816,85846,"California",400434,0.115524655748513,106869,0.455,122488,0.521
"4236","placer",4236,"2021-03-04",3627,135886,1456,74689,2171,61197,0,0,1895,39762,1720,47980,1896,87742,"California",400434,0.119819995305094,106869,0.455,122488,0.521
"4237","placer",4237,"2021-03-05",3013,138899,1033,75722,1958,63155,22,22,1809,40391,1202,49182,1831,89573,"California",400434,0.122821738413821,106869,0.455,122488,0.521
"4238","placer",4238,"2021-03-06",2413,141312,1486,77208,831,63986,96,118,925,39931,1481,50663,1021,90594,"California",400434,0.126520225555273,106869,0.455,122488,0.521
"4239","placer",4239,"2021-03-07",1298,142610,751,77959,509,64495,38,156,531,39736,764,51427,569,91163,"California",400434,0.128428155451335,106869,0.455,122488,0.521
"4240","placer",4240,"2021-03-08",2907,145517,1826,79785,968,65463,113,269,1647,40238,1258,52685,1760,92923,"California",400434,0.131569746824695,106869,0.455,122488,0.521
"4241","placer",4241,"2021-03-09",3173,148690,1681,81466,1401,66864,91,360,1817,40793,1353,54038,1908,94831,"California",400434,0.134948580789843,106869,0.455,122488,0.521
"4242","placer",4242,"2021-03-10",3282,151972,1321,82787,1854,68718,107,467,1709,41041,1568,55606,1816,96647,"California",400434,0.138864332199563,106869,0.455,122488,0.521
"4243","placer",4243,"2021-03-11",3637,155609,1646,84433,1866,70584,125,592,1747,41035,1881,57487,1875,98522,"California",400434,0.143561735516964,106869,0.455,122488,0.521
"4244","placer",4244,"2021-03-12",3673,159282,1483,85916,1409,71993,781,1373,1252,40654,2415,59902,2034,100556,"California",400434,0.149592691929257,106869,0.455,122488,0.521
"4245","placer",4245,"2021-03-13",2108,161390,741,86657,1248,73241,119,1492,1114,40896,991,60893,1233,101789,"California",400434,0.152067506755171,106869,0.455,122488,0.521
"4246","placer",4246,"2021-03-14",1642,163032,672,87329,821,74062,149,1641,891,41185,751,61644,1040,102829,"California",400434,0.153942971875515,106869,0.455,122488,0.521
"4247","placer",4247,"2021-03-15",3183,166215,1533,88862,1518,75580,132,1773,1765,41666,1417,63061,1898,104727,"California",400434,0.157481632428815,106869,0.455,122488,0.521
"4248","placer",4248,"2021-03-16",3563,169778,1915,90777,1515,77095,133,1906,2287,42822,1265,64326,2421,107148,"California",400434,0.160640704835254,106869,0.455,122488,0.521
"4249","placer",4249,"2021-03-17",3424,173202,1728,92505,1597,78692,99,2005,2210,43921,1212,65538,2311,109459,"California",400434,0.16366742084838,106869,0.455,122488,0.521
"4250","placer",4250,"2021-03-18",4091,177293,2324,94829,1729,80421,38,2043,2864,45602,1220,66758,2901,112360,"California",400434,0.166714115185024,106869,0.455,122488,0.521
"4251","placer",4251,"2021-03-19",3439,180732,2070,96899,1105,81526,264,2307,2196,46825,1236,67994,2459,114819,"California",400434,0.169800766168707,106869,0.455,122488,0.521
"4252","placer",4252,"2021-03-20",2138,182870,897,97796,1144,82670,97,2404,1301,47390,832,68826,1397,116216,"California",400434,0.171878511814681,106869,0.455,122488,0.521
"4253","placer",4253,"2021-03-21",1253,184123,574,98370,670,83340,9,2413,945,48039,305,69131,954,117170,"California",400434,0.172640185398842,106869,0.455,122488,0.521
"4254","placer",4254,"2021-03-22",3269,187392,2103,100473,1077,84417,89,2502,2193,49250,1072,70203,2283,119453,"California",400434,0.175317280750386,106869,0.455,122488,0.521
"4255","placer",4255,"2021-03-23",3526,190918,2097,102570,1338,85755,91,2593,2522,50865,999,71202,2614,122067,"California",400434,0.177812073899819,106869,0.455,122488,0.521
"4256","placer",4256,"2021-03-24",3788,194706,1998,104568,1693,87448,97,2690,1952,51100,1814,73016,2049,124116,"California",400434,0.182342158757748,106869,0.455,122488,0.521
"4257","placer",4257,"2021-03-25",3852,198558,1864,106432,1891,89339,97,2787,1785,50924,2057,75073,1881,125997,"California",400434,0.187479085192566,106869,0.455,122488,0.521
"4258","placer",4258,"2021-03-26",3761,202319,1663,108095,1866,91205,232,3019,1584,50576,2164,77237,1816,127813,"California",400434,0.192883221704451,106869,0.455,122488,0.521
"4259","placer",4259,"2021-03-27",1592,203911,467,108562,1105,92310,20,3039,647,50305,938,78175,667,128480,"California",400434,0.195225680137051,106869,0.455,122488,0.521
"4260","placer",4260,"2021-03-28",1107,205018,527,109089,570,92880,10,3049,374,49961,728,78903,384,128864,"California",400434,0.197043707577279,106869,0.455,122488,0.521
"4261","placer",4261,"2021-03-29",3559,208577,1988,111077,1537,94417,34,3083,1726,49898,1824,80727,1761,130625,"California",400434,0.201598765339607,106869,0.455,122488,0.521
"4262","placer",4262,"2021-03-30",3974,212551,2100,113177,1831,96248,43,3126,2091,50162,1869,82596,2133,132758,"California",400434,0.206266201171729,106869,0.455,122488,0.521
"4263","placer",4263,"2021-03-31",4093,216644,1830,115007,2188,98436,75,3201,1693,49536,2393,84989,1767,134525,"California",400434,0.212242217194344,106869,0.455,122488,0.521
"4264","placer",4264,"2021-04-01",2967,219611,1429,116436,1492,99928,46,3247,1655,49926,1311,86300,1701,136226,"California",400434,0.215516164961017,106869,0.455,122488,0.521
"4265","placer",4265,"2021-04-02",2837,222448,1449,117885,1324,101252,64,3311,1588,50336,1242,87542,1652,137878,"California",400434,0.218617799687339,106869,0.455,122488,0.521
"4266","placer",4266,"2021-04-03",1852,224300,984,118869,740,101992,128,3439,889,50397,956,88498,1017,138895,"California",400434,0.221005209347858,106869,0.455,122488,0.521
"4267","placer",4267,"2021-04-04",710,225010,361,119230,296,102288,53,3492,286,50315,421,88919,339,139234,"California",400434,0.222056568623044,106869,0.455,122488,0.521
"4268","placer",4268,"2021-04-05",2994,228004,1896,121126,914,103202,184,3676,1742,50993,1248,90167,1926,141160,"California",400434,0.225173187092005,106869,0.455,122488,0.521
"4269","placer",4269,"2021-04-06",4277,232281,2469,123595,1509,104711,299,3975,1523,50066,2749,92916,1822,142982,"California",400434,0.232038238511215,106869,0.455,122488,0.521
"4270","placer",4270,"2021-04-07",4505,236786,2570,126165,1474,106185,461,4436,2060,50144,2440,95356,2518,145500,"California",400434,0.238131627184505,106869,0.455,122488,0.521
"4271","placer",4271,"2021-04-08",4688,241474,2592,128757,1550,107735,546,4982,1569,49151,3108,98464,2115,147615,"California",400434,0.245893205871629,106869,0.455,122488,0.521
"4272","placer",4272,"2021-04-09",4101,245575,2263,131020,1220,108955,618,5600,1223,48124,2870,101334,1843,149458,"California",400434,0.253060429434064,106869,0.455,122488,0.521
"4273","placer",4273,"2021-04-10",2007,247582,876,131896,949,109904,182,5782,853,48007,1151,102485,1034,150492,"California",400434,0.255934810730358,106869,0.455,122488,0.521
"4274","placer",4274,"2021-04-11",1353,248935,532,132428,788,110692,33,5815,455,47600,894,103379,487,150979,"California",400434,0.258167388383604,106869,0.455,122488,0.521
"4275","placer",4275,"2021-04-12",4104,253039,2654,135082,1070,111762,380,6195,2466,48818,1627,105006,2845,153824,"California",400434,0.262230479929277,106869,0.455,122488,0.521
"4276","placer",4276,"2021-04-13",4339,257378,2989,138071,1349,113111,1,6196,2184,48853,2150,107156,2185,156009,"California",400434,0.267599654375003,106869,0.455,122488,0.521
"4277","placer",4277,"2021-04-14",4121,261499,2561,140632,1559,114670,1,6197,1847,48435,2265,109421,1847,157856,"California",400434,0.273256017221315,106869,0.455,122488,0.521
"4278","placer",4278,"2021-04-15",4497,265996,2511,143143,1985,116655,1,6198,2353,48656,2133,111554,2354,160210,"California",400434,0.278582737729563,106869,0.455,122488,0.521
"4279","placer",4279,"2021-04-16",3679,269675,2189,145332,1490,118145,0,6198,1438,47859,2235,113789,1438,161648,"California",400434,0.284164181862679,106869,0.455,122488,0.521
"4280","placer",4280,"2021-04-17",2412,272087,836,146168,1576,119721,0,6198,1511,48472,898,114687,1511,163159,"California",400434,0.286406748677685,106869,0.455,122488,0.521
"4281","placer",4281,"2021-04-18",1178,273265,254,146422,924,120645,0,6198,410,48116,766,115453,410,163569,"California",400434,0.288319673154627,106869,0.455,122488,0.521
"4282","placer",4282,"2021-04-19",2920,276185,1790,148212,1130,121775,0,6198,1157,47514,1760,117213,1158,164727,"California",400434,0.292714904328803,106869,0.455,122488,0.521
"4283","placer",4283,"2021-04-20",3771,279956,2448,150660,1323,123098,0,6198,2399,48549,1364,118577,2399,167126,"California",400434,0.29612120848879,106869,0.455,122488,0.521
"4284","placer",4284,"2021-04-21",3650,283606,2392,153052,1257,124355,1,6199,2378,49660,1268,119845,2379,169505,"California",400434,0.299287772766548,106869,0.455,122488,0.521
"4285","placer",4285,"2021-04-22",3652,287258,2257,155309,1395,125750,0,6199,1742,49495,1907,121752,1742,171247,"California",400434,0.304050105635386,106869,0.455,122488,0.521
"4286","placer",4286,"2021-04-23",3495,290753,2319,157628,1175,126925,1,6200,1370,48747,2119,123871,1371,172618,"California",400434,0.309341864077476,106869,0.455,122488,0.521
"4287","placer",4287,"2021-04-24",2071,292824,1254,158882,816,127741,1,6201,1210,49104,853,124724,1210,173828,"California",400434,0.311472052822687,106869,0.455,122488,0.521
"4288","placer",4288,"2021-04-25",900,293724,497,159379,403,128144,0,6201,556,49316,344,125068,556,174384,"California",400434,0.312331120734004,106869,0.455,122488,0.521
"4289","placer",4289,"2021-04-26",2200,295924,1205,160584,972,129116,23,6224,1097,49342,1093,126161,1119,175503,"California",400434,0.315060659184784,106869,0.455,122488,0.521
"4290","placer",4290,"2021-04-27",2492,298416,1310,161894,1147,130263,35,6259,1472,49836,1014,127175,1508,177011,"California",400434,0.317592911690815,106869,0.455,122488,0.521
"4291","placer",4291,"2021-04-28",2911,301327,1803,163697,1071,131334,37,6296,1519,50010,1382,128557,1556,178567,"California",400434,0.32104416707872,106869,0.455,122488,0.521
"4292","placer",4292,"2021-04-29",3259,304586,2074,165771,1133,132467,52,6348,1318,49445,1935,130492,1370,179937,"California",400434,0.325876424079873,106869,0.455,122488,0.521
"4293","placer",4293,"2021-04-30",2984,307570,1808,167579,1129,133596,47,6395,1193,48900,1785,132277,1240,181177,"California",400434,0.330334087515046,106869,0.455,122488,0.521
"4294","placer",4294,"2021-05-01",1327,308897,931,168510,372,133968,24,6419,606,48814,715,132992,629,181806,"California",400434,0.332119650179555,106869,0.455,122488,0.521
"4295","placer",4295,"2021-05-02",715,309612,553,169063,141,134109,21,6440,333,48788,380,133372,354,182160,"California",400434,0.333068620546707,106869,0.455,122488,0.521
"4296","placer",4296,"2021-05-03",1611,311223,998,170061,550,134659,63,6503,444,48131,1163,134535,506,182666,"California",400434,0.335972969328279,106869,0.455,122488,0.521
"4297","placer",4297,"2021-05-04",2281,313504,1291,171352,827,135486,163,6666,857,47730,1421,135956,1020,183686,"California",400434,0.339521619043338,106869,0.455,122488,0.521
"4298","placer",4298,"2021-05-05",3635,317139,2466,173818,1068,136554,101,6767,947,46094,2684,138640,1048,184734,"California",400434,0.346224346583956,106869,0.455,122488,0.521
"4299","placer",4299,"2021-05-06",3060,320199,1889,175707,1101,137655,70,6837,787,44702,2249,140889,857,185591,"California",400434,0.35184075278323,106869,0.455,122488,0.521
"4300","placer",4300,"2021-05-07",2760,322959,1873,177580,797,138452,90,6927,745,43533,2003,142892,834,186425,"California",400434,0.356842825534295,106869,0.455,122488,0.521
"4301","placer",4301,"2021-05-08",1308,324267,702,178282,571,139023,35,6962,391,43043,916,143808,426,186851,"California",400434,0.359130343577219,106869,0.455,122488,0.521
"4302","plumas",4302,"2020-12-18",4,4,4,4,0,0,0,0,4,4,0,0,4,4,"California",18997,0,4561,0.405,6445,0.573
"4303","plumas",4303,"2020-12-19",1,5,1,5,0,0,0,0,1,5,0,0,1,5,"California",18997,0,4561,0.405,6445,0.573
"4304","plumas",4304,"2020-12-21",45,50,45,50,0,0,0,0,45,50,0,0,45,50,"California",18997,0,4561,0.405,6445,0.573
"4305","plumas",4305,"2020-12-22",92,142,92,142,0,0,0,0,92,142,0,0,92,142,"California",18997,0,4561,0.405,6445,0.573
"4306","plumas",4306,"2020-12-23",50,192,50,192,0,0,0,0,50,192,0,0,50,192,"California",18997,0,4561,0.405,6445,0.573
"4307","plumas",4307,"2020-12-24",6,198,6,198,0,0,0,0,6,198,0,0,6,198,"California",18997,0,4561,0.405,6445,0.573
"4308","plumas",4308,"2020-12-28",8,206,0,198,8,8,0,0,8,206,0,0,8,206,"California",18997,0,4561,0.405,6445,0.573
"4309","plumas",4309,"2020-12-29",32,238,22,220,10,18,0,0,32,238,0,0,32,238,"California",18997,0,4561,0.405,6445,0.573
"4310","plumas",4310,"2020-12-30",22,260,1,221,21,39,0,0,22,260,0,0,22,260,"California",18997,0,4561,0.405,6445,0.573
"4311","plumas",4311,"2020-12-31",4,264,1,222,3,42,0,0,4,264,0,0,4,264,"California",18997,0,4561,0.405,6445,0.573
"4312","plumas",4312,"2021-01-04",10,274,4,226,6,48,0,0,10,274,0,0,10,274,"California",18997,0,4561,0.405,6445,0.573
"4313","plumas",4313,"2021-01-05",22,296,2,228,20,68,0,0,22,296,0,0,22,296,"California",18997,0,4561,0.405,6445,0.573
"4314","plumas",4314,"2021-01-06",124,420,5,233,119,187,0,0,124,420,0,0,124,420,"California",18997,0,4561,0.405,6445,0.573
"4315","plumas",4315,"2021-01-07",53,473,2,235,51,238,0,0,52,471,1,1,52,472,"California",18997,5.26398905090277e-05,4561,0.405,6445,0.573
"4316","plumas",4316,"2021-01-08",12,485,5,240,7,245,0,0,8,475,4,5,8,480,"California",18997,0.000263199452545139,4561,0.405,6445,0.573
"4317","plumas",4317,"2021-01-09",2,487,2,242,0,245,0,0,1,475,1,6,1,481,"California",18997,0.000315839343054166,4561,0.405,6445,0.573
"4318","plumas",4318,"2021-01-11",59,546,50,292,9,254,0,0,12,440,47,53,12,493,"California",18997,0.00278991419697847,4561,0.405,6445,0.573
"4319","plumas",4319,"2021-01-12",155,701,86,378,69,323,0,0,71,427,84,137,71,564,"California",18997,0.0072116649997368,4561,0.405,6445,0.573
"4320","plumas",4320,"2021-01-13",56,757,50,428,6,329,0,0,10,391,46,183,10,574,"California",18997,0.00963309996315208,4561,0.405,6445,0.573
"4321","plumas",4321,"2021-01-14",96,853,14,442,82,411,0,0,91,477,5,188,91,665,"California",18997,0.00989629941569722,4561,0.405,6445,0.573
"4322","plumas",4322,"2021-01-15",62,915,7,449,55,466,0,0,60,535,2,190,60,725,"California",18997,0.0100015791967153,4561,0.405,6445,0.573
"4323","plumas",4323,"2021-01-16",58,973,1,450,57,523,0,0,58,593,0,190,58,783,"California",18997,0.0100015791967153,4561,0.405,6445,0.573
"4324","plumas",4324,"2021-01-18",2,975,1,451,1,524,0,0,2,595,0,190,2,785,"California",18997,0.0100015791967153,4561,0.405,6445,0.573
"4325","plumas",4325,"2021-01-19",36,1011,5,456,31,555,0,0,32,623,4,194,32,817,"California",18997,0.0102121387587514,4561,0.405,6445,0.573
"4326","plumas",4326,"2021-01-20",121,1132,3,459,118,673,0,0,119,740,2,196,119,936,"California",18997,0.0103174185397694,4561,0.405,6445,0.573
"4327","plumas",4327,"2021-01-21",112,1244,2,461,110,783,0,0,112,852,0,196,112,1048,"California",18997,0.0103174185397694,4561,0.405,6445,0.573
"4328","plumas",4328,"2021-01-22",5,1249,1,462,4,787,0,0,5,857,0,196,5,1053,"California",18997,0.0103174185397694,4561,0.405,6445,0.573
"4329","plumas",4329,"2021-01-23",93,1342,2,464,91,878,0,0,93,950,0,196,93,1146,"California",18997,0.0103174185397694,4561,0.405,6445,0.573
"4330","plumas",4330,"2021-01-24",1,1343,1,465,0,878,0,0,1,951,0,196,1,1147,"California",18997,0.0103174185397694,4561,0.405,6445,0.573
"4331","plumas",4331,"2021-01-25",10,1353,7,472,3,881,0,0,7,955,3,199,7,1154,"California",18997,0.0104753382112965,4561,0.405,6445,0.573
"4332","plumas",4332,"2021-01-26",60,1413,2,474,58,939,0,0,52,999,8,207,52,1206,"California",18997,0.0108964573353687,4561,0.405,6445,0.573
"4333","plumas",4333,"2021-01-27",25,1438,20,494,5,944,0,0,5,984,20,227,5,1211,"California",18997,0.0119492551455493,4561,0.405,6445,0.573
"4334","plumas",4334,"2021-01-28",23,1461,0,494,23,967,0,0,21,1003,2,229,21,1232,"California",18997,0.0120545349265674,4561,0.405,6445,0.573
"4335","plumas",4335,"2021-01-29",8,1469,2,496,6,973,0,0,7,1009,1,230,7,1239,"California",18997,0.0121071748170764,4561,0.405,6445,0.573
"4336","plumas",4336,"2021-01-30",8,1477,4,500,4,977,0,0,7,1015,1,231,7,1246,"California",18997,0.0121598147075854,4561,0.405,6445,0.573
"4337","plumas",4337,"2021-01-31",3,1480,3,503,0,977,0,0,3,1018,0,231,3,1249,"California",18997,0.0121598147075854,4561,0.405,6445,0.573
"4338","plumas",4338,"2021-02-01",15,1495,2,505,13,990,0,0,7,1017,8,239,7,1256,"California",18997,0.0125809338316576,4561,0.405,6445,0.573
"4339","plumas",4339,"2021-02-02",21,1516,2,507,19,1009,0,0,2,1000,19,258,2,1258,"California",18997,0.0135810917513292,4561,0.405,6445,0.573
"4340","plumas",4340,"2021-02-03",128,1644,8,515,120,1129,0,0,13,899,114,372,13,1271,"California",18997,0.0195820392693583,4561,0.405,6445,0.573
"4341","plumas",4341,"2021-02-04",101,1745,8,523,93,1222,0,0,23,844,78,450,23,1294,"California",18997,0.0236879507290625,4561,0.405,6445,0.573
"4342","plumas",4342,"2021-02-05",24,1769,11,534,13,1235,0,0,9,838,15,465,9,1303,"California",18997,0.0244775490866979,4561,0.405,6445,0.573
"4343","plumas",4343,"2021-02-06",7,1776,0,534,7,1242,0,0,7,845,0,465,7,1310,"California",18997,0.0244775490866979,4561,0.405,6445,0.573
"4344","plumas",4344,"2021-02-08",16,1792,7,541,9,1251,0,0,4,837,12,477,4,1314,"California",18997,0.0251092277728062,4561,0.405,6445,0.573
"4345","plumas",4345,"2021-02-09",171,1963,1,542,170,1421,0,0,111,888,60,537,111,1425,"California",18997,0.0282676212033479,4561,0.405,6445,0.573
"4346","plumas",4346,"2021-02-10",89,2052,9,551,80,1501,0,0,80,960,9,546,81,1506,"California",18997,0.0287413802179291,4561,0.405,6445,0.573
"4347","plumas",4347,"2021-02-11",322,2374,7,558,315,1816,0,0,263,1164,59,605,263,1769,"California",18997,0.0318471337579618,4561,0.405,6445,0.573
"4348","plumas",4348,"2021-02-12",123,2497,4,562,119,1935,0,0,118,1277,5,610,118,1887,"California",18997,0.0321103332105069,4561,0.405,6445,0.573
"4349","plumas",4349,"2021-02-13",74,2571,5,567,69,2004,0,0,14,1231,60,670,14,1901,"California",18997,0.0352687266410486,4561,0.405,6445,0.573
"4350","plumas",4350,"2021-02-14",8,2579,5,572,3,2007,0,0,8,1239,0,670,8,1909,"California",18997,0.0352687266410486,4561,0.405,6445,0.573
"4351","plumas",4351,"2021-02-15",27,2606,5,577,22,2029,0,0,24,1260,3,673,24,1933,"California",18997,0.0354266463125757,4561,0.405,6445,0.573
"4352","plumas",4352,"2021-02-16",76,2682,4,581,72,2101,0,0,14,1212,62,735,14,1947,"California",18997,0.0386903195241354,4561,0.405,6445,0.573
"4353","plumas",4353,"2021-02-17",136,2818,5,586,131,2232,0,0,12,1100,124,859,12,1959,"California",18997,0.0452176659472548,4561,0.405,6445,0.573
"4354","plumas",4354,"2021-02-18",128,2946,6,592,122,2354,0,0,19,1011,109,968,20,1979,"California",18997,0.0509554140127389,4561,0.405,6445,0.573
"4355","plumas",4355,"2021-02-19",41,2987,4,596,37,2391,0,0,6,982,35,1003,6,1985,"California",18997,0.0527978101805548,4561,0.405,6445,0.573
"4356","plumas",4356,"2021-02-20",104,3091,7,603,97,2488,0,0,12,902,92,1095,12,1997,"California",18997,0.0576406801073854,4561,0.405,6445,0.573
"4357","plumas",4357,"2021-02-21",5,3096,5,608,0,2488,0,0,1,899,4,1099,1,1998,"California",18997,0.0578512396694215,4561,0.405,6445,0.573
"4358","plumas",4358,"2021-02-22",3,3099,1,609,2,2490,0,0,0,896,3,1102,0,1998,"California",18997,0.0580091593409486,4561,0.405,6445,0.573
"4359","plumas",4359,"2021-02-23",25,3124,5,614,20,2510,0,0,17,905,8,1110,17,2015,"California",18997,0.0584302784650208,4561,0.405,6445,0.573
"4360","plumas",4360,"2021-02-24",457,3581,7,621,450,2960,0,0,444,1336,13,1123,444,2459,"California",18997,0.0591145970416382,4561,0.405,6445,0.573
"4361","plumas",4361,"2021-02-25",229,3810,10,631,219,3179,0,0,168,1443,61,1184,168,2627,"California",18997,0.0623256303626888,4561,0.405,6445,0.573
"4362","plumas",4362,"2021-02-26",267,4077,8,639,259,3438,0,0,259,1695,8,1192,260,2887,"California",18997,0.0627467494867611,4561,0.405,6445,0.573
"4363","plumas",4363,"2021-02-27",40,4117,4,643,36,3474,0,0,33,1721,7,1199,33,2920,"California",18997,0.0631152287203243,4561,0.405,6445,0.573
"4364","plumas",4364,"2021-02-28",1,4118,0,643,1,3475,0,0,1,1722,0,1199,1,2921,"California",18997,0.0631152287203243,4561,0.405,6445,0.573
"4365","plumas",4365,"2021-03-01",13,4131,3,646,10,3485,0,0,8,1726,4,1203,8,2929,"California",18997,0.0633257882823604,4561,0.405,6445,0.573
"4366","plumas",4366,"2021-03-02",8,4139,0,646,8,3493,0,0,6,1730,2,1205,6,2935,"California",18997,0.0634310680633784,4561,0.405,6445,0.573
"4367","plumas",4367,"2021-03-03",152,4291,10,656,142,3635,0,0,136,1850,16,1221,136,3071,"California",18997,0.0642733063115229,4561,0.405,6445,0.573
"4368","plumas",4368,"2021-03-04",251,4542,9,665,242,3877,0,0,229,2057,22,1243,229,3300,"California",18997,0.0654313839027215,4561,0.405,6445,0.573
"4369","plumas",4369,"2021-03-05",399,4941,7,672,387,4264,5,5,388,2439,11,1254,393,3693,"California",18997,0.0660104226983208,4561,0.405,6445,0.573
"4370","plumas",4370,"2021-03-06",19,4960,2,674,9,4273,8,13,3,2434,16,1270,11,3704,"California",18997,0.0668526609464652,4561,0.405,6445,0.573
"4371","plumas",4371,"2021-03-07",13,4973,2,676,2,4275,9,22,3,2436,10,1280,12,3716,"California",18997,0.0673790598515555,4561,0.405,6445,0.573
"4372","plumas",4372,"2021-03-08",29,5002,3,679,2,4277,24,46,3,2437,26,1306,27,3743,"California",18997,0.0687476970047902,4561,0.405,6445,0.573
"4373","plumas",4373,"2021-03-09",133,5135,2,681,116,4393,15,61,18,2355,115,1421,33,3776,"California",18997,0.0748012844133284,4561,0.405,6445,0.573
"4374","plumas",4374,"2021-03-10",255,5390,3,684,238,4631,14,75,108,2331,146,1567,122,3898,"California",18997,0.0824867084276465,4561,0.405,6445,0.573
"4375","plumas",4375,"2021-03-11",182,5572,8,692,169,4800,5,80,147,2448,35,1602,152,4050,"California",18997,0.0843291045954624,4561,0.405,6445,0.573
"4376","plumas",4376,"2021-03-12",595,6167,3,695,304,5104,288,368,23,2187,572,2174,311,4361,"California",18997,0.114439121966626,4561,0.405,6445,0.573
"4377","plumas",4377,"2021-03-13",25,6192,4,699,10,5114,11,379,5,2183,20,2194,16,4377,"California",18997,0.115491919776807,4561,0.405,6445,0.573
"4378","plumas",4378,"2021-03-14",12,6204,3,702,4,5118,5,384,1,2179,10,2204,6,4383,"California",18997,0.116018318681897,4561,0.405,6445,0.573
"4379","plumas",4379,"2021-03-15",32,6236,1,703,24,5142,7,391,6,2166,26,2230,13,4396,"California",18997,0.117386955835132,4561,0.405,6445,0.573
"4380","plumas",4380,"2021-03-16",60,6296,3,706,56,5198,1,392,49,2205,11,2241,50,4446,"California",18997,0.117965994630731,4561,0.405,6445,0.573
"4381","plumas",4381,"2021-03-17",73,6369,9,715,63,5261,1,393,58,2250,14,2255,59,4505,"California",18997,0.118702953097858,4561,0.405,6445,0.573
"4382","plumas",4382,"2021-03-18",60,6429,6,721,38,5299,16,409,12,2230,48,2303,28,4533,"California",18997,0.121229667842291,4561,0.405,6445,0.573
"4383","plumas",4383,"2021-03-19",164,6593,6,727,156,5455,2,411,155,2381,7,2310,158,4691,"California",18997,0.121598147075854,4561,0.405,6445,0.573
"4384","plumas",4384,"2021-03-20",693,7286,4,731,688,6143,1,412,673,3037,18,2328,674,5365,"California",18997,0.122545665105017,4561,0.405,6445,0.573
"4385","plumas",4385,"2021-03-21",2,7288,1,732,1,6144,0,412,1,3038,0,2328,1,5366,"California",18997,0.122545665105017,4561,0.405,6445,0.573
"4386","plumas",4386,"2021-03-22",183,7471,2,734,181,6325,0,412,176,3207,7,2335,176,5542,"California",18997,0.12291414433858,4561,0.405,6445,0.573
"4387","plumas",4387,"2021-03-23",27,7498,2,736,25,6350,0,412,13,3206,14,2349,13,5555,"California",18997,0.123651102805706,4561,0.405,6445,0.573
"4388","plumas",4388,"2021-03-24",654,8152,7,743,646,6996,1,413,223,3000,430,2779,224,5779,"California",18997,0.146286255724588,4561,0.405,6445,0.573
"4389","plumas",4389,"2021-03-25",299,8451,7,750,290,7286,2,415,157,3015,142,2921,157,5936,"California",18997,0.15376112017687,4561,0.405,6445,0.573
"4390","plumas",4390,"2021-03-26",315,8766,9,759,306,7592,0,415,46,2793,268,3189,46,5982,"California",18997,0.167868610833289,4561,0.405,6445,0.573
"4391","plumas",4391,"2021-03-27",13,8779,1,760,11,7603,1,416,3,2787,10,3199,4,5986,"California",18997,0.16839500973838,4561,0.405,6445,0.573
"4392","plumas",4392,"2021-03-28",5,8784,3,763,1,7604,1,417,3,2789,2,3201,4,5990,"California",18997,0.168500289519398,4561,0.405,6445,0.573
"4393","plumas",4393,"2021-03-29",12,8796,4,767,7,7611,1,418,4,2786,8,3209,5,5995,"California",18997,0.16892140864347,4561,0.405,6445,0.573
"4394","plumas",4394,"2021-03-30",151,8947,3,770,147,7758,1,419,24,2684,127,3336,25,6020,"California",18997,0.175606674738117,4561,0.405,6445,0.573
"4395","plumas",4395,"2021-03-31",289,9236,2,772,286,8044,1,420,268,2933,20,3356,269,6289,"California",18997,0.176659472548297,4561,0.405,6445,0.573
"4396","plumas",4396,"2021-04-01",298,9534,11,783,286,8330,1,421,61,2759,235,3591,61,6350,"California",18997,0.189029846817919,4561,0.405,6445,0.573
"4397","plumas",4397,"2021-04-02",375,9909,5,788,369,8699,1,422,29,2455,334,3925,30,6380,"California",18997,0.206611570247934,4561,0.405,6445,0.573
"4398","plumas",4398,"2021-04-03",16,9925,3,791,5,8704,8,430,4,2455,12,3937,12,6392,"California",18997,0.207243248934042,4561,0.405,6445,0.573
"4399","plumas",4399,"2021-04-04",3,9928,1,792,1,8705,1,431,0,2453,3,3940,1,6393,"California",18997,0.207401168605569,4561,0.405,6445,0.573
"4400","plumas",4400,"2021-04-05",10,9938,3,795,6,8711,1,432,3,2450,7,3947,4,6397,"California",18997,0.207769647839132,4561,0.405,6445,0.573
"4401","plumas",4401,"2021-04-06",120,10058,6,801,88,8799,26,458,13,2382,107,4054,39,6436,"California",18997,0.213402116123598,4561,0.405,6445,0.573
"4402","plumas",4402,"2021-04-07",281,10339,7,808,99,8898,175,633,28,2332,253,4307,203,6639,"California",18997,0.226720008422382,4561,0.405,6445,0.573
"4403","plumas",4403,"2021-04-08",155,10494,3,811,136,9034,16,649,34,2261,120,4427,49,6688,"California",18997,0.233036795283466,4561,0.405,6445,0.573
"4404","plumas",4404,"2021-04-09",50,10544,9,820,25,9059,16,665,19,2264,31,4458,34,6722,"California",18997,0.234668631889246,4561,0.405,6445,0.573
"4405","plumas",4405,"2021-04-10",22,10566,2,822,4,9063,16,681,3,2264,19,4477,19,6741,"California",18997,0.235668789808917,4561,0.405,6445,0.573
"4406","plumas",4406,"2021-04-11",4,10570,3,825,0,9063,1,682,3,2267,1,4478,4,6745,"California",18997,0.235721429699426,4561,0.405,6445,0.573
"4407","plumas",4407,"2021-04-12",11,10581,5,830,3,9066,3,685,7,2273,4,4482,10,6755,"California",18997,0.235931989261462,4561,0.405,6445,0.573
"4408","plumas",4408,"2021-04-13",206,10787,5,835,201,9267,0,685,138,2343,68,4550,138,6893,"California",18997,0.239511501816076,4561,0.405,6445,0.573
"4409","plumas",4409,"2021-04-14",108,10895,8,843,100,9367,0,685,54,2343,54,4604,54,6947,"California",18997,0.242354055903564,4561,0.405,6445,0.573
"4410","plumas",4410,"2021-04-15",50,10945,2,845,48,9415,0,685,32,2357,18,4622,32,6979,"California",18997,0.243301573932726,4561,0.405,6445,0.573
"4411","plumas",4411,"2021-04-16",144,11089,4,849,140,9555,0,685,4,2221,140,4762,4,6983,"California",18997,0.25067115860399,4561,0.405,6445,0.573
"4412","plumas",4412,"2021-04-17",667,11756,2,851,665,10220,0,685,21,1598,644,5406,21,7004,"California",18997,0.284571248091804,4561,0.405,6445,0.573
"4413","plumas",4413,"2021-04-18",4,11760,3,854,1,10221,0,685,1,1596,3,5409,1,7005,"California",18997,0.284729167763331,4561,0.405,6445,0.573
"4414","plumas",4414,"2021-04-19",38,11798,3,857,35,10256,0,685,5,1568,33,5442,5,7010,"California",18997,0.286466284150129,4561,0.405,6445,0.573
"4415","plumas",4415,"2021-04-20",41,11839,4,861,37,10293,0,685,25,1578,15,5457,25,7035,"California",18997,0.287255882507764,4561,0.405,6445,0.573
"4416","plumas",4416,"2021-04-21",312,12151,5,866,306,10599,1,686,18,1302,294,5751,18,7053,"California",18997,0.302732010317419,4561,0.405,6445,0.573
"4417","plumas",4417,"2021-04-22",272,12423,8,874,264,10863,0,686,130,1290,142,5893,130,7183,"California",18997,0.3102068747697,4561,0.405,6445,0.573
"4418","plumas",4418,"2021-04-23",73,12496,6,880,67,10930,0,686,16,1249,57,5950,16,7199,"California",18997,0.313207348528715,4561,0.405,6445,0.573
"4419","plumas",4419,"2021-04-24",171,12667,5,885,166,11096,0,686,146,1371,24,5974,146,7345,"California",18997,0.314470705900932,4561,0.405,6445,0.573
"4420","plumas",4420,"2021-04-26",29,12696,4,889,25,11121,0,686,9,1361,19,5993,9,7354,"California",18997,0.315470863820603,4561,0.405,6445,0.573
"4421","plumas",4421,"2021-04-27",87,12783,3,892,84,11205,0,686,51,1376,36,6029,51,7405,"California",18997,0.317365899878928,4561,0.405,6445,0.573
"4422","plumas",4422,"2021-04-28",283,13066,4,896,279,11484,0,686,37,1167,246,6275,37,7442,"California",18997,0.330315312944149,4561,0.405,6445,0.573
"4423","plumas",4423,"2021-04-29",172,13238,69,965,103,11587,0,686,118,1232,53,6328,118,7560,"California",18997,0.333105227141128,4561,0.405,6445,0.573
"4424","plumas",4424,"2021-04-30",23,13261,11,976,12,11599,0,686,7,1223,16,6344,7,7567,"California",18997,0.333947465389272,4561,0.405,6445,0.573
"4425","plumas",4425,"2021-05-01",2,13263,1,977,0,11599,1,687,0,1222,2,6346,1,7568,"California",18997,0.33405274517029,4561,0.405,6445,0.573
"4426","plumas",4426,"2021-05-02",3,13266,3,980,0,11599,0,687,1,1221,2,6348,1,7569,"California",18997,0.334158024951308,4561,0.405,6445,0.573
"4427","plumas",4427,"2021-05-03",18,13284,8,988,4,11603,6,693,7,1223,11,6359,13,7582,"California",18997,0.334737063746907,4561,0.405,6445,0.573
"4428","plumas",4428,"2021-05-04",28,13312,3,991,19,11622,6,699,17,1235,11,6370,23,7605,"California",18997,0.335316102542507,4561,0.405,6445,0.573
"4429","plumas",4429,"2021-05-05",44,13356,6,997,37,11659,1,700,17,1226,27,6397,18,7623,"California",18997,0.33673737958625,4561,0.405,6445,0.573
"4430","plumas",4430,"2021-05-06",53,13409,3,1000,45,11704,5,705,13,1205,39,6436,18,7641,"California",18997,0.338790335316103,4561,0.405,6445,0.573
"4431","plumas",4431,"2021-05-07",23,13432,7,1007,16,11720,0,705,7,1196,16,6452,7,7648,"California",18997,0.339632573564247,4561,0.405,6445,0.573
"4432","plumas",4432,"2021-05-08",8,13440,1,1008,4,11724,3,708,4,1200,3,6455,7,7655,"California",18997,0.339790493235774,4561,0.405,6445,0.573
"4433","riverside",4433,"2020-12-15",5,5,5,5,0,0,0,0,5,5,0,0,5,5,"California",2468145,0,528340,0.53,449144,0.45
"4434","riverside",4434,"2020-12-16",64,69,64,69,0,0,0,0,64,69,0,0,64,69,"California",2468145,0,528340,0.53,449144,0.45
"4435","riverside",4435,"2020-12-17",804,873,804,873,0,0,0,0,804,873,0,0,804,873,"California",2468145,0,528340,0.53,449144,0.45
"4436","riverside",4436,"2020-12-18",1723,2596,1722,2595,1,1,0,0,1723,2596,0,0,1723,2596,"California",2468145,0,528340,0.53,449144,0.45
"4437","riverside",4437,"2020-12-19",1026,3622,1023,3618,3,4,0,0,1024,3619,1,1,1024,3620,"California",2468145,4.05162581614938e-07,528340,0.53,449144,0.45
"4438","riverside",4438,"2020-12-20",1083,4705,1082,4700,1,5,0,0,1083,4702,0,1,1083,4703,"California",2468145,4.05162581614938e-07,528340,0.53,449144,0.45
"4439","riverside",4439,"2020-12-21",2273,6978,2271,6971,2,7,0,0,2273,6975,0,1,2273,6976,"California",2468145,4.05162581614938e-07,528340,0.53,449144,0.45
"4440","riverside",4440,"2020-12-22",2256,9234,2217,9188,39,46,0,0,2255,9230,0,1,2255,9231,"California",2468145,4.05162581614938e-07,528340,0.53,449144,0.45
"4441","riverside",4441,"2020-12-23",2129,11363,1792,10980,337,383,0,0,2130,11360,0,1,2130,11361,"California",2468145,4.05162581614938e-07,528340,0.53,449144,0.45
"4442","riverside",4442,"2020-12-24",828,12191,626,11606,202,585,0,0,828,12188,0,1,828,12189,"California",2468145,4.05162581614938e-07,528340,0.53,449144,0.45
"4443","riverside",4443,"2020-12-25",28,12219,5,11611,23,608,0,0,28,12216,0,1,28,12217,"California",2468145,4.05162581614938e-07,528340,0.53,449144,0.45
"4444","riverside",4444,"2020-12-26",400,12619,257,11868,143,751,0,0,400,12616,0,1,400,12617,"California",2468145,4.05162581614938e-07,528340,0.53,449144,0.45
"4445","riverside",4445,"2020-12-27",361,12980,243,12111,118,869,0,0,361,12977,0,1,361,12978,"California",2468145,4.05162581614938e-07,528340,0.53,449144,0.45
"4446","riverside",4446,"2020-12-28",1626,14606,1126,13237,500,1369,0,0,1626,14603,0,1,1626,14604,"California",2468145,4.05162581614938e-07,528340,0.53,449144,0.45
"4447","riverside",4447,"2020-12-29",1738,16344,972,14209,766,2135,0,0,1738,16341,0,1,1738,16342,"California",2468145,4.05162581614938e-07,528340,0.53,449144,0.45
"4448","riverside",4448,"2020-12-30",2578,18922,1684,15893,894,3029,0,0,2577,18918,0,1,2577,18919,"California",2468145,4.05162581614938e-07,528340,0.53,449144,0.45
"4449","riverside",4449,"2020-12-31",1022,19944,395,16288,627,3656,0,0,1024,19942,0,1,1024,19943,"California",2468145,4.05162581614938e-07,528340,0.53,449144,0.45
"4450","riverside",4450,"2021-01-01",116,20060,45,16333,71,3727,0,0,116,20058,0,1,116,20059,"California",2468145,4.05162581614938e-07,528340,0.53,449144,0.45
"4451","riverside",4451,"2021-01-02",834,20894,694,17027,140,3867,0,0,834,20892,0,1,834,20893,"California",2468145,4.05162581614938e-07,528340,0.53,449144,0.45
"4452","riverside",4452,"2021-01-03",343,21237,298,17325,45,3912,0,0,342,21234,0,1,342,21235,"California",2468145,4.05162581614938e-07,528340,0.53,449144,0.45
"4453","riverside",4453,"2021-01-04",1265,22502,797,18122,468,4380,0,0,1265,22499,0,1,1265,22500,"California",2468145,4.05162581614938e-07,528340,0.53,449144,0.45
"4454","riverside",4454,"2021-01-05",1984,24486,1363,19485,621,5001,0,0,1889,24299,89,90,1889,24389,"California",2468145,3.64646323453444e-05,528340,0.53,449144,0.45
"4455","riverside",4455,"2021-01-06",2496,26982,1112,20597,1384,6385,0,0,2190,26187,302,392,2190,26579,"California",2468145,0.000158823731993056,528340,0.53,449144,0.45
"4456","riverside",4456,"2021-01-07",2766,29748,1813,22410,953,7338,0,0,1705,26838,1056,1448,1707,28286,"California",2468145,0.00058667541817843,528340,0.53,449144,0.45
"4457","riverside",4457,"2021-01-08",4055,33803,2935,25345,1120,8458,0,0,2244,27275,1807,3255,2244,30530,"California",2468145,0.00131880420315662,528340,0.53,449144,0.45
"4458","riverside",4458,"2021-01-09",2070,35873,844,26189,1226,9684,0,0,1723,28652,346,3601,1723,32253,"California",2468145,0.00145899045639539,528340,0.53,449144,0.45
"4459","riverside",4459,"2021-01-10",1667,37540,735,26924,932,10616,0,0,1063,29111,604,4205,1063,33316,"California",2468145,0.00170370865569081,528340,0.53,449144,0.45
"4460","riverside",4460,"2021-01-11",4525,42065,3103,30027,1422,12038,0,0,2790,30169,1733,5938,2791,36107,"California",2468145,0.0024058554096295,528340,0.53,449144,0.45
"4461","riverside",4461,"2021-01-12",3405,45470,2731,32758,674,12712,0,0,1717,30203,1683,7621,1717,37824,"California",2468145,0.00308774403448744,528340,0.53,449144,0.45
"4462","riverside",4462,"2021-01-13",4389,49859,2870,35628,1519,14231,0,0,2784,31385,1602,9223,2784,40608,"California",2468145,0.00373681449023457,528340,0.53,449144,0.45
"4463","riverside",4463,"2021-01-14",5495,55354,1895,37523,3600,17831,0,0,4907,35704,588,9811,4907,45515,"California",2468145,0.00397505008822415,528340,0.53,449144,0.45
"4464","riverside",4464,"2021-01-15",6155,61509,2097,39620,4058,21889,0,0,5867,41284,287,10098,5867,51382,"California",2468145,0.00409133174914764,528340,0.53,449144,0.45
"4465","riverside",4465,"2021-01-16",3608,65117,1017,40637,2591,24480,0,0,3362,44401,246,10344,3363,54745,"California",2468145,0.00419100174422491,528340,0.53,449144,0.45
"4466","riverside",4466,"2021-01-17",3593,68710,582,41219,3011,27491,0,0,3396,47602,195,10539,3396,58141,"California",2468145,0.00427000844763983,528340,0.53,449144,0.45
"4467","riverside",4467,"2021-01-18",3729,72439,2023,43242,1706,29197,0,0,2724,49321,1005,11544,2724,60865,"California",2468145,0.00467719684216284,528340,0.53,449144,0.45
"4468","riverside",4468,"2021-01-19",7409,79848,2643,45885,4766,33963,0,0,6292,54497,1117,12661,6293,67158,"California",2468145,0.00512976344582672,528340,0.53,449144,0.45
"4469","riverside",4469,"2021-01-20",8110,87958,3025,48910,5085,39048,0,0,6536,59474,1563,14224,6540,73698,"California",2468145,0.00576303256089087,528340,0.53,449144,0.45
"4470","riverside",4470,"2021-01-21",8363,96321,3521,52431,4842,43890,0,0,7714,66539,649,14873,7714,81412,"California",2468145,0.00602598307635897,528340,0.53,449144,0.45
"4471","riverside",4471,"2021-01-22",8727,105048,2980,55411,5747,49637,0,0,8297,74409,428,15301,8298,89710,"California",2468145,0.00619939266129016,528340,0.53,449144,0.45
"4472","riverside",4472,"2021-01-23",5925,110973,2393,57804,3532,53169,0,0,5197,78879,728,16029,5198,94908,"California",2468145,0.00649435102070583,528340,0.53,449144,0.45
"4473","riverside",4473,"2021-01-24",3034,114007,1430,59234,1604,54773,0,0,2820,81489,211,16240,2821,97729,"California",2468145,0.00657984032542659,528340,0.53,449144,0.45
"4474","riverside",4474,"2021-01-25",7879,121886,4537,63771,3342,58115,0,0,6753,87118,1125,17365,6754,104483,"California",2468145,0.00703564822974339,528340,0.53,449144,0.45
"4475","riverside",4475,"2021-01-26",9121,131007,5731,69502,3390,61505,0,0,7609,93219,1509,18874,7610,112093,"California",2468145,0.00764703856540033,528340,0.53,449144,0.45
"4476","riverside",4476,"2021-01-27",10906,141913,6387,75889,4519,66024,0,0,9299,100918,1603,20477,9302,121395,"California",2468145,0.00829651418372908,528340,0.53,449144,0.45
"4477","riverside",4477,"2021-01-28",11489,153402,6780,82669,4709,70733,0,0,10329,110096,1152,21629,10330,131725,"California",2468145,0.00876326147774948,528340,0.53,449144,0.45
"4478","riverside",4478,"2021-01-29",11924,165326,7277,89946,4647,75380,0,0,10555,119312,1343,22972,10559,142284,"California",2468145,0.00930739482485834,528340,0.53,449144,0.45
"4479","riverside",4479,"2021-01-30",9049,174375,4605,94551,4444,79824,0,0,8585,127437,461,23433,8586,150870,"California",2468145,0.00949417477498283,528340,0.53,449144,0.45
"4480","riverside",4480,"2021-01-31",5161,179536,4250,98801,911,80735,0,0,5028,132337,132,23565,5032,155902,"California",2468145,0.009547656235756,528340,0.53,449144,0.45
"4481","riverside",4481,"2021-02-01",10873,190409,6714,105515,4159,84894,0,0,9086,139646,1780,25345,9089,164991,"California",2468145,0.0102688456310306,528340,0.53,449144,0.45
"4482","riverside",4482,"2021-02-02",9512,199921,4847,110362,4665,89559,0,0,8017,146178,1488,26833,8020,173011,"California",2468145,0.0108717275524736,528340,0.53,449144,0.45
"4483","riverside",4483,"2021-02-03",12123,212044,5099,115461,7024,96583,0,0,9792,153649,2321,29154,9792,182803,"California",2468145,0.0118121099044019,528340,0.53,449144,0.45
"4484","riverside",4484,"2021-02-04",13550,225594,6043,121504,7507,104090,0,0,11436,162980,2107,31261,11438,194241,"California",2468145,0.0126657874638646,528340,0.53,449144,0.45
"4485","riverside",4485,"2021-02-05",14331,239925,5399,126903,8932,113022,0,0,11278,171217,3045,34306,11282,205523,"California",2468145,0.013899507524882,528340,0.53,449144,0.45
"4486","riverside",4486,"2021-02-06",7261,247186,4288,131191,2973,115995,0,0,5615,175197,1638,35944,5618,211141,"California",2468145,0.0145631638335673,528340,0.53,449144,0.45
"4487","riverside",4487,"2021-02-07",2167,249353,796,131987,1371,117366,0,0,1851,176734,315,36259,1852,212993,"California",2468145,0.014690790046776,528340,0.53,449144,0.45
"4488","riverside",4488,"2021-02-08",12453,261806,5533,137520,6920,124286,0,0,10139,184580,2297,38556,10143,223136,"California",2468145,0.0156214484967455,528340,0.53,449144,0.45
"4489","riverside",4489,"2021-02-09",9669,271475,4547,142067,5122,129408,0,0,7727,190378,1934,40490,7732,230868,"California",2468145,0.0164050329295888,528340,0.53,449144,0.45
"4490","riverside",4490,"2021-02-10",12071,283546,6981,149048,5090,134498,0,0,8897,196121,3162,43652,8905,239773,"California",2468145,0.0176861570126553,528340,0.53,449144,0.45
"4491","riverside",4491,"2021-02-11",16588,300134,9044,158092,7544,142042,0,0,12082,203735,4483,48135,12097,251870,"California",2468145,0.019502500866035,528340,0.53,449144,0.45
"4492","riverside",4492,"2021-02-12",17684,317818,10818,168910,6866,148908,0,0,12812,211732,4827,52962,12824,264694,"California",2468145,0.0214582206474903,528340,0.53,449144,0.45
"4493","riverside",4493,"2021-02-13",6325,324143,2127,171037,4198,153106,0,0,3099,211644,3208,56170,3120,267814,"California",2468145,0.022757982209311,528340,0.53,449144,0.45
"4494","riverside",4494,"2021-02-14",4927,329070,1122,172159,3805,156911,0,0,2175,211072,2748,58918,2176,269990,"California",2468145,0.0238713689835889,528340,0.53,449144,0.45
"4495","riverside",4495,"2021-02-15",9824,338894,4999,177158,4825,161736,0,0,5409,212081,4407,63325,5416,275406,"California",2468145,0.0256569204807659,528340,0.53,449144,0.45
"4496","riverside",4496,"2021-02-16",16107,355001,10104,187262,6003,167739,0,0,9246,214481,6854,70179,9254,284660,"California",2468145,0.0284339048151547,528340,0.53,449144,0.45
"4497","riverside",4497,"2021-02-17",15015,370016,8202,195464,6813,174552,0,0,7443,214375,7559,77738,7453,292113,"California",2468145,0.031496528769582,528340,0.53,449144,0.45
"4498","riverside",4498,"2021-02-18",15529,385545,8992,204456,6537,181089,0,0,8023,214925,7487,85225,8037,300150,"California",2468145,0.0345299810181331,528340,0.53,449144,0.45
"4499","riverside",4499,"2021-02-19",15259,400804,8223,212679,7036,188125,0,0,7210,214113,8030,93255,7218,307368,"California",2468145,0.037783436548501,528340,0.53,449144,0.45
"4500","riverside",4500,"2021-02-20",8312,409116,4497,217176,3815,191940,0,0,2170,210161,6125,99380,2173,309541,"California",2468145,0.0402650573608925,528340,0.53,449144,0.45
"4501","riverside",4501,"2021-02-21",4354,413470,3834,221010,520,192460,0,0,1218,208258,3121,102501,1218,310759,"California",2468145,0.0415295697781127,528340,0.53,449144,0.45
"4502","riverside",4502,"2021-02-22",12356,425826,7761,228771,4595,197055,0,0,5102,206130,7235,109736,5107,315866,"California",2468145,0.0444609210560968,528340,0.53,449144,0.45
"4503","riverside",4503,"2021-02-23",11091,436917,7556,236327,3535,200590,0,0,5389,205850,5673,115409,5393,321259,"California",2468145,0.0467594083815983,528340,0.53,449144,0.45
"4504","riverside",4504,"2021-02-24",14803,451720,8098,244425,6705,207295,0,0,6294,203691,8470,123879,6311,327570,"California",2468145,0.0501911354478768,528340,0.53,449144,0.45
"4505","riverside",4505,"2021-02-25",17329,469049,7385,251810,9944,217239,0,0,8045,202499,9262,133141,8070,335640,"California",2468145,0.0539437512787944,528340,0.53,449144,0.45
"4506","riverside",4506,"2021-02-26",18595,487644,6717,258527,11878,229117,0,0,9287,202569,9250,142391,9320,344960,"California",2468145,0.0576915051587326,528340,0.53,449144,0.45
"4507","riverside",4507,"2021-02-27",12026,499670,5560,264087,6466,235583,0,0,5751,202107,6240,148631,5778,350738,"California",2468145,0.0602197196680098,528340,0.53,449144,0.45
"4508","riverside",4508,"2021-02-28",4888,504558,3222,267309,1666,237249,0,0,2414,202065,2463,151094,2421,353159,"California",2468145,0.0612176351065274,528340,0.53,449144,0.45
"4509","riverside",4509,"2021-03-01",14307,518865,6093,273402,8212,245461,2,2,8429,204679,5844,156938,8458,361617,"California",2468145,0.0635854052334851,528340,0.53,449144,0.45
"4510","riverside",4510,"2021-03-02",15286,534151,7436,280838,7849,253310,1,3,8976,207396,6287,163225,9004,370621,"California",2468145,0.0661326623840982,528340,0.53,449144,0.45
"4511","riverside",4511,"2021-03-03",16858,551009,8343,289181,8515,261825,0,3,7281,205276,9528,172753,7408,378029,"California",2468145,0.0699930514617253,528340,0.53,449144,0.45
"4512","riverside",4512,"2021-03-04",18719,569728,7449,296630,11266,273091,4,7,8892,204540,9782,182535,9046,387075,"California",2468145,0.0739563518350826,528340,0.53,449144,0.45
"4513","riverside",4513,"2021-03-05",18755,588483,7532,304162,11179,284270,44,51,9287,204730,9418,191953,9608,396683,"California",2468145,0.0777721730287321,528340,0.53,449144,0.45
"4514","riverside",4514,"2021-03-06",9451,597934,5016,309178,3953,288223,482,533,4698,205200,4739,196692,5209,401892,"California",2468145,0.0796922385030053,528340,0.53,449144,0.45
"4515","riverside",4515,"2021-03-07",4175,602109,2698,311876,1088,289311,389,922,1961,205350,2204,198896,2354,404246,"California",2468145,0.0805852168328846,528340,0.53,449144,0.45
"4516","riverside",4516,"2021-03-08",11931,614040,4739,316615,6783,296094,409,1331,5311,204515,6601,205497,5766,410012,"California",2468145,0.0832596950341248,528340,0.53,449144,0.45
"4517","riverside",4517,"2021-03-09",14659,628699,6761,323376,7400,303494,498,1829,5788,202082,8853,214350,6420,416432,"California",2468145,0.0868465993691619,528340,0.53,449144,0.45
"4518","riverside",4518,"2021-03-10",15633,644332,8391,331767,6354,309848,888,2717,6015,199559,9578,223928,7055,423487,"California",2468145,0.0907272465758697,528340,0.53,449144,0.45
"4519","riverside",4519,"2021-03-11",19227,663559,9444,341211,7938,317786,1845,4562,7589,197600,11604,235532,9645,433132,"California",2468145,0.0954287531729295,528340,0.53,449144,0.45
"4520","riverside",4520,"2021-03-12",21150,684709,7922,349133,8494,326280,4734,9296,7095,195734,14022,249554,12156,445288,"California",2468145,0.101109942892334,528340,0.53,449144,0.45
"4521","riverside",4521,"2021-03-13",8390,693099,2507,351640,4677,330957,1206,10502,4295,197238,4076,253630,5580,450868,"California",2468145,0.102761385574997,528340,0.53,449144,0.45
"4522","riverside",4522,"2021-03-14",4606,697705,1581,353221,1734,332691,1291,11793,2044,198018,2552,256182,3332,454200,"California",2468145,0.103795360483278,528340,0.53,449144,0.45
"4523","riverside",4523,"2021-03-15",18681,716386,7850,361071,9158,341849,1673,13466,9203,199558,9436,265618,10976,465176,"California",2468145,0.107618474603396,528340,0.53,449144,0.45
"4524","riverside",4524,"2021-03-16",20886,737272,10137,371208,9935,351784,814,14280,11385,202389,9461,275079,12292,477468,"California",2468145,0.111451717788055,528340,0.53,449144,0.45
"4525","riverside",4525,"2021-03-17",21274,758546,10913,382121,9313,361097,1048,15328,12781,207819,8457,283536,13887,491355,"California",2468145,0.114878177740773,528340,0.53,449144,0.45
"4526","riverside",4526,"2021-03-18",22569,781115,11741,393862,9174,370271,1654,16982,12530,212019,9992,293528,14192,505547,"California",2468145,0.118926562256269,528340,0.53,449144,0.45
"4527","riverside",4527,"2021-03-19",24008,805123,12576,406438,10482,380753,950,17932,14036,217449,9917,303445,15347,520894,"California",2468145,0.122944559578145,528340,0.53,449144,0.45
"4528","riverside",4528,"2021-03-20",10596,815719,6837,413275,2594,383347,1165,19097,6827,221701,3740,307185,7992,528886,"California",2468145,0.124459867633385,528340,0.53,449144,0.45
"4529","riverside",4529,"2021-03-21",3679,819398,2873,416148,553,383900,253,19350,2525,223339,1140,308325,2778,531664,"California",2468145,0.124921752976426,528340,0.53,449144,0.45
"4530","riverside",4530,"2021-03-22",16641,836039,9925,426073,6163,390063,553,19903,10604,228504,5989,314314,11154,542818,"California",2468145,0.127348271677717,528340,0.53,449144,0.45
"4531","riverside",4531,"2021-03-23",18548,854587,10498,436571,7628,397691,422,20325,11964,234376,6529,320843,12401,555219,"California",2468145,0.129993578173081,528340,0.53,449144,0.45
"4532","riverside",4532,"2021-03-24",18684,873271,10416,446987,8148,405839,120,20445,12844,241554,5794,326637,12972,568191,"California",2468145,0.132341090170958,528340,0.53,449144,0.45
"4533","riverside",4533,"2021-03-25",21094,894365,11644,458631,9271,415110,179,20624,14168,249049,6859,333496,14354,582545,"California",2468145,0.135120100318255,528340,0.53,449144,0.45
"4534","riverside",4534,"2021-03-26",24080,918445,11890,470521,12017,427127,173,20797,15033,255310,8948,342444,15209,597754,"California",2468145,0.138745495098546,528340,0.53,449144,0.45
"4535","riverside",4535,"2021-03-27",9276,927721,4866,475387,3355,430482,1055,21852,4806,256722,4450,346894,5862,603616,"California",2468145,0.140548468586732,528340,0.53,449144,0.45
"4536","riverside",4536,"2021-03-28",4719,932440,3102,478489,1525,432007,92,21944,2832,257773,1874,348768,2925,606541,"California",2468145,0.141307743264679,528340,0.53,449144,0.45
"4537","riverside",4537,"2021-03-29",17622,950062,8437,486926,9069,441076,116,22060,10959,262233,6626,355394,11086,617627,"California",2468145,0.143992350530459,528340,0.53,449144,0.45
"4538","riverside",4538,"2021-03-30",18318,968380,9540,496466,8574,449650,204,22264,11803,267765,6477,361871,12009,629636,"California",2468145,0.146616588571579,528340,0.53,449144,0.45
"4539","riverside",4539,"2021-03-31",18032,986412,8387,504853,9344,458994,301,22565,11478,273043,6512,368383,11790,641426,"California",2468145,0.149255007303056,528340,0.53,449144,0.45
"4540","riverside",4540,"2021-04-01",25375,1011787,12396,517249,12221,471215,758,23323,16413,281308,8904,377287,17169,658595,"California",2468145,0.152862574929755,528340,0.53,449144,0.45
"4541","riverside",4541,"2021-04-02",26017,1037804,14019,531268,11059,482274,939,24262,16351,289210,9614,386901,17516,676111,"California",2468145,0.156757807989401,528340,0.53,449144,0.45
"4542","riverside",4542,"2021-04-03",9266,1047070,5897,537165,2792,485066,577,24839,6006,292551,3242,390143,6583,682694,"California",2468145,0.158071345078997,528340,0.53,449144,0.45
"4543","riverside",4543,"2021-04-04",3370,1050440,2046,539211,1086,486152,238,25077,1751,292930,1611,391754,1990,684684,"California",2468145,0.158724061997978,528340,0.53,449144,0.45
"4544","riverside",4544,"2021-04-05",18359,1068799,9414,548625,7108,493260,1837,26914,9896,296239,8426,400180,11735,696419,"California",2468145,0.162137961910666,528340,0.53,449144,0.45
"4545","riverside",4545,"2021-04-06",23684,1092483,12314,560939,9257,502517,2113,29027,13202,301117,10431,410611,15309,711728,"California",2468145,0.166364212799491,528340,0.53,449144,0.45
"4546","riverside",4546,"2021-04-07",24523,1117006,13180,574119,8863,511380,2480,31507,13658,306435,10822,421433,16140,727868,"California",2468145,0.170748882257728,528340,0.53,449144,0.45
"4547","riverside",4547,"2021-04-08",26927,1143933,14785,588904,9204,520584,2938,34445,16405,315298,10462,431895,19325,747193,"California",2468145,0.174987693186583,528340,0.53,449144,0.45
"4548","riverside",4548,"2021-04-09",26018,1169951,15281,604185,8319,528903,2418,36863,15902,323563,10073,441968,18338,765531,"California",2468145,0.179068895871191,528340,0.53,449144,0.45
"4549","riverside",4549,"2021-04-10",11920,1181871,6703,610888,3830,532733,1387,38250,5225,323517,6653,448621,6607,772138,"California",2468145,0.181764442526675,528340,0.53,449144,0.45
"4550","riverside",4550,"2021-04-11",4583,1186454,2728,613616,1243,533976,612,38862,2172,323900,2400,451021,2783,774921,"California",2468145,0.182736832722551,528340,0.53,449144,0.45
"4551","riverside",4551,"2021-04-12",20052,1206506,8910,622526,8515,542491,2627,41489,10075,326663,9937,460958,12700,787621,"California",2468145,0.186762933296058,528340,0.53,449144,0.45
"4552","riverside",4552,"2021-04-13",19891,1226397,11142,633668,8723,551214,26,41515,11367,329576,8482,469440,11395,799016,"California",2468145,0.190199522313316,528340,0.53,449144,0.45
"4553","riverside",4553,"2021-04-14",22006,1248403,12097,645765,9895,561109,14,41529,10789,329229,11153,480593,10806,809822,"California",2468145,0.194718300586068,528340,0.53,449144,0.45
"4554","riverside",4554,"2021-04-15",21648,1270051,12160,657925,9480,570589,8,41537,11343,330343,10238,490831,11352,821174,"California",2468145,0.198866355096641,528340,0.53,449144,0.45
"4555","riverside",4555,"2021-04-16",24920,1294971,14426,672351,10488,581077,6,41543,11613,328713,13256,504087,11626,832800,"California",2468145,0.204237190278529,528340,0.53,449144,0.45
"4556","riverside",4556,"2021-04-17",9843,1304814,6486,678837,3357,584434,0,41543,4977,328846,4851,508938,4984,837784,"California",2468145,0.206202633961943,528340,0.53,449144,0.45
"4557","riverside",4557,"2021-04-18",3857,1308671,2813,681650,1037,585471,7,41550,1841,328691,2005,510943,1850,839634,"California",2468145,0.207014984938081,528340,0.53,449144,0.45
"4558","riverside",4558,"2021-04-19",19436,1328107,11561,693211,7872,593343,3,41553,6957,323217,12439,523382,6965,846599,"California",2468145,0.212054802290789,528340,0.53,449144,0.45
"4559","riverside",4559,"2021-04-20",18773,1346880,9877,703088,8887,602230,9,41562,7685,319864,11051,534433,7698,854297,"California",2468145,0.216532253980216,528340,0.53,449144,0.45
"4560","riverside",4560,"2021-04-21",19446,1366326,11080,714168,8358,610588,8,41570,7663,315818,11724,546157,7678,861975,"California",2468145,0.221282380087069,528340,0.53,449144,0.45
"4561","riverside",4561,"2021-04-22",23073,1389399,13425,727593,9645,620233,3,41573,8572,309961,14437,560594,8580,870555,"California",2468145,0.227131712277844,528340,0.53,449144,0.45
"4562","riverside",4562,"2021-04-23",23249,1412648,13693,741286,9542,629775,14,41587,9148,305084,14047,574641,9170,879725,"California",2468145,0.232823031061789,528340,0.53,449144,0.45
"4563","riverside",4563,"2021-04-24",10469,1423117,7315,748601,3152,632927,2,41589,4855,304363,5579,580220,4858,884583,"California",2468145,0.235083433104619,528340,0.53,449144,0.45
"4564","riverside",4564,"2021-04-25",4208,1427325,2821,751422,1387,634314,0,41589,2200,304569,1995,582215,2201,886784,"California",2468145,0.235891732454941,528340,0.53,449144,0.45
"4565","riverside",4565,"2021-04-26",15946,1443271,9979,761401,5922,640236,45,41634,5326,299355,10588,592803,5374,892158,"California",2468145,0.24018159386908,528340,0.53,449144,0.45
"4566","riverside",4566,"2021-04-27",17144,1460415,9707,771108,7276,647512,161,41795,5898,294211,11203,604006,6059,898217,"California",2468145,0.244720630270912,528340,0.53,449144,0.45
"4567","riverside",4567,"2021-04-28",16386,1476801,8828,779936,7306,654818,252,42047,5529,289194,10798,614804,5781,903998,"California",2468145,0.24909557582719,528340,0.53,449144,0.45
"4568","riverside",4568,"2021-04-29",18621,1495422,11423,791359,6863,661681,335,42382,5384,281740,13173,627977,5719,909717,"California",2468145,0.254432782514804,528340,0.53,449144,0.45
"4569","riverside",4569,"2021-04-30",19630,1515052,11318,802677,7941,669622,371,42753,6280,275091,13303,641280,6654,916371,"California",2468145,0.259822660338027,528340,0.53,449144,0.45
"4570","riverside",4570,"2021-05-01",6753,1521805,4869,807546,1716,671338,168,42921,2319,273164,4412,645692,2485,918856,"California",2468145,0.261610237648112,528340,0.53,449144,0.45
"4571","riverside",4571,"2021-05-02",3345,1525150,2184,809730,956,672294,205,43126,1064,272172,2267,647959,1275,920131,"California",2468145,0.262528741220633,528340,0.53,449144,0.45
"4572","riverside",4572,"2021-05-03",17868,1543018,10941,820671,6450,678744,477,43603,4079,262998,13729,661688,4555,924686,"California",2468145,0.268091218303625,528340,0.53,449144,0.45
"4573","riverside",4573,"2021-05-04",17063,1560081,10831,831502,5820,684564,412,44015,4793,255991,12212,673900,5205,929891,"California",2468145,0.273039063750306,528340,0.53,449144,0.45
"4574","riverside",4574,"2021-05-05",13852,1573933,7929,839431,5577,690141,346,44361,3852,250240,9949,683849,4198,934089,"California",2468145,0.277070026274793,528340,0.53,449144,0.45
"4575","riverside",4575,"2021-05-06",15532,1589465,8761,848192,6380,696521,391,44752,3776,242710,11699,695548,4169,938258,"California",2468145,0.281810023317107,528340,0.53,449144,0.45
"4576","riverside",4576,"2021-05-07",17702,1607167,10466,858658,6808,703329,428,45180,4440,234382,13196,708744,4868,943126,"California",2468145,0.287156548744097,528340,0.53,449144,0.45
"4577","riverside",4577,"2021-05-08",5830,1612997,3729,862387,1916,705245,185,45365,2284,233329,3522,712266,2469,945595,"California",2468145,0.288583531356545,528340,0.53,449144,0.45
"4578","sacramento",4578,"2020-12-15",315,315,315,315,0,0,0,0,315,315,0,0,315,315,"California",1567975,0,440808,0.614,259405,0.361
"4579","sacramento",4579,"2020-12-16",643,958,643,958,0,0,0,0,643,958,0,0,643,958,"California",1567975,0,440808,0.614,259405,0.361
"4580","sacramento",4580,"2020-12-17",647,1605,647,1605,0,0,0,0,647,1605,0,0,647,1605,"California",1567975,0,440808,0.614,259405,0.361
"4581","sacramento",4581,"2020-12-18",969,2574,969,2574,0,0,0,0,969,2574,0,0,969,2574,"California",1567975,0,440808,0.614,259405,0.361
"4582","sacramento",4582,"2020-12-19",612,3186,612,3186,0,0,0,0,612,3186,0,0,612,3186,"California",1567975,0,440808,0.614,259405,0.361
"4583","sacramento",4583,"2020-12-20",633,3819,633,3819,0,0,0,0,633,3819,0,0,633,3819,"California",1567975,0,440808,0.614,259405,0.361
"4584","sacramento",4584,"2020-12-21",1676,5495,1676,5495,0,0,0,0,1677,5496,0,0,1677,5496,"California",1567975,0,440808,0.614,259405,0.361
"4585","sacramento",4585,"2020-12-22",2095,7590,2062,7557,33,33,0,0,2095,7591,0,0,2095,7591,"California",1567975,0,440808,0.614,259405,0.361
"4586","sacramento",4586,"2020-12-23",2249,9839,2080,9637,169,202,0,0,2249,9840,0,0,2249,9840,"California",1567975,0,440808,0.614,259405,0.361
"4587","sacramento",4587,"2020-12-24",1046,10885,834,10471,212,414,0,0,1046,10886,0,0,1046,10886,"California",1567975,0,440808,0.614,259405,0.361
"4588","sacramento",4588,"2020-12-25",1,10886,0,10471,1,415,0,0,1,10887,0,0,1,10887,"California",1567975,0,440808,0.614,259405,0.361
"4589","sacramento",4589,"2020-12-26",509,11395,291,10762,218,633,0,0,509,11396,0,0,509,11396,"California",1567975,0,440808,0.614,259405,0.361
"4590","sacramento",4590,"2020-12-27",351,11746,247,11009,104,737,0,0,351,11747,0,0,351,11747,"California",1567975,0,440808,0.614,259405,0.361
"4591","sacramento",4591,"2020-12-28",1902,13648,1324,12333,578,1315,0,0,1901,13647,1,1,1901,13648,"California",1567975,6.37765270492195e-07,440808,0.614,259405,0.361
"4592","sacramento",4592,"2020-12-29",1954,15602,1189,13522,765,2080,0,0,1954,15601,0,1,1954,15602,"California",1567975,6.37765270492195e-07,440808,0.614,259405,0.361
"4593","sacramento",4593,"2020-12-30",2562,18164,1457,14979,1105,3185,0,0,2563,18164,0,1,2563,18165,"California",1567975,6.37765270492195e-07,440808,0.614,259405,0.361
"4594","sacramento",4594,"2020-12-31",1229,19393,695,15674,534,3719,0,0,1230,19394,0,1,1230,19395,"California",1567975,6.37765270492195e-07,440808,0.614,259405,0.361
"4595","sacramento",4595,"2021-01-01",81,19474,70,15744,11,3730,0,0,81,19475,0,1,81,19476,"California",1567975,6.37765270492195e-07,440808,0.614,259405,0.361
"4596","sacramento",4596,"2021-01-02",563,20037,362,16106,201,3931,0,0,563,20038,0,1,563,20039,"California",1567975,6.37765270492195e-07,440808,0.614,259405,0.361
"4597","sacramento",4597,"2021-01-03",411,20448,222,16328,189,4120,0,0,411,20449,0,1,411,20450,"California",1567975,6.37765270492195e-07,440808,0.614,259405,0.361
"4598","sacramento",4598,"2021-01-04",1958,22406,845,17173,1113,5233,0,0,1956,22404,1,2,1956,22406,"California",1567975,1.27553054098439e-06,440808,0.614,259405,0.361
"4599","sacramento",4599,"2021-01-05",2213,24619,986,18159,1227,6460,0,0,1859,23916,354,356,1866,24272,"California",1567975,0.000227044436295222,440808,0.614,259405,0.361
"4600","sacramento",4600,"2021-01-06",2734,27353,1623,19782,1111,7571,0,0,1959,25103,772,1128,1959,26231,"California",1567975,0.000719399225115196,440808,0.614,259405,0.361
"4601","sacramento",4601,"2021-01-07",2836,30189,1506,21288,1330,8901,0,0,1975,26220,858,1986,1975,28206,"California",1567975,0.0012666018271975,440808,0.614,259405,0.361
"4602","sacramento",4602,"2021-01-08",3296,33485,2091,23379,1205,10106,0,0,2262,27453,1030,3016,2263,30469,"California",1567975,0.00192350005580446,440808,0.614,259405,0.361
"4603","sacramento",4603,"2021-01-09",1290,34775,798,24177,492,10598,0,0,900,27965,388,3404,900,31369,"California",1567975,0.00217095298075543,440808,0.614,259405,0.361
"4604","sacramento",4604,"2021-01-10",1246,36021,710,24887,536,11134,0,0,775,28271,470,3874,776,32145,"California",1567975,0.00247070265788676,440808,0.614,259405,0.361
"4605","sacramento",4605,"2021-01-11",4350,40371,2960,27847,1390,12524,0,0,2413,28760,1936,5810,2425,34570,"California",1567975,0.00370541622155966,440808,0.614,259405,0.361
"4606","sacramento",4606,"2021-01-12",4396,44767,3033,30880,1363,13887,0,0,2430,29229,1965,7775,2434,37004,"California",1567975,0.00495862497807682,440808,0.614,259405,0.361
"4607","sacramento",4607,"2021-01-13",3791,48558,2171,33051,1620,15507,0,0,2380,30200,1410,9185,2381,39385,"California",1567975,0.00585787400947081,440808,0.614,259405,0.361
"4608","sacramento",4608,"2021-01-14",4628,53186,2369,35420,2259,17766,0,0,3705,32986,919,10104,3705,43090,"California",1567975,0.00644398029305314,440808,0.614,259405,0.361
"4609","sacramento",4609,"2021-01-15",4427,57613,2265,37685,2162,19928,0,0,3705,35971,721,10825,3706,46796,"California",1567975,0.00690380905307801,440808,0.614,259405,0.361
"4610","sacramento",4610,"2021-01-16",2093,59706,1292,38977,801,20729,0,0,1876,37630,217,11042,1876,48672,"California",1567975,0.00704220411677482,440808,0.614,259405,0.361
"4611","sacramento",4611,"2021-01-17",1643,61349,952,39929,691,21420,0,0,1465,38920,178,11220,1468,50140,"California",1567975,0.00715572633492243,440808,0.614,259405,0.361
"4612","sacramento",4612,"2021-01-18",2860,64209,1768,41697,1092,22512,0,0,2333,40728,526,11746,2334,52474,"California",1567975,0.00749119086720133,440808,0.614,259405,0.361
"4613","sacramento",4613,"2021-01-19",5001,69210,3051,44748,1950,24462,0,0,3730,43189,1271,13017,3732,56206,"California",1567975,0.00830179052599691,440808,0.614,259405,0.361
"4614","sacramento",4614,"2021-01-20",4811,74021,2850,47598,1961,26423,0,0,3590,45561,1223,14240,3595,59801,"California",1567975,0.00908177745180886,440808,0.614,259405,0.361
"4615","sacramento",4615,"2021-01-21",5200,79221,2997,50595,2203,28626,0,0,4235,48838,959,15199,4236,64037,"California",1567975,0.00969339434621088,440808,0.614,259405,0.361
"4616","sacramento",4616,"2021-01-22",4985,84206,2654,53249,2331,30957,0,0,4684,53223,300,15499,4685,68722,"California",1567975,0.00988472392735854,440808,0.614,259405,0.361
"4617","sacramento",4617,"2021-01-23",3731,87937,1561,54810,2170,33127,0,0,3274,56040,457,15956,3274,71996,"California",1567975,0.0101761826559735,440808,0.614,259405,0.361
"4618","sacramento",4618,"2021-01-24",1598,89535,998,55808,600,33727,0,0,1357,57157,241,16197,1358,73354,"California",1567975,0.0103298840861621,440808,0.614,259405,0.361
"4619","sacramento",4619,"2021-01-25",4362,93897,2113,57921,2249,35976,0,0,2944,58685,1418,17615,2946,76300,"California",1567975,0.01123423523972,440808,0.614,259405,0.361
"4620","sacramento",4620,"2021-01-26",4724,98621,2137,60058,2587,38563,0,0,3522,61009,1200,18815,3524,79824,"California",1567975,0.0119995535643107,440808,0.614,259405,0.361
"4621","sacramento",4621,"2021-01-27",5814,104435,3056,63114,2758,41321,0,0,4207,63614,1604,20419,4209,84033,"California",1567975,0.0130225290581801,440808,0.614,259405,0.361
"4622","sacramento",4622,"2021-01-28",5361,109796,2708,65822,2653,43974,0,0,4267,66789,1093,21512,4268,88301,"California",1567975,0.0137196064988281,440808,0.614,259405,0.361
"4623","sacramento",4623,"2021-01-29",5399,115195,2939,68761,2460,46434,0,0,4373,70145,1017,22529,4373,92674,"California",1567975,0.0143682137789187,440808,0.614,259405,0.361
"4624","sacramento",4624,"2021-01-30",4511,119706,2206,70967,2305,48739,0,0,4076,73788,433,22962,4076,96750,"California",1567975,0.0146443661410418,440808,0.614,259405,0.361
"4625","sacramento",4625,"2021-01-31",2313,122019,2019,72986,294,49033,0,0,2037,75553,274,23236,2039,98789,"California",1567975,0.0148191138251567,440808,0.614,259405,0.361
"4626","sacramento",4626,"2021-02-01",5911,127930,3015,76001,2896,51929,0,0,4249,78144,1658,24894,4249,103038,"California",1567975,0.0158765286436327,440808,0.614,259405,0.361
"4627","sacramento",4627,"2021-02-02",6936,134866,3765,79766,3171,55100,0,0,4851,80931,2066,26960,4853,107891,"California",1567975,0.0171941516924696,440808,0.614,259405,0.361
"4628","sacramento",4628,"2021-02-03",7099,141965,3557,83323,3542,58642,0,0,5236,84316,1853,28813,5238,113129,"California",1567975,0.0183759307386916,440808,0.614,259405,0.361
"4629","sacramento",4629,"2021-02-04",7719,149684,3638,86961,4081,62723,0,0,5498,87603,2211,31024,5498,118627,"California",1567975,0.0197860297517499,440808,0.614,259405,0.361
"4630","sacramento",4630,"2021-02-05",7813,157497,4452,91413,3361,66084,0,0,4877,89570,2913,33937,4880,123507,"California",1567975,0.0216438399846936,440808,0.614,259405,0.361
"4631","sacramento",4631,"2021-02-06",8441,165938,3453,94866,4988,71072,0,0,7111,95356,1326,35263,7112,130619,"California",1567975,0.0224895167333663,440808,0.614,259405,0.361
"4632","sacramento",4632,"2021-02-07",4076,170014,2190,97056,1886,72958,0,0,2853,96996,1215,36478,2855,133474,"California",1567975,0.0232644015370143,440808,0.614,259405,0.361
"4633","sacramento",4633,"2021-02-08",6196,176210,3204,100260,2992,75950,0,0,3885,98574,2307,38785,3885,137359,"California",1567975,0.0247357260160398,440808,0.614,259405,0.361
"4634","sacramento",4634,"2021-02-09",6801,183011,3588,103848,3213,79163,0,0,4010,99803,2782,41567,4011,141370,"California",1567975,0.0265099889985491,440808,0.614,259405,0.361
"4635","sacramento",4635,"2021-02-10",7660,190671,4174,108022,3486,82649,0,0,4529,101216,3118,44685,4531,145901,"California",1567975,0.0284985411119437,440808,0.614,259405,0.361
"4636","sacramento",4636,"2021-02-11",9608,200279,5747,113769,3861,86510,0,0,5547,102718,4047,48732,5549,151450,"California",1567975,0.0310795771616257,440808,0.614,259405,0.361
"4637","sacramento",4637,"2021-02-12",10662,210941,4142,117911,6520,93030,0,0,6401,104921,4201,52933,6404,157854,"California",1567975,0.0337588290629634,440808,0.614,259405,0.361
"4638","sacramento",4638,"2021-02-13",7676,218617,2991,120902,4685,97715,0,0,6090,109427,1584,54517,6090,163944,"California",1567975,0.034769049251423,440808,0.614,259405,0.361
"4639","sacramento",4639,"2021-02-14",3164,221781,1947,122849,1217,98932,0,0,2086,110441,1076,55593,2090,166034,"California",1567975,0.0354552846824726,440808,0.614,259405,0.361
"4640","sacramento",4640,"2021-02-15",5985,227766,2043,124892,3942,102874,0,0,4162,112789,1816,57409,4164,170198,"California",1567975,0.0366134664136864,440808,0.614,259405,0.361
"4641","sacramento",4641,"2021-02-16",9231,236997,4203,129095,5028,107902,0,0,5319,114207,3905,61314,5323,175521,"California",1567975,0.0391039397949585,440808,0.614,259405,0.361
"4642","sacramento",4642,"2021-02-17",8826,245823,4980,134075,3846,111748,0,0,5137,115669,3677,64991,5139,180660,"California",1567975,0.0414490026945583,440808,0.614,259405,0.361
"4643","sacramento",4643,"2021-02-18",9554,255377,5718,139793,3836,115584,0,0,5766,117657,3781,68772,5769,186429,"California",1567975,0.0438603931822893,440808,0.614,259405,0.361
"4644","sacramento",4644,"2021-02-19",10008,265385,6138,145931,3870,119454,0,0,5911,119489,4084,72856,5916,192345,"California",1567975,0.0464650265469794,440808,0.614,259405,0.361
"4645","sacramento",4645,"2021-02-20",7745,273130,5720,151651,2025,121479,0,0,4689,121131,3048,75904,4690,197035,"California",1567975,0.0484089350914396,440808,0.614,259405,0.361
"4646","sacramento",4646,"2021-02-21",2937,276067,2334,153985,603,122082,0,0,1024,120248,1907,77811,1024,198059,"California",1567975,0.0496251534622682,440808,0.614,259405,0.361
"4647","sacramento",4647,"2021-02-22",6188,282255,3745,157730,2443,124525,0,0,2685,119445,3492,81303,2689,200748,"California",1567975,0.051852229786827,440808,0.614,259405,0.361
"4648","sacramento",4648,"2021-02-23",7139,289394,4439,162169,2700,127225,0,0,3468,119262,3655,84958,3472,204220,"California",1567975,0.0541832618504759,440808,0.614,259405,0.361
"4649","sacramento",4649,"2021-02-24",9653,299047,5295,167464,4358,131583,0,0,5287,120204,4349,89307,5291,209511,"California",1567975,0.0569569030118465,440808,0.614,259405,0.361
"4650","sacramento",4650,"2021-02-25",10918,309965,6224,173688,4694,136277,0,0,6410,122121,4493,93800,6410,215921,"California",1567975,0.0598223823721679,440808,0.614,259405,0.361
"4651","sacramento",4651,"2021-02-26",13904,323869,6472,180160,7432,143709,0,0,9577,127406,4296,98096,9581,225502,"California",1567975,0.0625622219742024,440808,0.614,259405,0.361
"4652","sacramento",4652,"2021-02-27",10809,334678,6719,186879,4087,147796,3,3,7944,132506,2847,100943,7947,233449,"California",1567975,0.0643779396992937,440808,0.614,259405,0.361
"4653","sacramento",4653,"2021-02-28",5614,340292,2225,189104,3389,151185,0,3,2590,132087,3010,103953,2591,236040,"California",1567975,0.0662976131634752,440808,0.614,259405,0.361
"4654","sacramento",4654,"2021-03-01",8043,348335,3469,192573,4574,155759,0,3,4349,132765,3673,107626,4351,240391,"California",1567975,0.068640125001993,440808,0.614,259405,0.361
"4655","sacramento",4655,"2021-03-02",9242,357577,4021,196594,5220,160979,1,4,5676,134895,3550,111176,5680,246071,"California",1567975,0.0709041917122403,440808,0.614,259405,0.361
"4656","sacramento",4656,"2021-03-03",10921,368498,5001,201595,5917,166896,3,7,6509,137016,4393,115569,6514,252585,"California",1567975,0.0737058945455125,440808,0.614,259405,0.361
"4657","sacramento",4657,"2021-03-04",13418,381916,6167,207762,7247,174143,4,11,7465,138568,5923,121492,7475,260060,"California",1567975,0.0774833782426378,440808,0.614,259405,0.361
"4658","sacramento",4658,"2021-03-05",10575,392491,4883,212645,5662,179805,30,41,7031,142107,3522,125014,7061,267121,"California",1567975,0.0797295875253113,440808,0.614,259405,0.361
"4659","sacramento",4659,"2021-03-06",8092,400583,3103,215748,4867,184672,122,163,4095,142343,3980,128994,4216,271337,"California",1567975,0.0822678933018702,440808,0.614,259405,0.361
"4660","sacramento",4660,"2021-03-07",7587,408170,2196,217944,5305,189977,86,249,3728,142301,3854,132848,3812,275149,"California",1567975,0.0847258406543472,440808,0.614,259405,0.361
"4661","sacramento",4661,"2021-03-08",9098,417268,4243,222187,4631,194608,224,473,5958,145354,3127,135975,6180,281329,"California",1567975,0.0867201326551763,440808,0.614,259405,0.361
"4662","sacramento",4662,"2021-03-09",9554,426822,4526,226713,4740,199348,288,761,5492,147088,4046,140021,5780,287109,"California",1567975,0.0893005309395877,440808,0.614,259405,0.361
"4663","sacramento",4663,"2021-03-10",11708,438530,7476,234189,3886,203234,346,1107,6845,149453,4828,144849,7193,294302,"California",1567975,0.092379661665524,440808,0.614,259405,0.361
"4664","sacramento",4664,"2021-03-11",14986,453516,9958,244147,4233,207467,795,1902,8916,153131,6032,150881,9710,304012,"California",1567975,0.0962266617771329,440808,0.614,259405,0.361
"4665","sacramento",4665,"2021-03-12",17958,471474,8308,252455,8817,216284,833,2735,8838,153743,9067,159948,9679,313691,"California",1567975,0.102009279484686,440808,0.614,259405,0.361
"4666","sacramento",4666,"2021-03-13",12952,484426,3571,256026,8957,225241,424,3159,7860,156944,5080,165028,8281,321972,"California",1567975,0.105249127058786,440808,0.614,259405,0.361
"4667","sacramento",4667,"2021-03-14",8374,492800,3463,259489,4281,229522,630,3789,4475,158172,3876,168904,5104,327076,"California",1567975,0.107721105247214,440808,0.614,259405,0.361
"4668","sacramento",4668,"2021-03-15",12166,504966,4823,264312,6693,236215,650,4439,7081,160840,5064,173968,7732,334808,"California",1567975,0.110950748576986,440808,0.614,259405,0.361
"4669","sacramento",4669,"2021-03-16",13968,518934,6206,270518,7124,243339,638,5077,8629,164796,5306,179274,9262,344070,"California",1567975,0.114334731102218,440808,0.614,259405,0.361
"4670","sacramento",4670,"2021-03-17",13636,532570,6570,277088,6455,249794,611,5688,8812,169427,4796,184070,9427,353497,"California",1567975,0.117393453339498,440808,0.614,259405,0.361
"4671","sacramento",4671,"2021-03-18",15634,548204,8210,285298,6860,256654,564,6252,10111,174609,5492,189562,10674,364171,"California",1567975,0.120896060205042,440808,0.614,259405,0.361
"4672","sacramento",4672,"2021-03-19",15578,563782,7957,293255,6249,262903,1372,7624,8111,176650,7440,197002,9481,373652,"California",1567975,0.125641033817503,440808,0.614,259405,0.361
"4673","sacramento",4673,"2021-03-20",12889,576671,7529,300784,5021,267924,339,7963,8161,180454,4698,201700,8502,382154,"California",1567975,0.128637255058276,440808,0.614,259405,0.361
"4674","sacramento",4674,"2021-03-21",5597,582268,2753,303537,2805,270729,39,8002,4944,184798,641,202341,4985,387139,"California",1567975,0.129046062596661,440808,0.614,259405,0.361
"4675","sacramento",4675,"2021-03-22",9363,591631,4795,308332,3719,274448,849,8851,6280,188871,3057,205398,7130,394269,"California",1567975,0.130995711028556,440808,0.614,259405,0.361
"4676","sacramento",4676,"2021-03-23",11317,602948,6745,315077,3763,278211,809,9660,7311,193022,3967,209365,8118,402387,"California",1567975,0.133525725856598,440808,0.614,259405,0.361
"4677","sacramento",4677,"2021-03-24",11847,614795,7273,322350,3944,282155,630,10290,6750,195387,5016,214381,7381,409768,"California",1567975,0.136724756453387,440808,0.614,259405,0.361
"4678","sacramento",4678,"2021-03-25",14077,628872,8305,330655,4964,287119,808,11098,8543,199244,5491,219872,9348,419116,"California",1567975,0.14022672555366,440808,0.614,259405,0.361
"4679","sacramento",4679,"2021-03-26",18238,647110,8930,339585,8820,295939,488,11586,9234,200032,8936,228808,9724,428840,"California",1567975,0.145925796010778,440808,0.614,259405,0.361
"4680","sacramento",4680,"2021-03-27",9679,656789,3559,343144,5830,301769,290,11876,5217,201104,4431,233239,5503,434343,"California",1567975,0.148751733924329,440808,0.614,259405,0.361
"4681","sacramento",4681,"2021-03-28",6520,663309,3214,346358,3058,304827,248,12124,3130,201105,3380,236619,3381,437724,"California",1567975,0.150907380538593,440808,0.614,259405,0.361
"4682","sacramento",4682,"2021-03-29",11011,674320,5896,352254,4744,309571,371,12495,5221,200937,5762,242381,5594,443318,"California",1567975,0.154582184027169,440808,0.614,259405,0.361
"4683","sacramento",4683,"2021-03-30",11845,686165,6078,358332,5375,314946,392,12887,6067,201639,5756,248137,6458,449776,"California",1567975,0.158253160924122,440808,0.614,259405,0.361
"4684","sacramento",4684,"2021-03-31",13396,699561,7833,366165,5167,320113,396,13283,5683,200024,7687,255824,6072,455848,"California",1567975,0.163155662558395,440808,0.614,259405,0.361
"4685","sacramento",4685,"2021-04-01",17287,716848,10398,376563,6669,326782,220,13503,7295,197587,9960,265784,7523,463371,"California",1567975,0.169507804652498,440808,0.614,259405,0.361
"4686","sacramento",4686,"2021-04-02",17041,733889,9666,386229,6646,333428,729,14232,8970,199249,8040,273824,9702,473073,"California",1567975,0.174635437427255,440808,0.614,259405,0.361
"4687","sacramento",4687,"2021-04-03",10345,744234,6166,392395,3632,337060,547,14779,6354,202182,3964,277788,6897,479970,"California",1567975,0.177163538959486,440808,0.614,259405,0.361
"4688","sacramento",4688,"2021-04-04",3683,747917,1519,393914,1976,339036,188,14967,1442,201573,2236,280024,1627,481597,"California",1567975,0.178589582104307,440808,0.614,259405,0.361
"4689","sacramento",4689,"2021-04-05",11998,759915,7530,401444,3638,342674,830,15797,5357,201146,6608,286632,6181,487778,"California",1567975,0.182803935011719,440808,0.614,259405,0.361
"4690","sacramento",4690,"2021-04-06",15548,775463,8833,410277,5372,348046,1343,17140,6875,200719,8642,295274,8215,495993,"California",1567975,0.188315502479313,440808,0.614,259405,0.361
"4691","sacramento",4691,"2021-04-07",14695,790158,7953,418230,5165,353211,1577,18717,7111,201847,7551,302825,8679,504672,"California",1567975,0.193131268036799,440808,0.614,259405,0.361
"4692","sacramento",4692,"2021-04-08",14901,805059,6683,424913,5253,358464,2965,21682,5906,201742,8963,311788,8858,513530,"California",1567975,0.198847558156221,440808,0.614,259405,0.361
"4693","sacramento",4693,"2021-04-09",18102,823161,9256,434169,6664,365128,2182,23864,7328,200508,10737,322525,9503,523033,"California",1567975,0.205695243865495,440808,0.614,259405,0.361
"4694","sacramento",4694,"2021-04-10",12478,835639,3820,437989,7487,372615,1171,25035,5076,199354,7375,329900,6221,529254,"California",1567975,0.210398762735375,440808,0.614,259405,0.361
"4695","sacramento",4695,"2021-04-11",10708,846347,4309,442298,6175,378790,224,25259,3791,196476,6891,336791,4013,533267,"California",1567975,0.214793603214337,440808,0.614,259405,0.361
"4696","sacramento",4696,"2021-04-12",12891,859238,5003,447301,6025,384815,1863,27122,4925,195339,7911,344702,6774,540041,"California",1567975,0.219838964269201,440808,0.614,259405,0.361
"4697","sacramento",4697,"2021-04-13",16207,875445,9915,457216,6288,391103,4,27126,7534,194235,8647,353349,7543,547584,"California",1567975,0.225353720563147,440808,0.614,259405,0.361
"4698","sacramento",4698,"2021-04-14",14876,890321,7934,465150,6940,398043,2,27128,5877,191149,8968,362317,5882,553466,"California",1567975,0.231073199508921,440808,0.614,259405,0.361
"4699","sacramento",4699,"2021-04-15",16276,906597,8384,473534,7890,405933,2,27130,6603,188119,9638,371955,6608,560074,"California",1567975,0.237219981185925,440808,0.614,259405,0.361
"4700","sacramento",4700,"2021-04-16",17335,923932,9592,483126,7743,413676,0,27130,7858,186542,9437,381392,7860,567934,"California",1567975,0.243238572043559,440808,0.614,259405,0.361
"4701","sacramento",4701,"2021-04-17",15199,939131,6106,489232,9093,422769,0,27130,11005,193376,4175,385567,11009,578943,"California",1567975,0.245901242047864,440808,0.614,259405,0.361
"4702","sacramento",4702,"2021-04-18",8417,947548,3062,492294,5355,428124,0,27130,3741,192457,4661,390228,3742,582685,"California",1567975,0.248873865973628,440808,0.614,259405,0.361
"4703","sacramento",4703,"2021-04-19",10549,958097,5699,497993,4846,432970,4,27134,4695,191323,5835,396063,4701,587386,"California",1567975,0.25259522632695,440808,0.614,259405,0.361
"4704","sacramento",4704,"2021-04-20",11081,969178,6720,504713,4358,437328,3,27137,5901,192070,5161,401224,5908,593294,"California",1567975,0.255886732887961,440808,0.614,259405,0.361
"4705","sacramento",4705,"2021-04-21",11446,980624,6610,511323,4834,442162,2,27139,6214,193081,5206,406430,6217,599511,"California",1567975,0.259206938886143,440808,0.614,259405,0.361
"4706","sacramento",4706,"2021-04-22",14775,995399,9868,521191,4904,447066,3,27142,6817,191972,7931,414361,6822,606333,"California",1567975,0.264265055246417,440808,0.614,259405,0.361
"4707","sacramento",4707,"2021-04-23",15791,1011190,9984,531175,5807,452873,0,27142,7331,190878,8426,422787,7332,613665,"California",1567975,0.269638865415584,440808,0.614,259405,0.361
"4708","sacramento",4708,"2021-04-24",11306,1022496,7000,538175,4305,457178,1,27143,5926,191465,5341,428128,5928,619593,"California",1567975,0.273045169725283,440808,0.614,259405,0.361
"4709","sacramento",4709,"2021-04-25",7974,1030470,4482,542657,3492,460670,0,27143,4154,191814,3806,431934,4155,623748,"California",1567975,0.275472504344776,440808,0.614,259405,0.361
"4710","sacramento",4710,"2021-04-26",9813,1040283,6152,548809,3636,464306,25,27168,4469,190994,5315,437249,4495,628243,"California",1567975,0.278862226757442,440808,0.614,259405,0.361
"4711","sacramento",4711,"2021-04-27",11171,1051454,7352,556161,3699,468005,120,27288,5439,190850,5703,442952,5559,633802,"California",1567975,0.282499402095059,440808,0.614,259405,0.361
"4712","sacramento",4712,"2021-04-28",9991,1061445,5698,561859,4092,472097,201,27489,5353,191796,4613,447565,5559,639361,"California",1567975,0.285441413287839,440808,0.614,259405,0.361
"4713","sacramento",4713,"2021-04-29",10150,1071595,6788,568647,3059,475156,303,27792,5338,192659,4779,452344,5642,645003,"California",1567975,0.288489293515522,440808,0.614,259405,0.361
"4714","sacramento",4714,"2021-04-30",12400,1083995,7786,576433,4350,479506,264,28056,5859,192286,6497,458841,6124,651127,"California",1567975,0.292632854477909,440808,0.614,259405,0.361
"4715","sacramento",4715,"2021-05-01",7556,1091551,5469,581902,1918,481424,169,28225,2752,190440,4769,463610,2923,654050,"California",1567975,0.295674357052887,440808,0.614,259405,0.361
"4716","sacramento",4716,"2021-05-02",3808,1095359,3157,585059,543,481967,108,28333,2161,191078,1629,465239,2267,656317,"California",1567975,0.296713276678518,440808,0.614,259405,0.361
"4717","sacramento",4717,"2021-05-03",9052,1104411,7243,592302,1529,483496,280,28613,3915,190154,5113,470352,4189,660506,"California",1567975,0.299974170506545,440808,0.614,259405,0.361
"4718","sacramento",4718,"2021-05-04",9327,1113738,5668,597970,3351,486847,308,28921,3764,188706,5518,475870,4070,664576,"California",1567975,0.303493359269121,440808,0.614,259405,0.361
"4719","sacramento",4719,"2021-05-05",10828,1124566,5860,603830,4519,491366,449,29370,4339,187034,6455,482325,4783,669359,"California",1567975,0.307610134090148,440808,0.614,259405,0.361
"4720","sacramento",4720,"2021-05-06",11041,1135607,6172,610002,4578,495944,291,29661,4603,185782,6145,488470,4893,674252,"California",1567975,0.311529201677323,440808,0.614,259405,0.361
"4721","sacramento",4721,"2021-05-07",10381,1145988,6048,616050,3957,499901,376,30037,4302,184423,6035,494505,4676,678928,"California",1567975,0.315378115084743,440808,0.614,259405,0.361
"4722","sacramento",4722,"2021-05-08",8092,1154080,3763,619813,4105,504006,224,30261,2673,181930,5387,499892,2894,681822,"California",1567975,0.318813756596884,440808,0.614,259405,0.361
"4723","san benito",4723,"2020-12-16",2,2,2,2,0,0,0,0,2,2,0,0,2,2,"California",64022,0,17628,0.612,10590,0.367
"4724","san benito",4724,"2020-12-17",8,10,8,10,0,0,0,0,8,10,0,0,8,10,"California",64022,0,17628,0.612,10590,0.367
"4725","san benito",4725,"2020-12-18",32,42,32,42,0,0,0,0,32,42,0,0,32,42,"California",64022,0,17628,0.612,10590,0.367
"4726","san benito",4726,"2020-12-19",47,89,47,89,0,0,0,0,47,89,0,0,47,89,"California",64022,0,17628,0.612,10590,0.367
"4727","san benito",4727,"2020-12-20",22,111,22,111,0,0,0,0,22,111,0,0,22,111,"California",64022,0,17628,0.612,10590,0.367
"4728","san benito",4728,"2020-12-21",48,159,48,159,0,0,0,0,48,159,0,0,48,159,"California",64022,0,17628,0.612,10590,0.367
"4729","san benito",4729,"2020-12-22",65,224,65,224,0,0,0,0,65,224,0,0,65,224,"California",64022,0,17628,0.612,10590,0.367
"4730","san benito",4730,"2020-12-23",48,272,36,260,12,12,0,0,48,272,0,0,48,272,"California",64022,0,17628,0.612,10590,0.367
"4731","san benito",4731,"2020-12-24",12,284,4,264,8,20,0,0,12,284,0,0,12,284,"California",64022,0,17628,0.612,10590,0.367
"4732","san benito",4732,"2020-12-25",4,288,4,268,0,20,0,0,4,288,0,0,4,288,"California",64022,0,17628,0.612,10590,0.367
"4733","san benito",4733,"2020-12-26",13,301,4,272,9,29,0,0,13,301,0,0,13,301,"California",64022,0,17628,0.612,10590,0.367
"4734","san benito",4734,"2020-12-27",8,309,7,279,1,30,0,0,8,309,0,0,8,309,"California",64022,0,17628,0.612,10590,0.367
"4735","san benito",4735,"2020-12-28",63,372,36,315,27,57,0,0,63,372,0,0,63,372,"California",64022,0,17628,0.612,10590,0.367
"4736","san benito",4736,"2020-12-29",50,422,21,336,29,86,0,0,50,422,0,0,50,422,"California",64022,0,17628,0.612,10590,0.367
"4737","san benito",4737,"2020-12-30",59,481,37,373,22,108,0,0,59,481,0,0,59,481,"California",64022,0,17628,0.612,10590,0.367
"4738","san benito",4738,"2020-12-31",19,500,2,375,17,125,0,0,19,500,0,0,19,500,"California",64022,0,17628,0.612,10590,0.367
"4739","san benito",4739,"2021-01-02",25,525,24,399,1,126,0,0,25,525,0,0,25,525,"California",64022,0,17628,0.612,10590,0.367
"4740","san benito",4740,"2021-01-03",3,528,1,400,2,128,0,0,3,528,0,0,3,528,"California",64022,0,17628,0.612,10590,0.367
"4741","san benito",4741,"2021-01-04",62,590,23,423,39,167,0,0,62,590,0,0,62,590,"California",64022,0,17628,0.612,10590,0.367
"4742","san benito",4742,"2021-01-05",119,709,37,460,82,249,0,0,116,703,3,3,116,706,"California",64022,4.68588922557871e-05,17628,0.612,10590,0.367
"4743","san benito",4743,"2021-01-06",97,806,42,502,55,304,0,0,83,772,14,17,83,789,"California",64022,0.000265533722782793,17628,0.612,10590,0.367
"4744","san benito",4744,"2021-01-07",80,886,43,545,37,341,0,0,52,796,28,45,52,841,"California",64022,0.000702883383836806,17628,0.612,10590,0.367
"4745","san benito",4745,"2021-01-08",130,1016,67,612,63,404,0,0,86,838,44,89,86,927,"California",64022,0.00139014713692168,17628,0.612,10590,0.367
"4746","san benito",4746,"2021-01-09",42,1058,29,641,13,417,0,0,29,854,13,102,29,956,"California",64022,0.00159320233669676,17628,0.612,10590,0.367
"4747","san benito",4747,"2021-01-10",15,1073,13,654,2,419,0,0,5,849,10,112,5,961,"California",64022,0.00174939864421605,17628,0.612,10590,0.367
"4748","san benito",4748,"2021-01-11",100,1173,59,713,41,460,0,0,47,843,53,165,47,1008,"California",64022,0.00257723907406829,17628,0.612,10590,0.367
"4749","san benito",4749,"2021-01-12",157,1330,53,766,104,564,0,0,121,928,36,201,121,1129,"California",64022,0.00313954578113773,17628,0.612,10590,0.367
"4750","san benito",4750,"2021-01-13",190,1520,35,801,155,719,0,0,163,1064,27,228,163,1292,"California",64022,0.00356127581143982,17628,0.612,10590,0.367
"4751","san benito",4751,"2021-01-14",116,1636,23,824,93,812,0,0,99,1146,17,245,99,1391,"California",64022,0.00382680953422261,17628,0.612,10590,0.367
"4752","san benito",4752,"2021-01-15",215,1851,21,845,194,1006,0,0,201,1333,14,259,201,1592,"California",64022,0.00404548436474962,17628,0.612,10590,0.367
"4753","san benito",4753,"2021-01-16",27,1878,9,854,18,1024,0,0,21,1348,6,265,21,1613,"California",64022,0.00413920214926119,17628,0.612,10590,0.367
"4754","san benito",4754,"2021-01-17",11,1889,5,859,6,1030,0,0,8,1353,3,268,8,1621,"California",64022,0.00418606104151698,17628,0.612,10590,0.367
"4755","san benito",4755,"2021-01-18",36,1925,23,882,13,1043,0,0,21,1359,15,283,21,1642,"California",64022,0.00442035550279591,17628,0.612,10590,0.367
"4756","san benito",4756,"2021-01-19",152,2077,65,947,87,1130,0,0,125,1457,27,310,125,1767,"California",64022,0.004842085533098,17628,0.612,10590,0.367
"4757","san benito",4757,"2021-01-20",275,2352,94,1041,181,1311,0,0,229,1641,45,355,229,1996,"California",64022,0.0055449689169348,17628,0.612,10590,0.367
"4758","san benito",4758,"2021-01-21",125,2477,32,1073,93,1404,0,0,100,1716,25,380,100,2096,"California",64022,0.00593545968573303,17628,0.612,10590,0.367
"4759","san benito",4759,"2021-01-22",231,2708,19,1092,212,1616,0,0,221,1927,10,390,221,2317,"California",64022,0.00609165599325232,17628,0.612,10590,0.367
"4760","san benito",4760,"2021-01-23",31,2739,17,1109,14,1630,0,0,13,1922,18,408,13,2330,"California",64022,0.00637280934678704,17628,0.612,10590,0.367
"4761","san benito",4761,"2021-01-24",11,2750,3,1112,8,1638,0,0,7,1925,4,412,7,2337,"California",64022,0.00643528786979476,17628,0.612,10590,0.367
"4762","san benito",4762,"2021-01-25",67,2817,25,1137,42,1680,0,0,21,1900,46,458,21,2358,"California",64022,0.00715379088438349,17628,0.612,10590,0.367
"4763","san benito",4763,"2021-01-26",134,2951,41,1178,93,1773,0,0,81,1928,53,511,81,2439,"California",64022,0.00798163131423573,17628,0.612,10590,0.367
"4764","san benito",4764,"2021-01-27",230,3181,69,1247,161,1934,0,0,190,2078,40,551,190,2629,"California",64022,0.00860641654431289,17628,0.612,10590,0.367
"4765","san benito",4765,"2021-01-28",155,3336,32,1279,123,2057,0,0,123,2170,31,582,123,2752,"California",64022,0.00909062509762269,17628,0.612,10590,0.367
"4766","san benito",4766,"2021-01-29",284,3620,31,1310,253,2310,0,0,261,2409,22,604,261,3013,"California",64022,0.00943425697416513,17628,0.612,10590,0.367
"4767","san benito",4767,"2021-01-30",50,3670,31,1341,19,2329,0,0,28,2415,22,626,28,3041,"California",64022,0.00977788885070757,17628,0.612,10590,0.367
"4768","san benito",4768,"2021-01-31",16,3686,5,1346,11,2340,0,0,11,2421,5,631,11,3052,"California",64022,0.00985598700446721,17628,0.612,10590,0.367
"4769","san benito",4769,"2021-02-01",133,3819,28,1374,105,2445,0,0,89,2466,44,675,89,3141,"California",64022,0.0105432507575521,17628,0.612,10590,0.367
"4770","san benito",4770,"2021-02-02",226,4045,49,1423,177,2622,0,0,136,2512,90,765,136,3277,"California",64022,0.0119490175252257,17628,0.612,10590,0.367
"4771","san benito",4771,"2021-02-03",336,4381,42,1465,294,2916,0,0,272,2720,64,829,272,3549,"California",64022,0.0129486738933492,17628,0.612,10590,0.367
"4772","san benito",4772,"2021-02-04",162,4543,24,1489,138,3054,0,0,118,2794,44,873,118,3667,"California",64022,0.013635937646434,17628,0.612,10590,0.367
"4773","san benito",4773,"2021-02-05",290,4833,40,1529,250,3304,0,0,228,2960,62,935,228,3895,"California",64022,0.0146043547530536,17628,0.612,10590,0.367
"4774","san benito",4774,"2021-02-06",49,4882,9,1538,40,3344,0,0,32,2975,17,952,32,3927,"California",64022,0.0148698884758364,17628,0.612,10590,0.367
"4775","san benito",4775,"2021-02-07",15,4897,7,1545,8,3352,0,0,14,2988,1,953,14,3941,"California",64022,0.0148855081065884,17628,0.612,10590,0.367
"4776","san benito",4776,"2021-02-08",138,5035,15,1560,123,3475,0,0,92,3034,46,999,92,4033,"California",64022,0.0156040111211771,17628,0.612,10590,0.367
"4777","san benito",4777,"2021-02-09",327,5362,64,1624,263,3738,0,0,194,3095,133,1132,194,4227,"California",64022,0.0176814220111837,17628,0.612,10590,0.367
"4778","san benito",4778,"2021-02-10",319,5681,88,1712,231,3969,0,0,111,2999,207,1339,111,4338,"California",64022,0.020914685576833,17628,0.612,10590,0.367
"4779","san benito",4779,"2021-02-11",296,5977,32,1744,264,4233,0,0,198,3099,98,1437,198,4536,"California",64022,0.022445409390522,17628,0.612,10590,0.367
"4780","san benito",4780,"2021-02-12",412,6389,30,1774,382,4615,0,0,207,3102,204,1641,207,4743,"California",64022,0.0256318140639155,17628,0.612,10590,0.367
"4781","san benito",4781,"2021-02-13",57,6446,8,1782,49,4664,0,0,43,3131,14,1655,43,4786,"California",64022,0.0258504888944425,17628,0.612,10590,0.367
"4782","san benito",4782,"2021-02-14",40,6486,5,1787,35,4699,0,0,30,3151,10,1665,30,4816,"California",64022,0.0260066852019618,17628,0.612,10590,0.367
"4783","san benito",4783,"2021-02-15",106,6592,9,1796,97,4796,0,0,95,3235,11,1676,95,4911,"California",64022,0.026178501140233,17628,0.612,10590,0.367
"4784","san benito",4784,"2021-02-16",205,6797,11,1807,194,4990,0,0,101,3232,104,1780,101,5012,"California",64022,0.0278029427384337,17628,0.612,10590,0.367
"4785","san benito",4785,"2021-02-17",327,7124,30,1837,297,5287,0,0,278,3461,49,1829,278,5290,"California",64022,0.0285683046452782,17628,0.612,10590,0.367
"4786","san benito",4786,"2021-02-18",293,7417,38,1875,255,5542,0,0,72,3312,221,2050,72,5362,"California",64022,0.0320202430414545,17628,0.612,10590,0.367
"4787","san benito",4787,"2021-02-19",342,7759,45,1920,297,5839,0,0,177,3324,165,2215,177,5539,"California",64022,0.0345974821155228,17628,0.612,10590,0.367
"4788","san benito",4788,"2021-02-20",45,7804,26,1946,19,5858,0,0,36,3351,9,2224,36,5575,"California",64022,0.0347380587922902,17628,0.612,10590,0.367
"4789","san benito",4789,"2021-02-21",23,7827,8,1954,15,5873,0,0,14,3356,9,2233,14,5589,"California",64022,0.0348786354690575,17628,0.612,10590,0.367
"4790","san benito",4790,"2021-02-22",132,7959,36,1990,96,5969,0,0,98,3421,33,2266,98,5687,"California",64022,0.0353940832838712,17628,0.612,10590,0.367
"4791","san benito",4791,"2021-02-23",374,8333,92,2082,282,6251,0,0,262,3571,112,2378,262,5949,"California",64022,0.0371434819280872,17628,0.612,10590,0.367
"4792","san benito",4792,"2021-02-24",377,8710,63,2145,314,6565,0,0,237,3668,140,2518,237,6186,"California",64022,0.0393302302333573,17628,0.612,10590,0.367
"4793","san benito",4793,"2021-02-25",392,9102,63,2208,329,6894,0,0,271,3816,123,2641,271,6457,"California",64022,0.0412514448158446,17628,0.612,10590,0.367
"4794","san benito",4794,"2021-02-26",640,9742,72,2280,568,7462,0,0,397,3970,243,2884,397,6854,"California",64022,0.0450470150885633,17628,0.612,10590,0.367
"4795","san benito",4795,"2021-02-27",98,9840,36,2316,62,7524,0,0,83,4038,15,2899,83,6937,"California",64022,0.0452813095498422,17628,0.612,10590,0.367
"4796","san benito",4796,"2021-02-28",249,10089,24,2340,225,7749,0,0,240,4269,9,2908,240,7177,"California",64022,0.0454218862266096,17628,0.612,10590,0.367
"4797","san benito",4797,"2021-03-01",224,10313,59,2399,165,7914,0,0,155,4354,70,2978,155,7332,"California",64022,0.0465152603792446,17628,0.612,10590,0.367
"4798","san benito",4798,"2021-03-02",276,10589,90,2489,186,8100,0,0,206,4490,70,3048,206,7538,"California",64022,0.0476086345318797,17628,0.612,10590,0.367
"4799","san benito",4799,"2021-03-03",396,10985,58,2547,338,8438,0,0,220,4536,174,3222,220,7758,"California",64022,0.0503264502827153,17628,0.612,10590,0.367
"4800","san benito",4800,"2021-03-04",610,11595,124,2671,471,8909,15,15,429,4788,181,3403,433,8191,"California",64022,0.0531536034488145,17628,0.612,10590,0.367
"4801","san benito",4801,"2021-03-05",582,12177,305,2976,265,9174,12,27,373,4965,208,3611,385,8576,"California",64022,0.0564024866452157,17628,0.612,10590,0.367
"4802","san benito",4802,"2021-03-06",191,12368,67,3043,110,9284,14,41,139,5066,52,3663,153,8729,"California",64022,0.057214707444316,17628,0.612,10590,0.367
"4803","san benito",4803,"2021-03-07",647,13015,603,3646,22,9306,22,63,615,5671,32,3695,637,9366,"California",64022,0.0577145356283777,17628,0.612,10590,0.367
"4804","san benito",4804,"2021-03-08",288,13303,65,3711,177,9483,46,109,167,5763,121,3816,213,9579,"California",64022,0.0596045109493612,17628,0.612,10590,0.367
"4805","san benito",4805,"2021-03-09",423,13726,84,3795,240,9723,99,208,137,5687,285,4101,209,9788,"California",64022,0.0640561057136609,17628,0.612,10590,0.367
"4806","san benito",4806,"2021-03-10",402,14128,114,3909,193,9916,95,303,232,5844,170,4271,327,10115,"California",64022,0.0667114429414889,17628,0.612,10590,0.367
"4807","san benito",4807,"2021-03-11",467,14595,119,4028,196,10112,152,455,206,5941,261,4532,358,10473,"California",64022,0.0707881665677423,17628,0.612,10590,0.367
"4808","san benito",4808,"2021-03-12",513,15108,117,4145,301,10413,95,550,230,5986,281,4813,326,10799,"California",64022,0.0751772828090344,17628,0.612,10590,0.367
"4809","san benito",4809,"2021-03-13",202,15310,102,4247,82,10495,18,568,128,6061,71,4884,146,10945,"California",64022,0.0762862765924214,17628,0.612,10590,0.367
"4810","san benito",4810,"2021-03-14",232,15542,40,4287,172,10667,20,588,180,6210,51,4935,200,11145,"California",64022,0.0770828777607697,17628,0.612,10590,0.367
"4811","san benito",4811,"2021-03-15",325,15867,100,4387,206,10873,19,607,191,6286,134,5069,210,11355,"California",64022,0.0791759082815282,17628,0.612,10590,0.367
"4812","san benito",4812,"2021-03-16",497,16364,219,4606,247,11120,31,638,350,6519,147,5216,380,11735,"California",64022,0.0814719940020618,17628,0.612,10590,0.367
"4813","san benito",4813,"2021-03-17",785,17149,476,5082,288,11408,21,659,559,6869,222,5438,572,12307,"California",64022,0.08493955202899,17628,0.612,10590,0.367
"4814","san benito",4814,"2021-03-18",787,17936,525,5607,207,11615,55,714,573,7276,212,5650,619,12926,"California",64022,0.088250913748399,17628,0.612,10590,0.367
"4815","san benito",4815,"2021-03-19",777,18713,404,6011,350,11965,23,737,577,7676,200,5850,600,13526,"California",64022,0.0913748398987848,17628,0.612,10590,0.367
"4816","san benito",4816,"2021-03-20",239,18952,147,6158,80,12045,12,749,183,7815,56,5906,195,13721,"California",64022,0.0922495392208928,17628,0.612,10590,0.367
"4817","san benito",4817,"2021-03-21",108,19060,56,6214,47,12092,5,754,81,7874,27,5933,86,13807,"California",64022,0.0926712692511949,17628,0.612,10590,0.367
"4818","san benito",4818,"2021-03-22",345,19405,171,6385,149,12241,25,779,222,7998,123,6056,247,14054,"California",64022,0.0945924838336822,17628,0.612,10590,0.367
"4819","san benito",4819,"2021-03-23",475,19880,197,6582,268,12509,10,789,215,7962,260,6316,224,14278,"California",64022,0.0986535878291837,17628,0.612,10590,0.367
"4820","san benito",4820,"2021-03-24",576,20456,305,6887,264,12773,7,796,361,8116,214,6530,368,14646,"California",64022,0.101996188810097,17628,0.612,10590,0.367
"4821","san benito",4821,"2021-03-25",742,21198,442,7329,296,13069,4,800,443,8268,295,6825,447,15093,"California",64022,0.106603979881916,17628,0.612,10590,0.367
"4822","san benito",4822,"2021-03-26",1001,22199,518,7847,480,13549,3,803,333,7937,667,7492,336,15429,"California",64022,0.117022273593452,17628,0.612,10590,0.367
"4823","san benito",4823,"2021-03-27",332,22531,184,8031,115,13664,33,836,215,8069,116,7608,248,15677,"California",64022,0.118834150760676,17628,0.612,10590,0.367
"4824","san benito",4824,"2021-03-28",694,23225,571,8602,118,13782,5,841,125,7630,569,8177,130,15807,"California",64022,0.127721720658524,17628,0.612,10590,0.367
"4825","san benito",4825,"2021-03-29",344,23569,110,8712,214,13996,20,861,149,7603,195,8372,168,15975,"California",64022,0.13076754865515,17628,0.612,10590,0.367
"4826","san benito",4826,"2021-03-30",573,24142,269,8981,210,14206,94,955,288,7700,285,8657,382,16357,"California",64022,0.13521914341945,17628,0.612,10590,0.367
"4827","san benito",4827,"2021-03-31",584,24726,357,9338,203,14409,24,979,334,7810,248,8905,358,16715,"California",64022,0.139092811845928,17628,0.612,10590,0.367
"4828","san benito",4828,"2021-04-01",933,25659,374,9712,521,14930,38,1017,557,8024,375,9280,589,17304,"California",64022,0.144950173377901,17628,0.612,10590,0.367
"4829","san benito",4829,"2021-04-02",540,26199,263,9975,142,15072,135,1152,266,8151,274,9554,401,17705,"California",64022,0.14922995220393,17628,0.612,10590,0.367
"4830","san benito",4830,"2021-04-03",252,26451,87,10062,103,15175,62,1214,74,8109,178,9732,136,17841,"California",64022,0.152010246477773,17628,0.612,10590,0.367
"4831","san benito",4831,"2021-04-04",144,26595,109,10171,30,15205,5,1219,107,8184,37,9769,112,17953,"California",64022,0.152588172815595,17628,0.612,10590,0.367
"4832","san benito",4832,"2021-04-05",351,26946,170,10341,139,15344,42,1261,143,8160,208,9977,184,18137,"California",64022,0.155837056011996,17628,0.612,10590,0.367
"4833","san benito",4833,"2021-04-06",459,27405,160,10501,124,15468,175,1436,155,8186,304,10281,330,18467,"California",64022,0.160585423760582,17628,0.612,10590,0.367
"4834","san benito",4834,"2021-04-07",922,28327,521,11022,212,15680,189,1625,254,7962,667,10948,443,18910,"California",64022,0.171003717472119,17628,0.612,10590,0.367
"4835","san benito",4835,"2021-04-08",848,29175,425,11447,173,15853,250,1875,216,7797,631,11579,466,19376,"California",64022,0.180859704476586,17628,0.612,10590,0.367
"4836","san benito",4836,"2021-04-09",836,30011,495,11942,250,16103,91,1966,287,7626,549,12128,378,19754,"California",64022,0.189434881759395,17628,0.612,10590,0.367
"4837","san benito",4837,"2021-04-10",325,30336,197,12139,71,16174,57,2023,180,7718,145,12273,237,19991,"California",64022,0.191699728218425,17628,0.612,10590,0.367
"4838","san benito",4838,"2021-04-11",470,30806,270,12409,167,16341,33,2056,263,7787,207,12480,276,20267,"California",64022,0.194932991784074,17628,0.612,10590,0.367
"4839","san benito",4839,"2021-04-12",528,31334,287,12696,129,16470,112,2168,277,7922,250,12730,385,20652,"California",64022,0.198837899472056,17628,0.612,10590,0.367
"4840","san benito",4840,"2021-04-13",757,32091,293,12989,441,16911,23,2191,528,8246,228,12958,552,21204,"California",64022,0.202399175283496,17628,0.612,10590,0.367
"4841","san benito",4841,"2021-04-14",830,32921,653,13642,177,17088,0,2191,396,8213,429,13387,396,21600,"California",64022,0.209099996876074,17628,0.612,10590,0.367
"4842","san benito",4842,"2021-04-15",940,33861,732,14374,207,17295,1,2192,467,8210,471,13858,468,22068,"California",64022,0.216456842960232,17628,0.612,10590,0.367
"4843","san benito",4843,"2021-04-16",697,34558,364,14738,324,17619,9,2201,291,8107,403,14261,300,22368,"California",64022,0.22275155415326,17628,0.612,10590,0.367
"4844","san benito",4844,"2021-04-17",316,34874,227,14965,89,17708,0,2201,129,8047,189,14450,129,22497,"California",64022,0.225703664365374,17628,0.612,10590,0.367
"4845","san benito",4845,"2021-04-18",492,35366,411,15376,81,17789,0,2201,242,8040,250,14700,243,22740,"California",64022,0.229608572053357,17628,0.612,10590,0.367
"4846","san benito",4846,"2021-04-19",727,36093,586,15962,141,17930,0,2201,411,8137,315,15015,412,23152,"California",64022,0.234528755740214,17628,0.612,10590,0.367
"4847","san benito",4847,"2021-04-20",746,36839,398,16360,347,18277,1,2202,475,8346,266,15281,475,23627,"California",64022,0.238683577520227,17628,0.612,10590,0.367
"4848","san benito",4848,"2021-04-21",954,37793,703,17063,251,18528,0,2202,522,8450,418,15699,522,24149,"California",64022,0.245212583174534,17628,0.612,10590,0.367
"4849","san benito",4849,"2021-04-22",893,38686,691,17754,202,18730,0,2202,567,8699,318,16017,567,24716,"California",64022,0.250179625753647,17628,0.612,10590,0.367
"4850","san benito",4850,"2021-04-23",625,39311,395,18149,229,18959,1,2203,339,8802,237,16254,340,25056,"California",64022,0.253881478241854,17628,0.612,10590,0.367
"4851","san benito",4851,"2021-04-24",351,39662,198,18347,153,19112,0,2203,161,8813,150,16404,161,25217,"California",64022,0.256224422854644,17628,0.612,10590,0.367
"4852","san benito",4852,"2021-04-25",199,39861,122,18469,77,19189,0,2203,88,8809,92,16496,88,25305,"California",64022,0.257661428883821,17628,0.612,10590,0.367
"4853","san benito",4853,"2021-04-26",473,40334,377,18846,96,19285,0,2203,251,8898,162,16658,251,25556,"California",64022,0.260191809065634,17628,0.612,10590,0.367
"4854","san benito",4854,"2021-04-27",526,40860,267,19113,252,19537,7,2210,397,9183,119,16777,404,25960,"California",64022,0.262050545125113,17628,0.612,10590,0.367
"4855","san benito",4855,"2021-04-28",540,41400,383,19496,148,19685,9,2219,377,9410,158,16935,385,26345,"California",64022,0.264518446783918,17628,0.612,10590,0.367
"4856","san benito",4856,"2021-04-29",621,42021,230,19726,381,20066,10,2229,249,9314,372,17307,276,26621,"California",64022,0.270328949423636,17628,0.612,10590,0.367
"4857","san benito",4857,"2021-04-30",370,42391,205,19931,158,20224,7,2236,199,9351,169,17476,206,26827,"California",64022,0.272968667020712,17628,0.612,10590,0.367
"4858","san benito",4858,"2021-05-01",193,42584,142,20073,43,20267,8,2244,65,9298,126,17602,73,26900,"California",64022,0.274936740495455,17628,0.612,10590,0.367
"4859","san benito",4859,"2021-05-02",189,42773,161,20234,24,20291,4,2248,57,9227,132,17734,61,26961,"California",64022,0.276998531754709,17628,0.612,10590,0.367
"4860","san benito",4860,"2021-05-03",357,43130,280,20514,67,20358,10,2258,83,9048,274,18008,95,27056,"California",64022,0.281278310580738,17628,0.612,10590,0.367
"4861","san benito",4861,"2021-05-04",389,43519,240,20754,142,20500,7,2265,147,8963,240,18248,155,27211,"California",64022,0.285027021961201,17628,0.612,10590,0.367
"4862","san benito",4862,"2021-05-05",593,44112,411,21165,163,20663,19,2284,200,8790,392,18640,219,27430,"California",64022,0.291149917215957,17628,0.612,10590,0.367
"4863","san benito",4863,"2021-05-06",601,44713,478,21643,107,20770,16,2300,213,8632,386,19026,228,27658,"California",64022,0.297179094686202,17628,0.612,10590,0.367
"4864","san benito",4864,"2021-05-07",436,45149,275,21918,149,20919,12,2312,164,8541,270,19296,179,27837,"California",64022,0.301396394989222,17628,0.612,10590,0.367
"4865","san benito",4865,"2021-05-08",259,45408,208,22126,45,20964,6,2318,140,8569,118,19414,146,27983,"California",64022,0.30323951141795,17628,0.612,10590,0.367
"4866","san bernardino",4866,"2020-12-15",13,13,13,13,0,0,0,0,13,13,0,0,13,13,"California",2217398,0,455859,0.542,366257,0.436
"4867","san bernardino",4867,"2020-12-16",107,120,107,120,0,0,0,0,107,120,0,0,107,120,"California",2217398,0,455859,0.542,366257,0.436
"4868","san bernardino",4868,"2020-12-17",2355,2475,2355,2475,0,0,0,0,2355,2475,0,0,2355,2475,"California",2217398,0,455859,0.542,366257,0.436
"4869","san bernardino",4869,"2020-12-18",3146,5621,3143,5618,3,3,0,0,3147,5622,0,0,3147,5622,"California",2217398,0,455859,0.542,366257,0.436
"4870","san bernardino",4870,"2020-12-19",1069,6690,1068,6686,1,4,0,0,1070,6692,0,0,1070,6692,"California",2217398,0,455859,0.542,366257,0.436
"4871","san bernardino",4871,"2020-12-20",1175,7865,1173,7859,2,6,0,0,1175,7867,0,0,1175,7867,"California",2217398,0,455859,0.542,366257,0.436
"4872","san bernardino",4872,"2020-12-21",2453,10318,2448,10307,5,11,0,0,2453,10320,0,0,2453,10320,"California",2217398,0,455859,0.542,366257,0.436
"4873","san bernardino",4873,"2020-12-22",2270,12588,2143,12450,127,138,0,0,2271,12591,0,0,2271,12591,"California",2217398,0,455859,0.542,366257,0.436
"4874","san bernardino",4874,"2020-12-23",2649,15237,1456,13906,1193,1331,0,0,2647,15238,0,0,2647,15238,"California",2217398,0,455859,0.542,366257,0.436
"4875","san bernardino",4875,"2020-12-24",1157,16394,581,14487,576,1907,0,0,1159,16397,0,0,1159,16397,"California",2217398,0,455859,0.542,366257,0.436
"4876","san bernardino",4876,"2020-12-25",75,16469,14,14501,61,1968,0,0,75,16472,0,0,75,16472,"California",2217398,0,455859,0.542,366257,0.436
"4877","san bernardino",4877,"2020-12-26",462,16931,254,14755,208,2176,0,0,462,16934,0,0,462,16934,"California",2217398,0,455859,0.542,366257,0.436
"4878","san bernardino",4878,"2020-12-27",343,17274,160,14915,183,2359,0,0,343,17277,0,0,343,17277,"California",2217398,0,455859,0.542,366257,0.436
"4879","san bernardino",4879,"2020-12-28",1569,18843,713,15628,856,3215,0,0,1570,18847,0,0,1570,18847,"California",2217398,0,455859,0.542,366257,0.436
"4880","san bernardino",4880,"2020-12-29",2210,21053,1043,16671,1167,4382,0,0,2210,21057,0,0,2210,21057,"California",2217398,0,455859,0.542,366257,0.436
"4881","san bernardino",4881,"2020-12-30",2895,23948,1459,18130,1436,5818,0,0,2896,23953,0,0,2896,23953,"California",2217398,0,455859,0.542,366257,0.436
"4882","san bernardino",4882,"2020-12-31",1357,25305,439,18569,918,6736,0,0,1355,25308,0,0,1355,25308,"California",2217398,0,455859,0.542,366257,0.436
"4883","san bernardino",4883,"2021-01-01",283,25588,151,18720,132,6868,0,0,282,25590,0,0,282,25590,"California",2217398,0,455859,0.542,366257,0.436
"4884","san bernardino",4884,"2021-01-02",476,26064,339,19059,137,7005,0,0,476,26066,0,0,476,26066,"California",2217398,0,455859,0.542,366257,0.436
"4885","san bernardino",4885,"2021-01-03",135,26199,85,19144,50,7055,0,0,135,26201,0,0,135,26201,"California",2217398,0,455859,0.542,366257,0.436
"4886","san bernardino",4886,"2021-01-04",2122,28321,1288,20432,834,7889,0,0,2121,28322,0,0,2121,28322,"California",2217398,0,455859,0.542,366257,0.436
"4887","san bernardino",4887,"2021-01-05",2336,30657,1461,21893,875,8764,0,0,2226,30439,109,109,2226,30548,"California",2217398,4.9156714311098e-05,455859,0.542,366257,0.436
"4888","san bernardino",4888,"2021-01-06",3438,34095,2353,24246,1085,9849,0,0,2943,32894,489,598,2944,33492,"California",2217398,0.000269685460165473,455859,0.542,366257,0.436
"4889","san bernardino",4889,"2021-01-07",5418,39513,4504,28750,914,10763,0,0,2485,32465,2914,3512,2485,35977,"California",2217398,0.00158383835468418,455859,0.542,366257,0.436
"4890","san bernardino",4890,"2021-01-08",5368,44881,4446,33196,922,11685,0,0,2291,31684,3073,6585,2292,38269,"California",2217398,0.00296969691503284,455859,0.542,366257,0.436
"4891","san bernardino",4891,"2021-01-09",1402,46283,1100,34296,302,11987,0,0,906,32094,496,7081,906,39175,"California",2217398,0.00319338251409986,455859,0.542,366257,0.436
"4892","san bernardino",4892,"2021-01-10",1025,47308,598,34894,427,12414,0,0,577,32223,448,7529,577,39752,"California",2217398,0.00339542111970878,455859,0.542,366257,0.436
"4893","san bernardino",4893,"2021-01-11",4982,52290,4076,38970,906,13320,0,0,2767,32778,2212,9741,2767,42519,"California",2217398,0.0043929867349028,455859,0.542,366257,0.436
"4894","san bernardino",4894,"2021-01-12",4231,56521,3218,42188,1013,14333,0,0,2517,33582,1713,11454,2517,45036,"California",2217398,0.00516551381393868,455859,0.542,366257,0.436
"4895","san bernardino",4895,"2021-01-13",4563,61084,2851,45039,1712,16045,0,0,3340,35713,1210,12664,3341,48377,"California",2217398,0.0057111984406949,455859,0.542,366257,0.436
"4896","san bernardino",4896,"2021-01-14",4789,65873,2815,47854,1974,18019,0,0,4207,39342,578,13242,4207,52584,"California",2217398,0.00597186432025284,455859,0.542,366257,0.436
"4897","san bernardino",4897,"2021-01-15",5986,71859,2978,50832,3008,21027,0,0,5589,44547,387,13629,5592,58176,"California",2217398,0.00614639320500875,455859,0.542,366257,0.436
"4898","san bernardino",4898,"2021-01-16",2261,74120,1294,52126,967,21994,0,0,2119,46524,142,13771,2119,60295,"California",2217398,0.00621043222732229,455859,0.542,366257,0.436
"4899","san bernardino",4899,"2021-01-17",1191,75311,517,52643,674,22668,0,0,1101,47538,89,13860,1103,61398,"California",2217398,0.00625056936102585,455859,0.542,366257,0.436
"4900","san bernardino",4900,"2021-01-18",4271,79582,2639,55282,1632,24300,0,0,3649,50569,621,14481,3652,65050,"California",2217398,0.00653062733889,455859,0.542,366257,0.436
"4901","san bernardino",4901,"2021-01-19",6310,85892,3709,58991,2601,26901,0,0,5218,54699,1090,15571,5220,70270,"California",2217398,0.00702219448200098,455859,0.542,366257,0.436
"4902","san bernardino",4902,"2021-01-20",6811,92703,3741,62732,3070,29971,0,0,4877,57652,1926,17497,4879,75149,"California",2217398,0.00789078009450717,455859,0.542,366257,0.436
"4903","san bernardino",4903,"2021-01-21",5984,98687,3078,65810,2906,32877,0,0,4866,61412,1109,18606,4869,80018,"California",2217398,0.00839091583919531,455859,0.542,366257,0.436
"4904","san bernardino",4904,"2021-01-22",6522,105209,3053,68863,3469,36346,0,0,5798,66489,722,19328,5799,85817,"California",2217398,0.00871652269912754,455859,0.542,366257,0.436
"4905","san bernardino",4905,"2021-01-23",3110,108319,1893,70756,1217,37563,0,0,2720,68820,389,19717,2720,88537,"California",2217398,0.00889195354194421,455859,0.542,366257,0.436
"4906","san bernardino",4906,"2021-01-24",1194,109513,461,71217,733,38296,0,0,1093,69812,101,19818,1093,89630,"California",2217398,0.00893750242401229,455859,0.542,366257,0.436
"4907","san bernardino",4907,"2021-01-25",6876,116389,3400,74617,3476,41772,0,0,5023,72988,1850,21668,5026,94656,"California",2217398,0.00977181363020982,455859,0.542,366257,0.436
"4908","san bernardino",4908,"2021-01-26",7109,123498,3570,78187,3539,45311,0,0,5012,75904,2097,23765,5013,99669,"California",2217398,0.0107175166569105,455859,0.542,366257,0.436
"4909","san bernardino",4909,"2021-01-27",8490,131988,4146,82333,4344,49655,0,0,5694,78810,2788,26553,5694,105363,"California",2217398,0.0119748461936017,455859,0.542,366257,0.436
"4910","san bernardino",4910,"2021-01-28",8593,140581,4082,86415,4511,54166,0,0,6267,82756,2321,28874,6267,111630,"California",2217398,0.0130215685231068,455859,0.542,366257,0.436
"4911","san bernardino",4911,"2021-01-29",8188,148769,3772,90187,4416,58582,0,0,6220,87023,1954,30828,6221,117851,"California",2217398,0.0139027815484636,455859,0.542,366257,0.436
"4912","san bernardino",4912,"2021-01-30",3092,151861,1900,92087,1192,59774,0,0,2804,89540,287,31115,2804,120655,"California",2217398,0.0140322125301818,455859,0.542,366257,0.436
"4913","san bernardino",4913,"2021-01-31",924,152785,494,92581,430,60204,0,0,870,90357,53,31168,870,121525,"California",2217398,0.0140561144187918,455859,0.542,366257,0.436
"4914","san bernardino",4914,"2021-02-01",7547,160332,4232,96813,3315,63519,0,0,4926,92665,2618,33786,4926,126451,"California",2217398,0.0152367775203189,455859,0.542,366257,0.436
"4915","san bernardino",4915,"2021-02-02",10423,170755,3653,100466,6770,70289,0,0,8360,98967,2059,35845,8361,134812,"California",2217398,0.0161653433438652,455859,0.542,366257,0.436
"4916","san bernardino",4916,"2021-02-03",8989,179744,4147,104613,4842,75131,0,0,6492,102971,2489,38334,6493,141305,"California",2217398,0.0172878301504737,455859,0.542,366257,0.436
"4917","san bernardino",4917,"2021-02-04",10526,190270,5199,109812,5327,80458,0,0,7419,107294,3096,41430,7419,148724,"California",2217398,0.018684061228521,455859,0.542,366257,0.436
"4918","san bernardino",4918,"2021-02-05",10998,201268,5913,115725,5085,85543,0,0,7471,111250,3516,44946,7472,156196,"California",2217398,0.0202697034993267,455859,0.542,366257,0.436
"4919","san bernardino",4919,"2021-02-06",5257,206525,2207,117932,3050,88593,0,0,3617,113255,1615,46561,3620,159816,"California",2217398,0.0209980346333856,455859,0.542,366257,0.436
"4920","san bernardino",4920,"2021-02-07",844,207369,490,118422,354,88947,0,0,466,113347,375,46936,467,160283,"California",2217398,0.021167151769777,455859,0.542,366257,0.436
"4921","san bernardino",4921,"2021-02-08",7275,214644,3878,122300,3397,92344,0,0,5607,117289,1665,48601,5607,165890,"California",2217398,0.0219180318553548,455859,0.542,366257,0.436
"4922","san bernardino",4922,"2021-02-09",9907,224551,5812,128112,4095,96439,0,0,6675,120738,3229,51830,6678,172568,"California",2217398,0.0233742431444423,455859,0.542,366257,0.436
"4923","san bernardino",4923,"2021-02-10",12015,236566,6535,134647,5480,101919,0,0,7842,124419,4162,55992,7843,180411,"California",2217398,0.0252512178688715,455859,0.542,366257,0.436
"4924","san bernardino",4924,"2021-02-11",12377,248943,7106,141753,5271,107190,0,0,7884,127836,4470,60462,7887,188298,"California",2217398,0.0272670941346569,455859,0.542,366257,0.436
"4925","san bernardino",4925,"2021-02-12",10390,259333,5934,147687,4456,111646,0,0,5678,128817,4697,65159,5678,193976,"California",2217398,0.0293853426403379,455859,0.542,366257,0.436
"4926","san bernardino",4926,"2021-02-13",6025,265358,4002,151689,2023,113669,0,0,3785,130383,2224,67383,3790,197766,"California",2217398,0.0303883200038965,455859,0.542,366257,0.436
"4927","san bernardino",4927,"2021-02-14",1549,266907,650,152339,899,114568,0,0,872,130586,669,68052,872,198638,"California",2217398,0.0306900249752187,455859,0.542,366257,0.436
"4928","san bernardino",4928,"2021-02-15",5459,272366,2994,155333,2465,117033,0,0,3056,131253,2389,70441,3056,201694,"California",2217398,0.0317674138787895,455859,0.542,366257,0.436
"4929","san bernardino",4929,"2021-02-16",12601,284967,7374,162707,5227,122260,0,0,7958,134582,4630,75071,7959,209653,"California",2217398,0.0338554467894352,455859,0.542,366257,0.436
"4930","san bernardino",4930,"2021-02-17",11786,296753,6451,169158,5335,127595,0,0,7138,137091,4631,79702,7140,216793,"California",2217398,0.0359439306791113,455859,0.542,366257,0.436
"4931","san bernardino",4931,"2021-02-18",12464,309217,7591,176749,4873,132468,0,0,7704,140051,4745,84447,7705,224498,"California",2217398,0.0380838261782504,455859,0.542,366257,0.436
"4932","san bernardino",4932,"2021-02-19",11499,320716,5933,182682,5566,138034,0,0,6805,142181,4675,89122,6805,231303,"California",2217398,0.0401921531452631,455859,0.542,366257,0.436
"4933","san bernardino",4933,"2021-02-20",4515,325231,3466,186148,1049,139083,0,0,2040,141751,2472,91594,2042,233345,"California",2217398,0.0413069733083551,455859,0.542,366257,0.436
"4934","san bernardino",4934,"2021-02-21",1039,326270,582,186730,457,139540,0,0,330,141372,709,92303,330,233675,"California",2217398,0.0416267174408924,455859,0.542,366257,0.436
"4935","san bernardino",4935,"2021-02-22",8636,334906,5324,192054,3312,142852,0,0,4033,140814,4592,96895,4034,237709,"California",2217398,0.0436976131483838,455859,0.542,366257,0.436
"4936","san bernardino",4936,"2021-02-23",9091,343997,5419,197473,3672,146524,0,0,4572,140898,4488,101383,4572,242281,"California",2217398,0.045721607036716,455859,0.542,366257,0.436
"4937","san bernardino",4937,"2021-02-24",12359,356356,7155,204628,5204,151728,0,0,6087,140739,6247,107630,6088,248369,"California",2217398,0.0485388730394814,455859,0.542,366257,0.436
"4938","san bernardino",4938,"2021-02-25",13001,369357,6267,210895,6734,158462,0,0,7562,142883,5421,113051,7565,255934,"California",2217398,0.0509836303631554,455859,0.542,366257,0.436
"4939","san bernardino",4939,"2021-02-26",13548,382905,6370,217265,7178,165640,0,0,7539,144478,5946,118997,7541,263475,"California",2217398,0.0536651516777773,455859,0.542,366257,0.436
"4940","san bernardino",4940,"2021-02-27",6630,389535,3697,220962,2932,168572,1,1,4790,147441,1828,120825,4791,268266,"California",2217398,0.0544895413453065,455859,0.542,366257,0.436
"4941","san bernardino",4941,"2021-02-28",1754,391289,726,221688,1028,169600,0,1,1130,147952,619,121444,1130,269396,"California",2217398,0.0547686973651099,455859,0.542,366257,0.436
"4942","san bernardino",4942,"2021-03-01",8413,399702,4339,226027,4072,173672,2,3,3834,147239,4557,126001,3844,273240,"California",2217398,0.0568238088065381,455859,0.542,366257,0.436
"4943","san bernardino",4943,"2021-03-02",13653,413355,5366,231393,8287,181959,0,3,6424,146467,7199,133200,6427,279667,"California",2217398,0.0600704068462225,455859,0.542,366257,0.436
"4944","san bernardino",4944,"2021-03-03",12679,426034,6442,237835,6234,188193,3,6,5875,145567,6784,139984,5884,285551,"California",2217398,0.0631298485883003,455859,0.542,366257,0.436
"4945","san bernardino",4945,"2021-03-04",13683,439717,6863,244698,6820,195013,0,6,5950,143808,7712,147696,5953,291504,"California",2217398,0.0666077988705681,455859,0.542,366257,0.436
"4946","san bernardino",4946,"2021-03-05",14213,453930,7370,252068,6842,201855,1,7,6889,143422,7294,154990,6908,298412,"California",2217398,0.0698972399181383,455859,0.542,366257,0.436
"4947","san bernardino",4947,"2021-03-06",9652,463582,5401,257469,4036,205891,215,222,4526,143050,5111,160101,4739,303151,"California",2217398,0.0722021937423954,455859,0.542,366257,0.436
"4948","san bernardino",4948,"2021-03-07",1572,465154,928,258397,589,206480,55,277,1001,143537,569,160670,1056,304207,"California",2217398,0.0724588008106799,455859,0.542,366257,0.436
"4949","san bernardino",4949,"2021-03-08",7998,473152,3507,261904,4331,210811,160,437,3526,142762,4465,165135,3690,307897,"California",2217398,0.0744724221813134,455859,0.542,366257,0.436
"4950","san bernardino",4950,"2021-03-09",12606,485758,7035,268939,5327,216138,244,681,4859,140132,7734,172869,5104,313001,"California",2217398,0.0779602940022495,455859,0.542,366257,0.436
"4951","san bernardino",4951,"2021-03-10",14018,499776,7686,276625,5783,221921,549,1230,6197,139088,7794,180663,6750,319751,"California",2217398,0.0814752245650082,455859,0.542,366257,0.436
"4952","san bernardino",4952,"2021-03-11",15254,515030,7131,283756,6539,228460,1584,2814,7264,139963,7969,188632,8844,328595,"California",2217398,0.0850690764580829,455859,0.542,366257,0.436
"4953","san bernardino",4953,"2021-03-12",15281,530311,6817,290573,6421,234881,2043,4857,7284,141368,7968,196600,9373,337968,"California",2217398,0.0886624773721272,455859,0.542,366257,0.436
"4954","san bernardino",4954,"2021-03-13",8276,538587,4494,295067,3271,238152,511,5368,4898,143412,3367,199967,5411,343379,"California",2217398,0.0901809237674067,455859,0.542,366257,0.436
"4955","san bernardino",4955,"2021-03-14",3221,541808,1615,296682,1032,239184,574,5942,1839,144443,1376,201343,2407,345786,"California",2217398,0.0908014709132055,455859,0.542,366257,0.436
"4956","san bernardino",4956,"2021-03-15",11336,553144,5333,302015,3972,243156,2031,7973,5552,146248,5771,207114,7576,353362,"California",2217398,0.0934040708975114,455859,0.542,366257,0.436
"4957","san bernardino",4957,"2021-03-16",16098,569242,7987,310002,7166,250322,945,8918,9838,150793,6234,213348,10779,364141,"California",2217398,0.0962154741728819,455859,0.542,366257,0.436
"4958","san bernardino",4958,"2021-03-17",17098,586340,8589,318591,7760,258082,749,9667,10296,155054,6785,220133,11046,375187,"California",2217398,0.0992753668939902,455859,0.542,366257,0.436
"4959","san bernardino",4959,"2021-03-18",16508,602848,8190,326781,7934,266016,384,10051,9785,158525,6697,226830,10168,385355,"California",2217398,0.102295573460425,455859,0.542,366257,0.436
"4960","san bernardino",4960,"2021-03-19",16828,619676,8337,335118,7903,273919,588,10639,9657,161676,7147,233977,10298,395653,"California",2217398,0.10551872059053,455859,0.542,366257,0.436
"4961","san bernardino",4961,"2021-03-20",9386,629062,5914,341032,2885,276804,587,11226,5568,164033,3794,237771,6151,401804,"California",2217398,0.10722973503178,455859,0.542,366257,0.436
"4962","san bernardino",4962,"2021-03-21",2758,631820,2242,343274,468,277272,48,11274,2228,165791,518,238289,2276,404080,"California",2217398,0.107463342169516,455859,0.542,366257,0.436
"4963","san bernardino",4963,"2021-03-22",9575,641395,4495,347769,4645,281917,435,11709,6940,170549,2617,240906,7375,411455,"California",2217398,0.108643554292013,455859,0.542,366257,0.436
"4964","san bernardino",4964,"2021-03-23",15446,656841,8760,356529,6065,287982,621,12330,9669,175081,5756,246662,10288,421743,"California",2217398,0.111239389590863,455859,0.542,366257,0.436
"4965","san bernardino",4965,"2021-03-24",15014,671855,7777,364306,6936,294918,301,12631,9990,180384,4989,251651,10292,432035,"California",2217398,0.113489323973414,455859,0.542,366257,0.436
"4966","san bernardino",4966,"2021-03-25",16949,688804,8301,372607,8351,303269,297,12928,10769,185315,6131,257782,11062,443097,"California",2217398,0.116254276408656,455859,0.542,366257,0.436
"4967","san bernardino",4967,"2021-03-26",17956,706760,8589,381196,8600,311869,767,13695,10913,189982,7013,264795,11680,454777,"California",2217398,0.11941699234869,455859,0.542,366257,0.436
"4968","san bernardino",4968,"2021-03-27",10737,717497,6907,388103,3080,314949,750,14445,6160,192331,4560,269355,6909,461686,"California",2217398,0.121473456727209,455859,0.542,366257,0.436
"4969","san bernardino",4969,"2021-03-28",3537,721034,2472,390575,952,315901,113,14558,2497,193908,1033,270388,2610,464296,"California",2217398,0.121939318065589,455859,0.542,366257,0.436
"4970","san bernardino",4970,"2021-03-29",11693,732727,6072,396647,5224,321125,397,14955,7974,198577,3702,274090,8371,472667,"California",2217398,0.123608842436044,455859,0.542,366257,0.436
"4971","san bernardino",4971,"2021-03-30",16863,749590,9423,406070,6730,327855,710,15665,10857,204163,5973,280063,11559,484226,"California",2217398,0.126302540184487,455859,0.542,366257,0.436
"4972","san bernardino",4972,"2021-03-31",16243,765833,9155,415225,6457,334312,631,16296,10880,210336,5337,285400,11510,495736,"California",2217398,0.128709415269609,455859,0.542,366257,0.436
"4973","san bernardino",4973,"2021-04-01",19446,785279,10252,425477,7835,342147,1359,17655,12542,217364,6866,292266,13894,509630,"California",2217398,0.131805837292178,455859,0.542,366257,0.436
"4974","san bernardino",4974,"2021-04-02",18617,803896,9346,434823,7999,350146,1272,18927,11276,222635,7317,299583,12588,522218,"California",2217398,0.135105650857446,455859,0.542,366257,0.436
"4975","san bernardino",4975,"2021-04-03",10972,814868,6847,441670,3001,353147,1124,20051,6012,224829,4944,304527,7138,529356,"California",2217398,0.137335291183631,455859,0.542,366257,0.436
"4976","san bernardino",4976,"2021-04-04",2453,817321,1489,443159,716,353863,248,20299,1250,225129,1198,305725,1498,530854,"California",2217398,0.137875564062022,455859,0.542,366257,0.436
"4977","san bernardino",4977,"2021-04-05",11719,829040,5264,448423,4728,358591,1727,22026,6004,227157,5696,311421,7724,538578,"California",2217398,0.14044434061905,455859,0.542,366257,0.436
"4978","san bernardino",4978,"2021-04-06",19638,848678,11045,459468,6490,365081,2103,24129,10433,230519,9169,320590,12531,551109,"California",2217398,0.144579367348577,455859,0.542,366257,0.436
"4979","san bernardino",4979,"2021-04-07",20798,869476,11128,470596,7210,372291,2460,26589,11392,234981,9378,329968,13840,564949,"California",2217398,0.148808648695453,455859,0.542,366257,0.436
"4980","san bernardino",4980,"2021-04-08",21595,891071,11069,481665,7936,380227,2590,29179,11955,239905,9613,339581,14537,579486,"California",2217398,0.153143910114467,455859,0.542,366257,0.436
"4981","san bernardino",4981,"2021-04-09",21525,912596,10901,492566,8080,388307,2544,31723,11744,244437,9746,349327,14278,593764,"California",2217398,0.157539151744522,455859,0.542,366257,0.436
"4982","san bernardino",4982,"2021-04-10",15561,928157,8059,500625,3811,392118,3691,35414,7742,248060,7799,357126,11422,605186,"California",2217398,0.161056337202433,455859,0.542,366257,0.436
"4983","san bernardino",4983,"2021-04-11",4399,932556,2566,503191,883,393001,950,36364,2038,248691,2354,359480,2985,608171,"California",2217398,0.16211794183994,455859,0.542,366257,0.436
"4984","san bernardino",4984,"2021-04-12",13328,945884,6177,509368,5513,398514,1638,38002,6323,249662,6985,366465,7956,616127,"California",2217398,0.165268030367124,455859,0.542,366257,0.436
"4985","san bernardino",4985,"2021-04-13",19181,965065,10937,520305,8226,406740,18,38020,10993,252509,8165,374630,11012,627139,"California",2217398,0.168950274150153,455859,0.542,366257,0.436
"4986","san bernardino",4986,"2021-04-14",18960,984025,10245,530550,8712,415452,3,38023,10836,255254,8095,382725,10840,637979,"California",2217398,0.172600949401055,455859,0.542,366257,0.436
"4987","san bernardino",4987,"2021-04-15",20125,1004150,11297,541847,8823,424275,5,38028,10740,256652,9350,392075,10748,648727,"California",2217398,0.17681760333508,455859,0.542,366257,0.436
"4988","san bernardino",4988,"2021-04-16",18461,1022611,10519,552366,7941,432216,1,38029,9136,256503,9285,401360,9136,657863,"California",2217398,0.181004943632131,455859,0.542,366257,0.436
"4989","san bernardino",4989,"2021-04-17",11874,1034485,7823,560189,4051,436267,0,38029,6257,257173,5587,406947,6257,664120,"California",2217398,0.183524563474848,455859,0.542,366257,0.436
"4990","san bernardino",4990,"2021-04-18",2874,1037359,1971,562160,903,437170,0,38029,1313,256934,1552,408499,1313,665433,"California",2217398,0.184224482929993,455859,0.542,366257,0.436
"4991","san bernardino",4991,"2021-04-19",12451,1049810,6616,568776,5835,443005,0,38029,4839,254186,7591,416090,4843,670276,"California",2217398,0.187647864749585,455859,0.542,366257,0.436
"4992","san bernardino",4992,"2021-04-20",17513,1067323,9751,578527,7759,450764,3,38032,8021,252739,9471,425561,8024,678300,"California",2217398,0.191919087146286,455859,0.542,366257,0.436
"4993","san bernardino",4993,"2021-04-21",17966,1085289,10294,588821,7670,458434,2,38034,7990,250811,9920,435481,7992,686292,"California",2217398,0.196392799127626,455859,0.542,366257,0.436
"4994","san bernardino",4994,"2021-04-22",19085,1104374,10899,599720,8182,466616,4,38038,7842,247463,11194,446675,7846,694138,"California",2217398,0.201441058393667,455859,0.542,366257,0.436
"4995","san bernardino",4995,"2021-04-23",18371,1122745,10515,610235,7855,474471,1,38039,8106,245353,10219,456894,8109,702247,"California",2217398,0.20604961310509,455859,0.542,366257,0.436
"4996","san bernardino",4996,"2021-04-24",12773,1135518,9456,619691,3315,477786,2,38041,6885,246369,5871,462765,6887,709134,"California",2217398,0.208697310992433,455859,0.542,366257,0.436
"4997","san bernardino",4997,"2021-04-25",3405,1138923,2234,621925,1171,478957,0,38041,1688,246355,1703,464468,1689,710823,"California",2217398,0.209465328281166,455859,0.542,366257,0.436
"4998","san bernardino",4998,"2021-04-26",10044,1148967,5318,627243,4637,483594,89,38130,4294,245020,5717,470185,4382,715205,"California",2217398,0.212043575397831,455859,0.542,366257,0.436
"4999","san bernardino",4999,"2021-04-27",15406,1164373,9182,636425,6056,489650,168,38298,6256,242332,9112,479297,6424,721629,"California",2217398,0.216152896322627,455859,0.542,366257,0.436
"5000","san bernardino",5000,"2021-04-28",14624,1178997,8686,645111,5668,495318,270,38568,5259,238518,9334,488631,5520,727149,"California",2217398,0.220362334592166,455859,0.542,366257,0.436
"5001","san bernardino",5001,"2021-04-29",16054,1195051,9256,654367,6530,501848,268,38836,5329,233430,10683,499314,5595,732744,"California",2217398,0.225180143573684,455859,0.542,366257,0.436
"5002","san bernardino",5002,"2021-04-30",16478,1211529,10422,664789,5776,507624,280,39116,6044,229367,10384,509698,6321,739065,"California",2217398,0.229863109825119,455859,0.542,366257,0.436
"5003","san bernardino",5003,"2021-05-01",10676,1222205,8390,673179,1978,509602,308,39424,3645,226322,6995,516693,3950,743015,"California",2217398,0.233017708142607,455859,0.542,366257,0.436
"5004","san bernardino",5004,"2021-05-02",2915,1225120,2112,675291,672,510274,131,39555,1039,225623,1869,518562,1170,744185,"California",2217398,0.233860587950381,455859,0.542,366257,0.436
"5005","san bernardino",5005,"2021-05-03",9926,1235046,5736,681027,3792,514066,398,39953,2824,221770,7074,525636,3221,747406,"California",2217398,0.237050813611269,455859,0.542,366257,0.436
"5006","san bernardino",5006,"2021-05-04",15592,1250638,9473,690500,5666,519732,453,40406,4509,215687,11043,536679,4960,752366,"California",2217398,0.242030975043722,455859,0.542,366257,0.436
"5007","san bernardino",5007,"2021-05-05",12846,1263484,7765,698265,4697,524429,384,40790,3608,210481,9195,545874,3989,756355,"California",2217398,0.246177727228039,455859,0.542,366257,0.436
"5008","san bernardino",5008,"2021-05-06",12928,1276412,7742,706007,4789,529218,397,41187,3551,205087,9340,555214,3946,760301,"California",2217398,0.250389871371761,455859,0.542,366257,0.436
"5009","san bernardino",5009,"2021-05-07",12883,1289295,7502,713509,5032,534250,349,41536,3777,200157,9055,564269,4125,764426,"California",2217398,0.254473486491825,455859,0.542,366257,0.436
"5010","san bernardino",5010,"2021-05-08",7477,1296772,5082,718591,2176,536426,219,41755,2527,197980,4921,569190,2744,767170,"California",2217398,0.256692754300311,455859,0.542,366257,0.436
"5011","san diego",5011,"2020-12-15",119,119,119,119,0,0,0,0,119,119,0,0,119,119,"California",3370418,0,964650,0.602,600094,0.375
"5012","san diego",5012,"2020-12-16",1103,1222,1103,1222,0,0,0,0,1103,1222,0,0,1103,1222,"California",3370418,0,964650,0.602,600094,0.375
"5013","san diego",5013,"2020-12-17",2349,3571,2349,3571,0,0,0,0,2349,3571,0,0,2349,3571,"California",3370418,0,964650,0.602,600094,0.375
"5014","san diego",5014,"2020-12-18",3671,7242,3670,7241,1,1,0,0,3671,7242,0,0,3671,7242,"California",3370418,0,964650,0.602,600094,0.375
"5015","san diego",5015,"2020-12-19",2311,9553,2311,9552,0,1,0,0,2311,9553,0,0,2311,9553,"California",3370418,0,964650,0.602,600094,0.375
"5016","san diego",5016,"2020-12-20",1184,10737,1183,10735,1,2,0,0,1184,10737,0,0,1184,10737,"California",3370418,0,964650,0.602,600094,0.375
"5017","san diego",5017,"2020-12-21",3524,14261,3523,14258,1,3,0,0,3524,14261,0,0,3524,14261,"California",3370418,0,964650,0.602,600094,0.375
"5018","san diego",5018,"2020-12-22",4058,18319,3415,17673,643,646,0,0,4058,18319,0,0,4058,18319,"California",3370418,0,964650,0.602,600094,0.375
"5019","san diego",5019,"2020-12-23",3180,21499,1977,19650,1203,1849,0,0,3180,21499,0,0,3180,21499,"California",3370418,0,964650,0.602,600094,0.375
"5020","san diego",5020,"2020-12-24",2738,24237,2220,21870,518,2367,0,0,2738,24237,0,0,2738,24237,"California",3370418,0,964650,0.602,600094,0.375
"5021","san diego",5021,"2020-12-25",875,25112,874,22744,1,2368,0,0,875,25112,0,0,875,25112,"California",3370418,0,964650,0.602,600094,0.375
"5022","san diego",5022,"2020-12-26",3295,28407,2144,24888,1151,3519,0,0,3295,28407,0,0,3295,28407,"California",3370418,0,964650,0.602,600094,0.375
"5023","san diego",5023,"2020-12-27",2507,30914,1617,26505,890,4409,0,0,2506,30912,1,1,2506,30913,"California",3370418,2.96699103790687e-07,964650,0.602,600094,0.375
"5024","san diego",5024,"2020-12-28",5901,36815,4214,30719,1687,6096,0,0,5901,36813,0,1,5901,36814,"California",3370418,2.96699103790687e-07,964650,0.602,600094,0.375
"5025","san diego",5025,"2020-12-29",5590,42405,3016,33735,2574,8670,0,0,5590,42403,0,1,5590,42404,"California",3370418,2.96699103790687e-07,964650,0.602,600094,0.375
"5026","san diego",5026,"2020-12-30",5953,48358,3108,36843,2845,11515,0,0,5953,48356,0,1,5953,48357,"California",3370418,2.96699103790687e-07,964650,0.602,600094,0.375
"5027","san diego",5027,"2020-12-31",3036,51394,1053,37896,1983,13498,0,0,3036,51392,0,1,3036,51393,"California",3370418,2.96699103790687e-07,964650,0.602,600094,0.375
"5028","san diego",5028,"2021-01-01",1006,52400,452,38348,554,14052,0,0,1006,52398,0,1,1006,52399,"California",3370418,2.96699103790687e-07,964650,0.602,600094,0.375
"5029","san diego",5029,"2021-01-02",3762,56162,1320,39668,2442,16494,0,0,3762,56160,0,1,3762,56161,"California",3370418,2.96699103790687e-07,964650,0.602,600094,0.375
"5030","san diego",5030,"2021-01-03",859,57021,632,40300,227,16721,0,0,858,57018,0,1,858,57019,"California",3370418,2.96699103790687e-07,964650,0.602,600094,0.375
"5031","san diego",5031,"2021-01-04",3704,60725,2052,42352,1652,18373,0,0,3697,60715,0,1,3697,60716,"California",3370418,2.96699103790687e-07,964650,0.602,600094,0.375
"5032","san diego",5032,"2021-01-05",4342,65067,2153,44505,2189,20562,0,0,3726,63841,612,613,3738,64454,"California",3370418,0.000181876550623691,964650,0.602,600094,0.375
"5033","san diego",5033,"2021-01-06",4958,70025,2302,46807,2656,23218,0,0,3723,66356,1212,1825,3727,68181,"California",3370418,0.000541475864418004,964650,0.602,600094,0.375
"5034","san diego",5034,"2021-01-07",5663,75688,2982,49789,2681,25899,0,0,3505,67716,2151,3976,3511,71692,"California",3370418,0.00117967563667177,964650,0.602,600094,0.375
"5035","san diego",5035,"2021-01-08",7884,83572,4957,54746,2927,28826,0,0,4098,68061,3769,7745,4114,75806,"California",3370418,0.00229793455885887,964650,0.602,600094,0.375
"5036","san diego",5036,"2021-01-09",3501,87073,1940,56686,1561,30387,0,0,1951,68485,1538,9283,1962,77768,"California",3370418,0.00275425778048895,964650,0.602,600094,0.375
"5037","san diego",5037,"2021-01-10",1882,88955,1293,57979,589,30976,0,0,780,68184,1090,10373,789,78557,"California",3370418,0.0030776598036208,964650,0.602,600094,0.375
"5038","san diego",5038,"2021-01-11",10335,99290,5863,63842,4472,35448,0,0,6805,71484,3523,13896,6823,85380,"California",3370418,0.00412293074627539,964650,0.602,600094,0.375
"5039","san diego",5039,"2021-01-12",11206,110496,5319,69161,5887,41335,0,0,7830,76060,3367,17263,7943,93323,"California",3370418,0.00512191662873863,964650,0.602,600094,0.375
"5040","san diego",5040,"2021-01-13",11488,121984,5033,74194,6455,47790,0,0,8942,82493,2533,19796,8966,102289,"California",3370418,0.00587345545864044,964650,0.602,600094,0.375
"5041","san diego",5041,"2021-01-14",12369,134353,4753,78947,7616,55406,0,0,10200,90568,2160,21956,10235,112524,"California",3370418,0.00651432552282833,964650,0.602,600094,0.375
"5042","san diego",5042,"2021-01-15",15134,149487,5356,84303,9778,65184,0,0,12490,100487,2625,24581,12544,125068,"California",3370418,0.00729316067027888,964650,0.602,600094,0.375
"5043","san diego",5043,"2021-01-16",10770,160257,3595,87898,7175,72359,0,0,9324,108401,1441,26022,9355,134423,"California",3370418,0.00772070407884126,964650,0.602,600094,0.375
"5044","san diego",5044,"2021-01-17",8685,168942,2502,90400,6183,78542,0,0,7846,115427,839,26861,7865,142288,"California",3370418,0.00796963462692165,964650,0.602,600094,0.375
"5045","san diego",5045,"2021-01-18",12525,181467,5965,96365,6560,85102,0,0,9692,122381,2794,29655,9748,152036,"California",3370418,0.00879861192291283,964650,0.602,600094,0.375
"5046","san diego",5046,"2021-01-19",14764,196231,5833,102198,8931,94033,0,0,11631,131152,3120,32775,11891,163927,"California",3370418,0.00972431312673977,964650,0.602,600094,0.375
"5047","san diego",5047,"2021-01-20",18332,214563,6391,108589,11941,105974,0,0,15009,143034,3302,36077,15184,179111,"California",3370418,0.0107040135674566,964650,0.602,600094,0.375
"5048","san diego",5048,"2021-01-21",17422,231985,5908,114497,11514,117488,0,0,16028,157827,1383,37460,16176,195287,"California",3370418,0.0111143484279991,964650,0.602,600094,0.375
"5049","san diego",5049,"2021-01-22",17677,249662,4759,119256,12918,130406,0,0,15623,171512,2040,39500,15725,211012,"California",3370418,0.0117196145997321,964650,0.602,600094,0.375
"5050","san diego",5050,"2021-01-23",14482,264144,5273,124529,9209,139615,0,0,12120,181339,2350,41850,12177,223189,"California",3370418,0.0124168574936403,964650,0.602,600094,0.375
"5051","san diego",5051,"2021-01-24",11915,276059,3357,127886,8558,148173,0,0,10944,191350,969,42819,10980,234169,"California",3370418,0.0127043589252134,964650,0.602,600094,0.375
"5052","san diego",5052,"2021-01-25",12266,288325,5795,133681,6471,154644,0,0,9248,197742,3011,45830,9403,243572,"California",3370418,0.0135977199267272,964650,0.602,600094,0.375
"5053","san diego",5053,"2021-01-26",14957,303282,7660,141341,7297,161941,0,0,11644,206265,3308,49138,11831,255403,"California",3370418,0.0145792005620668,964650,0.602,600094,0.375
"5054","san diego",5054,"2021-01-27",20767,324049,8131,149472,12636,174577,0,0,17671,220997,3082,52220,17814,273217,"California",3370418,0.0154936271999497,964650,0.602,600094,0.375
"5055","san diego",5055,"2021-01-28",21307,345356,7650,157122,13657,188234,0,0,19040,237860,2257,54477,19120,292337,"California",3370418,0.0161632770772053,964650,0.602,600094,0.375
"5056","san diego",5056,"2021-01-29",19712,365068,6468,163590,13244,201478,0,0,17287,252775,2415,56892,17330,309667,"California",3370418,0.0168798054128598,964650,0.602,600094,0.375
"5057","san diego",5057,"2021-01-30",15905,380973,3667,167257,12238,213716,0,0,13224,263424,2671,59563,13320,322987,"California",3370418,0.0176722887190847,964650,0.602,600094,0.375
"5058","san diego",5058,"2021-01-31",14802,395775,5755,173012,9047,222763,0,0,14441,277538,357,59920,14471,337458,"California",3370418,0.017778210299138,964650,0.602,600094,0.375
"5059","san diego",5059,"2021-02-01",20537,416312,7242,180254,13295,236058,0,0,17342,291775,3181,63101,17418,354876,"California",3370418,0.0187220101482961,964650,0.602,600094,0.375
"5060","san diego",5060,"2021-02-02",23218,439530,8701,188955,14517,250575,0,0,19671,308077,3537,66638,19839,374715,"California",3370418,0.0197714348784038,964650,0.602,600094,0.375
"5061","san diego",5061,"2021-02-03",27459,466989,11564,200519,15895,266470,0,0,23265,327353,4176,70814,23452,398167,"California",3370418,0.0210104503358337,964650,0.602,600094,0.375
"5062","san diego",5062,"2021-02-04",24386,491375,10031,210550,14355,280825,0,0,19670,342605,4698,75512,19950,418117,"California",3370418,0.0224043427254424,964650,0.602,600094,0.375
"5063","san diego",5063,"2021-02-05",25033,516408,8992,219542,16041,296866,0,0,18325,354691,6684,82196,18770,436887,"California",3370418,0.0243874795351793,964650,0.602,600094,0.375
"5064","san diego",5064,"2021-02-06",20795,537203,8569,228111,12226,309092,0,0,17528,369179,3261,85457,17749,454636,"California",3370418,0.0253550153126407,964650,0.602,600094,0.375
"5065","san diego",5065,"2021-02-07",12136,549339,5377,233488,6759,315851,0,0,10260,377841,1856,87313,10518,465154,"California",3370418,0.0259056888492763,964650,0.602,600094,0.375
"5066","san diego",5066,"2021-02-08",20111,569450,8520,242008,11591,327442,0,0,12677,383782,7416,94729,13357,478511,"California",3370418,0.028106009402988,964650,0.602,600094,0.375
"5067","san diego",5067,"2021-02-09",20419,589869,8256,250264,12163,339605,0,0,13203,390857,7196,101925,14271,492782,"California",3370418,0.0302410561538658,964650,0.602,600094,0.375
"5068","san diego",5068,"2021-02-10",23027,612896,9388,259652,13639,353244,0,0,13872,396996,9097,111022,15236,508018,"California",3370418,0.0329401279010497,964650,0.602,600094,0.375
"5069","san diego",5069,"2021-02-11",23816,636712,10157,269809,13659,366903,0,0,12749,400389,11037,122059,14430,522448,"California",3370418,0.0362147959095875,964650,0.602,600094,0.375
"5070","san diego",5070,"2021-02-12",23860,660572,7469,277278,16391,383294,0,0,11912,402634,11930,133989,14175,536623,"California",3370418,0.0397544162178104,964650,0.602,600094,0.375
"5071","san diego",5071,"2021-02-13",20053,680625,9044,286322,11009,394303,0,0,10920,405624,9125,143114,12115,548738,"California",3370418,0.0424617955399004,964650,0.602,600094,0.375
"5072","san diego",5072,"2021-02-14",11188,691813,7432,293754,3756,398059,0,0,6329,408609,4855,147969,7840,556578,"California",3370418,0.0439022696888042,964650,0.602,600094,0.375
"5073","san diego",5073,"2021-02-15",15279,707092,7769,301523,7510,405569,0,0,7847,412110,7410,155379,10911,567489,"California",3370418,0.0461008100478932,964650,0.602,600094,0.375
"5074","san diego",5074,"2021-02-16",19287,726379,11257,312780,8030,413599,0,0,9238,414282,10036,165415,12208,579697,"California",3370418,0.0490784822535365,964650,0.602,600094,0.375
"5075","san diego",5075,"2021-02-17",23405,749784,10989,323769,12416,426015,0,0,8131,410235,15260,180675,11213,590910,"California",3370418,0.0536061105773824,964650,0.602,600094,0.375
"5076","san diego",5076,"2021-02-18",23586,773370,12024,335793,11562,437577,0,0,7794,406322,15781,196456,11868,602778,"California",3370418,0.0582883191343032,964650,0.602,600094,0.375
"5077","san diego",5077,"2021-02-19",15917,789287,10924,346717,4993,442570,0,0,6634,405667,9265,205721,8610,611388,"California",3370418,0.0610372363309239,964650,0.602,600094,0.375
"5078","san diego",5078,"2021-02-20",10265,799552,6367,353084,3898,446468,0,0,5815,408938,4447,210168,7718,619106,"California",3370418,0.0623566572454811,964650,0.602,600094,0.375
"5079","san diego",5079,"2021-02-21",11547,811099,10134,363218,1413,447881,0,0,5190,409310,6327,216495,6699,625805,"California",3370418,0.0642338724751648,964650,0.602,600094,0.375
"5080","san diego",5080,"2021-02-22",12453,823552,10592,373810,1861,449742,0,0,5795,410091,6650,223145,7431,633236,"California",3370418,0.0662069215153729,964650,0.602,600094,0.375
"5081","san diego",5081,"2021-02-23",25901,849453,14527,388337,11374,461116,0,0,9658,409405,16235,239380,15549,648785,"California",3370418,0.0710238314654147,964650,0.602,600094,0.375
"5082","san diego",5082,"2021-02-24",28953,878406,12763,401100,16190,477306,0,0,6859,401623,22072,261452,14290,663075,"California",3370418,0.0775725740842827,964650,0.602,600094,0.375
"5083","san diego",5083,"2021-02-25",33198,911604,14724,415824,18474,495780,0,0,10163,397147,23015,284467,18539,681614,"California",3370418,0.0844011039580254,964650,0.602,600094,0.375
"5084","san diego",5084,"2021-02-26",33473,945077,12405,428229,21068,516848,0,0,12145,395070,21299,305766,19222,700836,"California",3370418,0.0907204981696632,964650,0.602,600094,0.375
"5085","san diego",5085,"2021-02-27",21239,966316,9679,437908,11560,528408,0,0,11447,400988,9787,315553,15705,716541,"California",3370418,0.0936242922984627,964650,0.602,600094,0.375
"5086","san diego",5086,"2021-02-28",15265,981581,9967,447875,5298,533706,0,0,9507,407526,5757,321310,12295,728836,"California",3370418,0.0953323890389857,964650,0.602,600094,0.375
"5087","san diego",5087,"2021-03-01",24245,1005826,14315,462190,9928,543634,2,2,14736,416681,9433,330743,18588,747424,"California",3370418,0.0981311516850432,964650,0.602,600094,0.375
"5088","san diego",5088,"2021-03-02",26157,1031983,14075,476265,12082,555716,0,2,12758,422733,13389,344132,19441,766865,"California",3370418,0.102103655985697,964650,0.602,600094,0.375
"5089","san diego",5089,"2021-03-03",33997,1065980,15918,492183,18076,573792,3,5,14066,423787,19910,364042,20964,787829,"California",3370418,0.108010935142169,964650,0.602,600094,0.375
"5090","san diego",5090,"2021-03-04",28323,1094303,14109,506292,14214,588006,0,5,12656,427527,15645,379687,19385,807214,"California",3370418,0.112652792620975,964650,0.602,600094,0.375
"5091","san diego",5091,"2021-03-05",28933,1123236,14833,521125,14018,602024,82,87,13474,432333,15436,395123,20242,827456,"California",3370418,0.117232639987088,964650,0.602,600094,0.375
"5092","san diego",5092,"2021-03-06",23365,1146601,9527,530652,13138,615162,700,787,10296,434936,13055,408178,15658,843114,"California",3370418,0.121106046787075,964650,0.602,600094,0.375
"5093","san diego",5093,"2021-03-07",18206,1164807,9298,539950,8337,623499,571,1358,6903,434766,11295,419473,11125,854239,"California",3370418,0.124457263164391,964650,0.602,600094,0.375
"5094","san diego",5094,"2021-03-08",23099,1187906,11228,551178,10971,634470,900,2258,11454,440363,11625,431098,17222,871461,"California",3370418,0.127906390245958,964650,0.602,600094,0.375
"5095","san diego",5095,"2021-03-09",25893,1213799,11981,563159,12157,646627,1755,4013,10130,440418,15751,446849,15806,887267,"California",3370418,0.132579697829765,964650,0.602,600094,0.375
"5096","san diego",5096,"2021-03-10",25302,1239101,10774,573933,12133,658760,2395,6408,9913,441410,15373,462222,16365,903632,"California",3370418,0.137140853152339,964650,0.602,600094,0.375
"5097","san diego",5097,"2021-03-11",28707,1267808,11032,584965,14077,672837,3598,10006,10038,440356,18646,480868,17592,921224,"California",3370418,0.14267310464162,964650,0.602,600094,0.375
"5098","san diego",5098,"2021-03-12",27077,1294885,9456,594421,14485,687322,3136,13142,9968,439893,17094,497962,16631,937855,"California",3370418,0.147744879121818,964650,0.602,600094,0.375
"5099","san diego",5099,"2021-03-13",26165,1321050,7301,601722,17075,704397,1789,14931,10078,439845,16084,514046,16036,953891,"California",3370418,0.152516987507188,964650,0.602,600094,0.375
"5100","san diego",5100,"2021-03-14",13770,1334820,5424,607146,7609,712006,737,15668,4789,438719,8973,523019,7847,961738,"California",3370418,0.155179268565501,964650,0.602,600094,0.375
"5101","san diego",5101,"2021-03-15",22026,1356846,10168,617314,11079,723085,779,16447,9032,438639,12978,535997,12898,974636,"California",3370418,0.159029829534497,964650,0.602,600094,0.375
"5102","san diego",5102,"2021-03-16",30008,1386854,15793,633107,13801,736886,414,16861,15750,443609,14235,550232,19205,993841,"California",3370418,0.163253341276957,964650,0.602,600094,0.375
"5103","san diego",5103,"2021-03-17",26320,1413174,12215,645322,13386,750272,719,17580,16772,453613,9533,559765,19537,1013378,"California",3370418,0.166081773833394,964650,0.602,600094,0.375
"5104","san diego",5104,"2021-03-18",31500,1444674,17796,663118,12793,763065,911,18491,17017,458618,14451,574216,19456,1032834,"California",3370418,0.170369372582273,964650,0.602,600094,0.375
"5105","san diego",5105,"2021-03-19",30258,1474932,14362,677480,14897,777962,999,19490,19361,469284,10879,585095,21545,1054379,"California",3370418,0.173597162132412,964650,0.602,600094,0.375
"5106","san diego",5106,"2021-03-20",27851,1502783,8429,685909,17628,795590,1794,21284,21402,487144,6438,591533,24298,1078677,"California",3370418,0.175507310962617,964650,0.602,600094,0.375
"5107","san diego",5107,"2021-03-21",16534,1519317,12056,697965,3761,799351,717,22001,7699,488051,8821,600354,9728,1088405,"California",3370418,0.178124493757154,964650,0.602,600094,0.375
"5108","san diego",5108,"2021-03-22",22517,1541834,13148,711113,9120,808471,249,22250,14338,497219,8167,608521,17335,1105740,"California",3370418,0.180547635337813,964650,0.602,600094,0.375
"5109","san diego",5109,"2021-03-23",25985,1567819,13642,724755,12080,820551,263,22513,17157,507841,8813,617334,19435,1125175,"California",3370418,0.18316244453952,964650,0.602,600094,0.375
"5110","san diego",5110,"2021-03-24",29546,1597365,19759,744514,9423,829974,364,22877,17122,514959,12415,629749,19533,1144708,"California",3370418,0.186845963913081,964650,0.602,600094,0.375
"5111","san diego",5111,"2021-03-25",30319,1627684,18283,762797,11378,841352,658,23535,17987,523395,12315,642064,20751,1165459,"California",3370418,0.190499813376264,964650,0.602,600094,0.375
"5112","san diego",5112,"2021-03-26",32094,1659778,17907,780704,13630,854982,557,24092,17560,529818,14508,656572,20931,1186390,"California",3370418,0.194804323974059,964650,0.602,600094,0.375
"5113","san diego",5113,"2021-03-27",25446,1685224,10993,791697,14060,869042,393,24485,15725,538463,9705,666277,18350,1204740,"California",3370418,0.197683788776348,964650,0.602,600094,0.375
"5114","san diego",5114,"2021-03-28",15035,1700259,9193,800890,5786,874828,56,24541,9282,543515,5747,672024,10799,1215539,"California",3370418,0.199388918525833,964650,0.602,600094,0.375
"5115","san diego",5115,"2021-03-29",26671,1726930,12905,813795,13170,887998,596,25137,16447,552768,10215,682239,19468,1235007,"California",3370418,0.202419699871055,964650,0.602,600094,0.375
"5116","san diego",5116,"2021-03-30",33230,1760160,17903,831698,14556,902554,771,25908,22052,566232,11166,693405,24630,1259637,"California",3370418,0.205732642063981,964650,0.602,600094,0.375
"5117","san diego",5117,"2021-03-31",30405,1790565,18760,850458,10967,913521,678,26586,20610,578828,9779,703184,22375,1282012,"California",3370418,0.208634062599951,964650,0.602,600094,0.375
"5118","san diego",5118,"2021-04-01",34316,1824881,20061,870519,12795,926316,1460,28046,23252,593807,11039,714223,26018,1308030,"California",3370418,0.211909324006696,964650,0.602,600094,0.375
"5119","san diego",5119,"2021-04-02",35699,1860580,20656,891175,12322,938638,2721,30767,24110,610479,11570,725793,28242,1336272,"California",3370418,0.215342132637554,964650,0.602,600094,0.375
"5120","san diego",5120,"2021-04-03",30808,1891388,14426,905601,11785,950423,4597,35364,19685,624840,11111,736904,25472,1361744,"California",3370418,0.218638756379772,964650,0.602,600094,0.375
"5121","san diego",5121,"2021-04-04",9065,1900453,5205,910806,2930,953353,930,36294,4827,626538,4233,741137,5931,1367675,"California",3370418,0.219894683686118,964650,0.602,600094,0.375
"5122","san diego",5122,"2021-04-05",29691,1930144,15403,926209,11698,965051,2590,38884,19397,640716,10279,751416,24457,1392132,"California",3370418,0.222944453773983,964650,0.602,600094,0.375
"5123","san diego",5123,"2021-04-06",38693,1968837,20391,946600,12448,977499,5854,44738,22352,654679,16326,767742,30289,1422421,"California",3370418,0.22778836334247,964650,0.602,600094,0.375
"5124","san diego",5124,"2021-04-07",35758,2004595,21977,968577,9270,986769,4511,49249,20452,665544,15282,783024,26147,1448568,"California",3370418,0.232322519046599,964650,0.602,600094,0.375
"5125","san diego",5125,"2021-04-08",35145,2039740,21358,989935,9690,996459,4097,53346,21308,679672,13817,796841,27945,1476513,"California",3370418,0.236422010563675,964650,0.602,600094,0.375
"5126","san diego",5126,"2021-04-09",38215,2077955,22803,1012738,10283,1006742,5129,58475,20829,691565,17316,814157,29209,1505722,"California",3370418,0.241559652244914,964650,0.602,600094,0.375
"5127","san diego",5127,"2021-04-10",29237,2107192,11781,1024519,13455,1020197,4001,62476,15237,699794,13988,828145,22217,1527939,"California",3370418,0.245709879308739,964650,0.602,600094,0.375
"5128","san diego",5128,"2021-04-11",16251,2123443,10072,1034591,3866,1024063,2313,64789,7299,703420,8948,837093,12574,1540513,"California",3370418,0.248364742889458,964650,0.602,600094,0.375
"5129","san diego",5129,"2021-04-12",30718,2154161,12816,1047407,13613,1037676,4289,69078,17223,715077,13480,850573,25137,1565650,"California",3370418,0.252364246808556,964650,0.602,600094,0.375
"5130","san diego",5130,"2021-04-13",37251,2191412,17773,1065180,19443,1057119,35,69113,24857,730403,12374,862947,27700,1593350,"California",3370418,0.256035601518862,964650,0.602,600094,0.375
"5131","san diego",5131,"2021-04-14",33051,2224463,18911,1084091,14128,1071247,12,69125,17908,737514,15128,878075,22239,1615589,"California",3370418,0.260524065561008,964650,0.602,600094,0.375
"5132","san diego",5132,"2021-04-15",39291,2263754,20330,1104421,18958,1090205,3,69128,23915,748888,15355,893430,26729,1642318,"California",3370418,0.265079880299714,964650,0.602,600094,0.375
"5133","san diego",5133,"2021-04-16",33763,2297517,18579,1123000,15182,1105387,2,69130,19593,756736,14108,907538,21956,1664274,"California",3370418,0.269265711255993,964650,0.602,600094,0.375
"5134","san diego",5134,"2021-04-17",27846,2325363,13527,1136527,14319,1119706,0,69130,12380,756762,15368,922906,15394,1679668,"California",3370418,0.273825383083048,964650,0.602,600094,0.375
"5135","san diego",5135,"2021-04-18",14272,2339635,8925,1145452,5344,1125050,3,69133,6583,758599,7676,930582,9513,1689181,"California",3370418,0.276102845403745,964650,0.602,600094,0.375
"5136","san diego",5136,"2021-04-19",26369,2366004,13493,1158945,12874,1137924,2,69135,12428,758837,13924,944506,14162,1703343,"California",3370418,0.280234083724927,964650,0.602,600094,0.375
"5137","san diego",5137,"2021-04-20",38770,2404774,17578,1176523,21192,1159116,0,69135,19844,762700,18905,963411,22768,1726111,"California",3370418,0.28584318028209,964650,0.602,600094,0.375
"5138","san diego",5138,"2021-04-21",34860,2439634,20849,1197372,14011,1173127,0,69135,16898,764617,17927,981338,19844,1745955,"California",3370418,0.291162105115745,964650,0.602,600094,0.375
"5139","san diego",5139,"2021-04-22",44394,2484028,22825,1220197,21563,1194690,6,69141,22192,767630,22163,1003501,25176,1771131,"California",3370418,0.297737847353058,964650,0.602,600094,0.375
"5140","san diego",5140,"2021-04-23",42005,2526033,25966,1246163,16037,1210727,2,69143,15592,759956,26380,1029881,18706,1789837,"California",3370418,0.305564769711057,964650,0.602,600094,0.375
"5141","san diego",5141,"2021-04-24",34306,2560339,18776,1264939,15515,1226242,15,69158,15415,759642,18858,1048739,18544,1808381,"California",3370418,0.311159921410341,964650,0.602,600094,0.375
"5142","san diego",5142,"2021-04-25",12442,2572781,7666,1272605,4776,1231018,0,69158,5849,760237,6584,1055323,7179,1815560,"California",3370418,0.313113388309699,964650,0.602,600094,0.375
"5143","san diego",5143,"2021-04-26",29953,2602734,14628,1287233,15201,1246219,124,69282,10070,754790,19873,1075196,14426,1829986,"California",3370418,0.319009689599332,964650,0.602,600094,0.375
"5144","san diego",5144,"2021-04-27",41462,2644196,22580,1309813,18482,1264701,400,69682,18164,752979,23267,1098463,21456,1851442,"California",3370418,0.32591298764723,964650,0.602,600094,0.375
"5145","san diego",5145,"2021-04-28",38124,2682320,22557,1332370,14926,1279627,641,70323,17286,752294,20804,1119267,20119,1871561,"California",3370418,0.332085515802491,964650,0.602,600094,0.375
"5146","san diego",5146,"2021-04-29",37976,2720296,24208,1356578,13150,1292777,618,70941,15359,747365,22581,1141848,17652,1889213,"California",3370418,0.338785278265188,964650,0.602,600094,0.375
"5147","san diego",5147,"2021-04-30",37900,2758196,23091,1379669,13833,1306610,976,71917,14810,741874,23056,1164904,17565,1906778,"California",3370418,0.345625972802187,964650,0.602,600094,0.375
"5148","san diego",5148,"2021-05-01",24259,2782455,10696,1390365,12918,1319528,645,72562,9515,739415,14733,1179637,12274,1919052,"California",3370418,0.349997240698335,964650,0.602,600094,0.375
"5149","san diego",5149,"2021-05-02",10697,2793152,7508,1397873,2602,1322130,587,73149,3265,736161,7427,1187064,4173,1923225,"California",3370418,0.352200824942188,964650,0.602,600094,0.375
"5150","san diego",5150,"2021-05-03",25294,2818446,12448,1410321,11691,1333821,1155,74304,9347,731514,15925,1202989,11278,1934503,"California",3370418,0.356925758170055,964650,0.602,600094,0.375
"5151","san diego",5151,"2021-05-04",31798,2850244,17542,1427863,12958,1346779,1298,75602,11511,725150,20259,1223248,13895,1948398,"California",3370418,0.36293658531375,964650,0.602,600094,0.375
"5152","san diego",5152,"2021-05-05",27570,2877814,16992,1444855,9309,1356088,1269,76871,10556,720922,16992,1240240,12764,1961162,"California",3370418,0.367978096485362,964650,0.602,600094,0.375
"5153","san diego",5153,"2021-05-06",28232,2906046,18792,1463647,8547,1364635,893,77764,10799,717672,17405,1257645,14155,1975317,"California",3370418,0.373142144386839,964650,0.602,600094,0.375
"5154","san diego",5154,"2021-05-07",29402,2935448,19517,1483164,8851,1373486,1034,78798,11018,712564,18349,1275994,13241,1988558,"California",3370418,0.378586276242294,964650,0.602,600094,0.375
"5155","san diego",5155,"2021-05-08",22531,2957979,10711,1493875,11114,1384600,706,79504,7261,706648,15248,1291242,9332,1997890,"California",3370418,0.383110344176894,964650,0.602,600094,0.375
"5156","san francisco",5156,"2020-12-15",7,7,7,7,0,0,0,0,7,7,0,0,7,7,"California",892280,0,378156,0.853,56417,0.127
"5157","san francisco",5157,"2020-12-16",229,236,229,236,0,0,0,0,229,236,0,0,229,236,"California",892280,0,378156,0.853,56417,0.127
"5158","san francisco",5158,"2020-12-17",393,629,393,629,0,0,0,0,393,629,0,0,393,629,"California",892280,0,378156,0.853,56417,0.127
"5159","san francisco",5159,"2020-12-18",876,1505,875,1504,1,1,0,0,876,1505,0,0,876,1505,"California",892280,0,378156,0.853,56417,0.127
"5160","san francisco",5160,"2020-12-19",601,2106,601,2105,0,1,0,0,601,2106,0,0,601,2106,"California",892280,0,378156,0.853,56417,0.127
"5161","san francisco",5161,"2020-12-20",484,2590,484,2589,0,1,0,0,484,2590,0,0,484,2590,"California",892280,0,378156,0.853,56417,0.127
"5162","san francisco",5162,"2020-12-21",1162,3752,1162,3751,0,1,0,0,1162,3752,0,0,1162,3752,"California",892280,0,378156,0.853,56417,0.127
"5163","san francisco",5163,"2020-12-22",1401,5153,1367,5118,34,35,0,0,1401,5153,0,0,1401,5153,"California",892280,0,378156,0.853,56417,0.127
"5164","san francisco",5164,"2020-12-23",1336,6489,1047,6165,289,324,0,0,1336,6489,0,0,1336,6489,"California",892280,0,378156,0.853,56417,0.127
"5165","san francisco",5165,"2020-12-24",841,7330,503,6668,338,662,0,0,841,7330,0,0,841,7330,"California",892280,0,378156,0.853,56417,0.127
"5166","san francisco",5166,"2020-12-25",34,7364,29,6697,5,667,0,0,34,7364,0,0,34,7364,"California",892280,0,378156,0.853,56417,0.127
"5167","san francisco",5167,"2020-12-26",245,7609,151,6848,94,761,0,0,245,7609,0,0,245,7609,"California",892280,0,378156,0.853,56417,0.127
"5168","san francisco",5168,"2020-12-27",274,7883,60,6908,214,975,0,0,274,7883,0,0,274,7883,"California",892280,0,378156,0.853,56417,0.127
"5169","san francisco",5169,"2020-12-28",1269,9152,686,7594,583,1558,0,0,1269,9152,0,0,1269,9152,"California",892280,0,378156,0.853,56417,0.127
"5170","san francisco",5170,"2020-12-29",1246,10398,623,8217,623,2181,0,0,1246,10398,0,0,1246,10398,"California",892280,0,378156,0.853,56417,0.127
"5171","san francisco",5171,"2020-12-30",1486,11884,779,8996,707,2888,0,0,1486,11884,0,0,1486,11884,"California",892280,0,378156,0.853,56417,0.127
"5172","san francisco",5172,"2020-12-31",963,12847,410,9406,553,3441,0,0,962,12846,0,0,962,12846,"California",892280,0,378156,0.853,56417,0.127
"5173","san francisco",5173,"2021-01-01",86,12933,70,9476,16,3457,0,0,86,12932,0,0,86,12932,"California",892280,0,378156,0.853,56417,0.127
"5174","san francisco",5174,"2021-01-02",334,13267,302,9778,32,3489,0,0,334,13266,0,0,334,13266,"California",892280,0,378156,0.853,56417,0.127
"5175","san francisco",5175,"2021-01-03",295,13562,102,9880,193,3682,0,0,294,13559,1,1,294,13560,"California",892280,1.12072443627561e-06,378156,0.853,56417,0.127
"5176","san francisco",5176,"2021-01-04",1840,15402,1355,11235,485,4167,0,0,1837,15393,3,4,1837,15397,"California",892280,4.48289774510243e-06,378156,0.853,56417,0.127
"5177","san francisco",5177,"2021-01-05",2234,17636,1417,12652,817,4984,0,0,2199,17559,35,39,2201,17598,"California",892280,4.37082530147487e-05,378156,0.853,56417,0.127
"5178","san francisco",5178,"2021-01-06",1869,19505,1160,13812,709,5693,0,0,1604,18901,263,302,1605,19203,"California",892280,0.000338458779755234,378156,0.853,56417,0.127
"5179","san francisco",5179,"2021-01-07",2062,21567,1202,15014,860,6553,0,0,1606,20054,453,755,1606,20809,"California",892280,0.000846146949388084,378156,0.853,56417,0.127
"5180","san francisco",5180,"2021-01-08",2332,23899,1633,16647,699,7252,0,0,1496,20719,831,1586,1496,22305,"California",892280,0.00177746895593312,378156,0.853,56417,0.127
"5181","san francisco",5181,"2021-01-09",1389,25288,893,17540,496,7748,0,0,885,21102,504,2090,887,23192,"California",892280,0.00234231407181602,378156,0.853,56417,0.127
"5182","san francisco",5182,"2021-01-10",919,26207,541,18081,378,8126,0,0,460,21104,458,2548,460,23652,"California",892280,0.00285560586363025,378156,0.853,56417,0.127
"5183","san francisco",5183,"2021-01-11",2504,28711,1872,19953,632,8758,0,0,1402,21403,1103,3651,1402,25054,"California",892280,0.00409176491684225,378156,0.853,56417,0.127
"5184","san francisco",5184,"2021-01-12",3089,31800,2059,22012,1030,9788,0,0,1896,22108,1193,4844,1898,26952,"California",892280,0.00542878916931905,378156,0.853,56417,0.127
"5185","san francisco",5185,"2021-01-13",2826,34626,1601,23613,1225,11013,0,0,1996,23274,830,5674,1996,28948,"California",892280,0.0063589904514278,378156,0.853,56417,0.127
"5186","san francisco",5186,"2021-01-14",2441,37067,1099,24712,1342,12355,0,0,1881,24595,560,6234,1881,30829,"California",892280,0.00698659613574214,378156,0.853,56417,0.127
"5187","san francisco",5187,"2021-01-15",2743,39810,1147,25859,1596,13951,0,0,2351,26558,390,6624,2353,33182,"California",892280,0.00742367866588963,378156,0.853,56417,0.127
"5188","san francisco",5188,"2021-01-16",2255,42065,964,26823,1291,15242,0,0,2089,28482,166,6790,2090,35272,"California",892280,0.00760971892231138,378156,0.853,56417,0.127
"5189","san francisco",5189,"2021-01-17",1916,43981,530,27353,1386,16628,0,0,1702,29970,214,7004,1702,36974,"California",892280,0.00784955395167436,378156,0.853,56417,0.127
"5190","san francisco",5190,"2021-01-18",1378,45359,593,27946,785,17413,0,0,1114,30823,263,7267,1116,38090,"California",892280,0.00814430447841485,378156,0.853,56417,0.127
"5191","san francisco",5191,"2021-01-19",2576,47935,1474,29420,1102,18515,0,0,1827,31901,749,8016,1827,39917,"California",892280,0.00898372708118528,378156,0.853,56417,0.127
"5192","san francisco",5192,"2021-01-20",2743,50678,1118,30538,1625,20140,0,0,1993,33148,747,8763,1994,41911,"California",892280,0.00982090823508316,378156,0.853,56417,0.127
"5193","san francisco",5193,"2021-01-21",3309,53987,945,31483,2364,22504,0,0,2474,34789,833,9596,2474,44385,"California",892280,0.0107544716905007,378156,0.853,56417,0.127
"5194","san francisco",5194,"2021-01-22",3188,57175,644,32127,2544,25048,0,0,2746,37095,440,10036,2746,47131,"California",892280,0.011247590442462,378156,0.853,56417,0.127
"5195","san francisco",5195,"2021-01-23",3092,60267,612,32739,2480,27528,0,0,2725,39455,366,10402,2726,49857,"California",892280,0.0116577755861389,378156,0.853,56417,0.127
"5196","san francisco",5196,"2021-01-24",2424,62691,363,33102,2061,29589,0,0,2195,41424,226,10628,2195,52052,"California",892280,0.0119110593087372,378156,0.853,56417,0.127
"5197","san francisco",5197,"2021-01-25",4581,67272,1779,34881,2802,32391,0,0,3034,42914,1545,12173,3035,55087,"California",892280,0.013642578562783,378156,0.853,56417,0.127
"5198","san francisco",5198,"2021-01-26",4668,71940,2135,37016,2533,34924,0,0,3076,44403,1589,13762,3078,58165,"California",892280,0.0154234096920249,378156,0.853,56417,0.127
"5199","san francisco",5199,"2021-01-27",4427,76367,2073,39089,2354,37278,0,0,3078,46136,1345,15107,3078,61243,"California",892280,0.0169307840588156,378156,0.853,56417,0.127
"5200","san francisco",5200,"2021-01-28",3756,80123,1555,40644,2201,39479,0,0,2594,47573,1157,16264,2594,63837,"California",892280,0.0182274622315865,378156,0.853,56417,0.127
"5201","san francisco",5201,"2021-01-29",4721,84844,1681,42325,3040,42519,0,0,3450,49759,1264,17528,3450,67287,"California",892280,0.0196440579190389,378156,0.853,56417,0.127
"5202","san francisco",5202,"2021-01-30",3772,88616,1838,44163,1934,44453,0,0,3323,52638,448,17976,3327,70614,"California",892280,0.0201461424664903,378156,0.853,56417,0.127
"5203","san francisco",5203,"2021-01-31",2351,90967,824,44987,1527,45980,0,0,2199,54687,151,18127,2200,72814,"California",892280,0.020315371856368,378156,0.853,56417,0.127
"5204","san francisco",5204,"2021-02-01",3798,94765,1530,46517,2268,48248,0,0,2892,56674,906,19033,2893,75707,"California",892280,0.0213307481956337,378156,0.853,56417,0.127
"5205","san francisco",5205,"2021-02-02",4648,99413,1963,48480,2685,50933,0,0,2884,57800,1758,20791,2884,78591,"California",892280,0.0233009817546062,378156,0.853,56417,0.127
"5206","san francisco",5206,"2021-02-03",5054,104467,2365,50845,2689,53622,0,0,3749,60247,1303,22094,3750,82341,"California",892280,0.0247612856950733,378156,0.853,56417,0.127
"5207","san francisco",5207,"2021-02-04",5027,109494,2434,53279,2593,56215,0,0,3862,62946,1163,23257,3862,86203,"California",892280,0.0260646882144618,378156,0.853,56417,0.127
"5208","san francisco",5208,"2021-02-05",5941,115435,3196,56475,2745,58960,0,0,4598,66204,1341,24598,4599,90802,"California",892280,0.0275675796835074,378156,0.853,56417,0.127
"5209","san francisco",5209,"2021-02-06",5474,120909,3655,60130,1819,60779,0,0,4574,69883,897,25495,4576,95378,"California",892280,0.0285728695028466,378156,0.853,56417,0.127
"5210","san francisco",5210,"2021-02-07",4331,125240,3181,63311,1150,61929,0,0,3753,73064,575,26070,3756,99134,"California",892280,0.0292172860537051,378156,0.853,56417,0.127
"5211","san francisco",5211,"2021-02-08",6702,131942,4613,67924,2089,64018,0,0,5486,77353,1199,27269,5488,104622,"California",892280,0.0305610346527996,378156,0.853,56417,0.127
"5212","san francisco",5212,"2021-02-09",5925,137867,3987,71911,1938,65956,0,0,4367,80167,1554,28823,4368,108990,"California",892280,0.0323026404267719,378156,0.853,56417,0.127
"5213","san francisco",5213,"2021-02-10",6867,144734,4177,76088,2690,68646,0,0,5068,83447,1791,30614,5071,114061,"California",892280,0.0343098578921415,378156,0.853,56417,0.127
"5214","san francisco",5214,"2021-02-11",6707,151441,3978,80066,2729,71375,0,0,4892,86529,1811,32425,4893,118954,"California",892280,0.0363394898462366,378156,0.853,56417,0.127
"5215","san francisco",5215,"2021-02-12",5314,156755,2666,82732,2648,74023,0,0,3478,88172,1835,34260,3478,122432,"California",892280,0.0383960191868023,378156,0.853,56417,0.127
"5216","san francisco",5216,"2021-02-13",4361,161116,2548,85280,1813,75836,0,0,3037,89887,1324,35584,3039,125471,"California",892280,0.0398798583404313,378156,0.853,56417,0.127
"5217","san francisco",5217,"2021-02-14",3415,164531,2241,87521,1174,77010,0,0,2290,91055,1124,36708,2292,127763,"California",892280,0.041139552606805,378156,0.853,56417,0.127
"5218","san francisco",5218,"2021-02-15",2771,167302,1505,89026,1266,78276,0,0,1678,91642,1091,37799,1678,129441,"California",892280,0.0423622629667817,378156,0.853,56417,0.127
"5219","san francisco",5219,"2021-02-16",4994,172296,2728,91754,2266,80542,0,0,2957,92575,2030,39829,2963,132404,"California",892280,0.0446373335724212,378156,0.853,56417,0.127
"5220","san francisco",5220,"2021-02-17",5404,177700,2681,94435,2723,83265,0,0,2961,93105,2432,42261,2962,135366,"California",892280,0.0473629354014435,378156,0.853,56417,0.127
"5221","san francisco",5221,"2021-02-18",5374,183074,2631,97066,2743,86008,0,0,2804,93342,2570,44831,2807,138173,"California",892280,0.0502431972026718,378156,0.853,56417,0.127
"5222","san francisco",5222,"2021-02-19",5638,188712,2646,99712,2992,89000,0,0,2928,93568,2704,47535,2930,141103,"California",892280,0.0532736360783611,378156,0.853,56417,0.127
"5223","san francisco",5223,"2021-02-20",4523,193235,2180,101892,2343,91343,0,0,1702,92458,2813,50348,1703,142806,"California",892280,0.0564262339176043,378156,0.853,56417,0.127
"5224","san francisco",5224,"2021-02-21",2741,195976,1373,103265,1368,92711,0,0,1144,92012,1591,51939,1145,143951,"California",892280,0.0582093064957188,378156,0.853,56417,0.127
"5225","san francisco",5225,"2021-02-22",5102,201078,3176,106441,1926,94637,0,0,2566,92052,2528,54467,2568,146519,"California",892280,0.0610424978706236,378156,0.853,56417,0.127
"5226","san francisco",5226,"2021-02-23",5462,206540,3085,109526,2377,97014,0,0,2766,92128,2690,57157,2766,149285,"California",892280,0.064057246604205,378156,0.853,56417,0.127
"5227","san francisco",5227,"2021-02-24",8982,215522,5083,114609,3899,100913,0,0,4792,92741,4180,61337,4793,154078,"California",892280,0.068741874747837,378156,0.853,56417,0.127
"5228","san francisco",5228,"2021-02-25",9773,225295,6869,121478,2904,103817,0,0,6315,95603,3455,64792,6317,160395,"California",892280,0.0726139776751692,378156,0.853,56417,0.127
"5229","san francisco",5229,"2021-02-26",11920,237215,7731,129209,4189,108006,0,0,7065,97813,4856,69648,7066,167461,"California",892280,0.0780562155377236,378156,0.853,56417,0.127
"5230","san francisco",5230,"2021-02-27",8919,246134,5677,134886,3241,111247,1,1,4512,97935,4392,74040,4514,171975,"California",892280,0.0829784372618461,378156,0.853,56417,0.127
"5231","san francisco",5231,"2021-02-28",7723,253857,5546,140432,2177,113424,0,1,3831,97877,3890,77930,3832,175807,"California",892280,0.0873380553189582,378156,0.853,56417,0.127
"5232","san francisco",5232,"2021-03-01",10760,264617,7241,147673,3516,116940,3,4,5230,97605,5508,83438,5236,181043,"California",892280,0.0935110055139642,378156,0.853,56417,0.127
"5233","san francisco",5233,"2021-03-02",8897,273514,5678,153351,3219,120159,0,4,5160,99037,3729,87167,5161,186204,"California",892280,0.097690186936836,378156,0.853,56417,0.127
"5234","san francisco",5234,"2021-03-03",11042,284556,6343,159694,4698,124857,1,5,6036,100083,4994,92161,6040,192244,"California",892280,0.103287084771596,378156,0.853,56417,0.127
"5235","san francisco",5235,"2021-03-04",8662,293218,5445,165139,3217,128074,0,5,4880,101187,3776,95937,4880,197124,"California",892280,0.107518940242973,378156,0.853,56417,0.127
"5236","san francisco",5236,"2021-03-05",8699,301917,5151,170290,3545,131619,3,8,5459,103426,3224,99161,5463,202587,"California",892280,0.111132155825526,378156,0.853,56417,0.127
"5237","san francisco",5237,"2021-03-06",6895,308812,4439,174729,2247,133866,209,217,4233,105191,2674,101835,4439,207026,"California",892280,0.114128972968127,378156,0.853,56417,0.127
"5238","san francisco",5238,"2021-03-07",5140,313952,3981,178710,1101,134967,58,275,2890,105876,2263,104098,2948,209974,"California",892280,0.116665172367418,378156,0.853,56417,0.127
"5239","san francisco",5239,"2021-03-08",7155,321107,5178,183888,1791,136758,186,461,5597,110070,1589,105687,5783,215757,"California",892280,0.11844600349666,378156,0.853,56417,0.127
"5240","san francisco",5240,"2021-03-09",6740,327847,3956,187844,2408,139166,376,837,4605,112906,2140,107827,4976,220733,"California",892280,0.12084435379029,378156,0.853,56417,0.127
"5241","san francisco",5241,"2021-03-10",10416,338263,5897,193741,4020,143186,499,1336,6361,115736,4032,111859,6862,227595,"California",892280,0.125363114717353,378156,0.853,56417,0.127
"5242","san francisco",5242,"2021-03-11",10046,348309,6354,200095,2729,145915,963,2299,6596,119853,3434,115293,7551,235146,"California",892280,0.129211682431524,378156,0.853,56417,0.127
"5243","san francisco",5243,"2021-03-12",10757,359066,6271,206366,3163,149078,1323,3622,5979,122397,4755,120048,7299,242445,"California",892280,0.134540727126014,378156,0.853,56417,0.127
"5244","san francisco",5244,"2021-03-13",6587,365653,3835,210201,1695,150773,1057,4679,4075,125025,2503,122551,5131,247576,"California",892280,0.137345900390012,378156,0.853,56417,0.127
"5245","san francisco",5245,"2021-03-14",7491,373144,4845,215046,2404,153177,242,4921,4040,125869,3438,125989,4282,251858,"California",892280,0.141198951001928,378156,0.853,56417,0.127
"5246","san francisco",5246,"2021-03-15",11946,385090,9108,224154,1896,155073,942,5863,8271,131411,3662,129651,9204,261062,"California",892280,0.145303043887569,378156,0.853,56417,0.127
"5247","san francisco",5247,"2021-03-16",12077,397167,8200,232354,3418,158491,459,6322,8785,137381,3273,132924,9243,270305,"California",892280,0.148971174967499,378156,0.853,56417,0.127
"5248","san francisco",5248,"2021-03-17",13201,410368,8146,240500,4498,162989,557,6879,9524,143811,3647,136571,10077,280382,"California",892280,0.153058456986596,378156,0.853,56417,0.127
"5249","san francisco",5249,"2021-03-18",9976,420344,6759,247259,2596,165585,621,7500,5684,145845,4267,140838,6301,286683,"California",892280,0.157840588156184,378156,0.853,56417,0.127
"5250","san francisco",5250,"2021-03-19",12027,432371,8709,255968,2853,168438,465,7965,6404,147110,5599,146437,6864,293547,"California",892280,0.164115524274891,378156,0.853,56417,0.127
"5251","san francisco",5251,"2021-03-20",8720,441091,6384,262352,1876,170314,460,8425,5201,149283,3490,149927,5663,299210,"California",892280,0.168026852557493,378156,0.853,56417,0.127
"5252","san francisco",5252,"2021-03-21",6448,447539,5900,268252,413,170727,135,8560,3681,150345,2753,152680,3815,303025,"California",892280,0.17111220693056,378156,0.853,56417,0.127
"5253","san francisco",5253,"2021-03-22",9744,457283,6836,275088,2065,172792,843,9403,5136,151734,4584,157264,5973,308998,"California",892280,0.176249607746447,378156,0.853,56417,0.127
"5254","san francisco",5254,"2021-03-23",11155,468438,7374,282462,3134,175926,647,10050,6703,154660,4421,161685,7347,316345,"California",892280,0.181204330479222,378156,0.853,56417,0.127
"5255","san francisco",5255,"2021-03-24",12286,480724,9394,291856,2356,178282,536,10586,6335,155615,5911,167596,6866,323211,"California",892280,0.187828932622047,378156,0.853,56417,0.127
"5256","san francisco",5256,"2021-03-25",11828,492552,8652,300508,2613,180895,563,11149,5909,156233,5850,173446,6468,329679,"California",892280,0.194385170574259,378156,0.853,56417,0.127
"5257","san francisco",5257,"2021-03-26",11860,504412,8204,308712,3426,184321,230,11379,6111,156853,5718,179164,6338,336017,"California",892280,0.200793472900883,378156,0.853,56417,0.127
"5258","san francisco",5258,"2021-03-27",8641,513053,5761,314473,2532,186853,348,11727,3918,156414,4703,183867,4264,340281,"California",892280,0.206064239924687,378156,0.853,56417,0.127
"5259","san francisco",5259,"2021-03-28",6582,519635,5246,319719,1294,188147,42,11769,3167,156228,3392,187259,3206,343487,"California",892280,0.209865737212534,378156,0.853,56417,0.127
"5260","san francisco",5260,"2021-03-29",11379,531014,7876,327595,3320,191467,183,11952,5100,155257,6252,193511,5281,348768,"California",892280,0.216872506388129,378156,0.853,56417,0.127
"5261","san francisco",5261,"2021-03-30",11501,542515,7185,334780,4026,195493,290,12242,6843,157758,4632,198143,7133,355901,"California",892280,0.222063701976958,378156,0.853,56417,0.127
"5262","san francisco",5262,"2021-03-31",12110,554625,8034,342814,3780,199273,296,12538,5551,157072,6526,204669,5840,361741,"California",892280,0.229377549648093,378156,0.853,56417,0.127
"5263","san francisco",5263,"2021-04-01",13766,568391,7314,350128,4811,204084,1641,14179,6005,156980,7728,212397,7636,369377,"California",892280,0.23803850809163,378156,0.853,56417,0.127
"5264","san francisco",5264,"2021-04-02",14638,583029,6453,356581,6371,210455,1814,15993,6907,157981,7713,220110,8714,378091,"California",892280,0.246682655668624,378156,0.853,56417,0.127
"5265","san francisco",5265,"2021-04-03",10422,593451,4793,361374,3836,214291,1793,17786,4831,159027,5576,225686,6622,384713,"California",892280,0.252931815125297,378156,0.853,56417,0.127
"5266","san francisco",5266,"2021-04-04",9009,602460,4768,366142,2588,216879,1653,19439,3631,158945,5365,231051,5283,389996,"California",892280,0.258944501725916,378156,0.853,56417,0.127
"5267","san francisco",5267,"2021-04-05",15923,618383,9761,375903,4287,221166,1875,21314,6360,157638,9536,240587,8229,398225,"California",892280,0.26963172995024,378156,0.853,56417,0.127
"5268","san francisco",5268,"2021-04-06",15979,634362,9469,385372,4452,225618,2058,23372,6292,156319,9664,250251,8345,406570,"California",892280,0.280462410902407,378156,0.853,56417,0.127
"5269","san francisco",5269,"2021-04-07",16763,651125,9976,395348,4563,230181,2224,25596,7055,155897,9687,259938,9265,415835,"California",892280,0.291318868516609,378156,0.853,56417,0.127
"5270","san francisco",5270,"2021-04-08",14120,665245,6717,402065,3007,233188,4396,29992,4648,155478,9442,269380,9023,424858,"California",892280,0.301900748643923,378156,0.853,56417,0.127
"5271","san francisco",5271,"2021-04-09",15700,680945,7588,409653,4779,237967,3333,33325,6672,156469,8998,278378,9989,434847,"California",892280,0.311985027121531,378156,0.853,56417,0.127
"5272","san francisco",5272,"2021-04-10",13235,694180,5662,415315,5850,243817,1723,35048,7137,159246,6074,284452,8851,443698,"California",892280,0.318792307347469,378156,0.853,56417,0.127
"5273","san francisco",5273,"2021-04-11",9975,704155,7468,422783,1337,245154,1170,36218,5209,160867,4755,289207,6376,450074,"California",892280,0.32412135204196,378156,0.853,56417,0.127
"5274","san francisco",5274,"2021-04-12",10577,714732,6864,429647,2568,247722,1145,37363,4865,161184,5690,294897,6007,456081,"California",892280,0.330498274084368,378156,0.853,56417,0.127
"5275","san francisco",5275,"2021-04-13",10706,725438,7278,436925,3415,251137,13,37376,5423,161361,5263,300160,5440,461521,"California",892280,0.336396646792487,378156,0.853,56417,0.127
"5276","san francisco",5276,"2021-04-14",13277,738715,8009,444934,5267,256404,1,37377,6439,160996,6805,306965,6440,467961,"California",892280,0.344023176581342,378156,0.853,56417,0.127
"5277","san francisco",5277,"2021-04-15",13668,752383,9495,454429,4171,260575,2,37379,8059,163481,5578,312543,8063,476024,"California",892280,0.350274577486888,378156,0.853,56417,0.127
"5278","san francisco",5278,"2021-04-16",12894,765277,8692,463121,4158,264733,44,37423,7656,165972,5213,317756,7704,483728,"California",892280,0.356116913973192,378156,0.853,56417,0.127
"5279","san francisco",5279,"2021-04-17",10021,775298,7297,470418,2723,267456,1,37424,7100,170171,2906,320662,7105,490833,"California",892280,0.359373739185009,378156,0.853,56417,0.127
"5280","san francisco",5280,"2021-04-18",6585,781883,5035,475453,1549,269005,1,37425,4090,171786,2478,323140,4093,494926,"California",892280,0.3621508943381,378156,0.853,56417,0.127
"5281","san francisco",5281,"2021-04-19",10811,792694,8112,483565,2695,271700,4,37429,6962,174928,3834,326974,6976,501902,"California",892280,0.366447751826781,378156,0.853,56417,0.127
"5282","san francisco",5282,"2021-04-20",12266,804960,7165,490730,5100,276800,1,37430,8469,179624,3776,330750,8472,510374,"California",892280,0.370679607298158,378156,0.853,56417,0.127
"5283","san francisco",5283,"2021-04-21",10510,815470,7513,498243,2993,279793,4,37434,6408,181960,4080,334830,6416,516790,"California",892280,0.375252162998162,378156,0.853,56417,0.127
"5284","san francisco",5284,"2021-04-22",10392,825862,7699,505942,2692,282485,1,37435,6006,183610,4363,339193,6013,522803,"California",892280,0.380141883713633,378156,0.853,56417,0.127
"5285","san francisco",5285,"2021-04-23",10323,836185,5939,511881,4384,286869,0,37435,6166,185652,4131,343324,6173,528976,"California",892280,0.384771596359887,378156,0.853,56417,0.127
"5286","san francisco",5286,"2021-04-24",7963,844148,5492,517373,2471,289340,0,37435,4739,187194,3204,346528,4746,533722,"California",892280,0.388362397453714,378156,0.853,56417,0.127
"5287","san francisco",5287,"2021-04-25",5035,849183,4340,521713,689,290029,6,37441,2955,188093,2065,348593,2964,536686,"California",892280,0.390676693414623,378156,0.853,56417,0.127
"5288","san francisco",5288,"2021-04-26",7453,856636,5245,526958,2196,292225,12,37453,3663,188012,3767,352360,3686,540372,"California",892280,0.394898462366073,378156,0.853,56417,0.127
"5289","san francisco",5289,"2021-04-27",7907,864543,5286,532244,2495,294720,126,37579,3925,188113,3959,356319,4060,544432,"California",892280,0.399335410409289,378156,0.853,56417,0.127
"5290","san francisco",5290,"2021-04-28",9242,873785,6525,538769,2527,297247,190,37769,4776,188642,4442,360761,4971,549403,"California",892280,0.404313668355225,378156,0.853,56417,0.127
"5291","san francisco",5291,"2021-04-29",9089,882874,5385,544154,3511,300758,193,37962,4372,188524,4695,365456,4577,553980,"California",892280,0.409575469583539,378156,0.853,56417,0.127
"5292","san francisco",5292,"2021-04-30",10847,893721,5189,549343,5459,306217,199,38161,3983,185883,6828,372284,4187,558167,"California",892280,0.417227776034429,378156,0.853,56417,0.127
"5293","san francisco",5293,"2021-05-01",6917,900638,3583,552926,3220,309437,114,38275,1707,182516,5190,377474,1823,559990,"California",892280,0.423044335858699,378156,0.853,56417,0.127
"5294","san francisco",5294,"2021-05-02",5319,905957,3083,556009,2138,311575,98,38373,976,179259,4334,381808,1077,561067,"California",892280,0.427901555565518,378156,0.853,56417,0.127
"5295","san francisco",5295,"2021-05-03",9659,915616,6580,562589,2909,314484,170,38543,2480,174774,7147,388955,2662,563729,"California",892280,0.435911373111579,378156,0.853,56417,0.127
"5296","san francisco",5296,"2021-05-04",9279,924895,5962,568551,3080,317564,237,38780,2268,170302,6984,395939,2512,566241,"California",892280,0.443738512574528,378156,0.853,56417,0.127
"5297","san francisco",5297,"2021-05-05",8780,933675,6156,574707,2315,319879,309,39089,2169,166222,6562,402501,2482,568723,"California",892280,0.451092706325369,378156,0.853,56417,0.127
"5298","san francisco",5298,"2021-05-06",10679,944354,8545,583252,1687,321566,447,39536,1878,159781,8769,411270,2328,571051,"California",892280,0.46092033890707,378156,0.853,56417,0.127
"5299","san francisco",5299,"2021-05-07",10118,954472,6434,589686,3406,324972,278,39814,1691,153349,8404,419674,1972,573023,"California",892280,0.47033890706953,378156,0.853,56417,0.127
"5300","san francisco",5300,"2021-05-08",8366,962838,3507,593193,4721,329693,138,39952,1030,147212,7305,426979,1168,574191,"California",892280,0.478525799076523,378156,0.853,56417,0.127
"5301","san joaquin",5301,"2020-12-15",12,12,12,12,0,0,0,0,12,12,0,0,12,12,"California",782545,0,161137,0.559,121098,0.42
"5302","san joaquin",5302,"2020-12-16",307,319,307,319,0,0,0,0,307,319,0,0,307,319,"California",782545,0,161137,0.559,121098,0.42
"5303","san joaquin",5303,"2020-12-17",312,631,312,631,0,0,0,0,312,631,0,0,312,631,"California",782545,0,161137,0.559,121098,0.42
"5304","san joaquin",5304,"2020-12-18",522,1153,518,1149,4,4,0,0,522,1153,0,0,522,1153,"California",782545,0,161137,0.559,121098,0.42
"5305","san joaquin",5305,"2020-12-19",188,1341,188,1337,0,4,0,0,188,1341,0,0,188,1341,"California",782545,0,161137,0.559,121098,0.42
"5306","san joaquin",5306,"2020-12-20",113,1454,112,1449,1,5,0,0,113,1454,0,0,113,1454,"California",782545,0,161137,0.559,121098,0.42
"5307","san joaquin",5307,"2020-12-21",491,1945,491,1940,0,5,0,0,491,1945,0,0,491,1945,"California",782545,0,161137,0.559,121098,0.42
"5308","san joaquin",5308,"2020-12-22",967,2912,847,2787,120,125,0,0,966,2911,0,0,966,2911,"California",782545,0,161137,0.559,121098,0.42
"5309","san joaquin",5309,"2020-12-23",978,3890,919,3706,59,184,0,0,976,3887,0,0,976,3887,"California",782545,0,161137,0.559,121098,0.42
"5310","san joaquin",5310,"2020-12-24",215,4105,187,3893,28,212,0,0,214,4101,0,0,214,4101,"California",782545,0,161137,0.559,121098,0.42
"5311","san joaquin",5311,"2020-12-25",14,4119,14,3907,0,212,0,0,14,4115,0,0,14,4115,"California",782545,0,161137,0.559,121098,0.42
"5312","san joaquin",5312,"2020-12-26",102,4221,30,3937,72,284,0,0,102,4217,0,0,102,4217,"California",782545,0,161137,0.559,121098,0.42
"5313","san joaquin",5313,"2020-12-27",42,4263,29,3966,13,297,0,0,42,4259,0,0,42,4259,"California",782545,0,161137,0.559,121098,0.42
"5314","san joaquin",5314,"2020-12-28",622,4885,421,4387,201,498,0,0,622,4881,0,0,622,4881,"California",782545,0,161137,0.559,121098,0.42
"5315","san joaquin",5315,"2020-12-29",797,5682,671,5058,126,624,0,0,797,5678,0,0,797,5678,"California",782545,0,161137,0.559,121098,0.42
"5316","san joaquin",5316,"2020-12-30",1007,6689,715,5773,292,916,0,0,1005,6683,0,0,1005,6683,"California",782545,0,161137,0.559,121098,0.42
"5317","san joaquin",5317,"2020-12-31",454,7143,203,5976,251,1167,0,0,454,7137,0,0,454,7137,"California",782545,0,161137,0.559,121098,0.42
"5318","san joaquin",5318,"2021-01-01",22,7165,13,5989,9,1176,0,0,22,7159,0,0,22,7159,"California",782545,0,161137,0.559,121098,0.42
"5319","san joaquin",5319,"2021-01-02",262,7427,240,6229,22,1198,0,0,262,7421,0,0,262,7421,"California",782545,0,161137,0.559,121098,0.42
"5320","san joaquin",5320,"2021-01-03",37,7464,19,6248,18,1216,0,0,36,7456,1,1,36,7457,"California",782545,1.27788178315624e-06,161137,0.559,121098,0.42
"5321","san joaquin",5321,"2021-01-04",476,7940,338,6586,138,1354,0,0,474,7929,1,2,474,7931,"California",782545,2.55576356631248e-06,161137,0.559,121098,0.42
"5322","san joaquin",5322,"2021-01-05",976,8916,644,7230,332,1686,0,0,808,8605,168,170,844,8775,"California",782545,0.000217239903136561,161137,0.559,121098,0.42
"5323","san joaquin",5323,"2021-01-06",1220,10136,707,7937,513,2199,0,0,917,9227,298,468,920,9695,"California",782545,0.00059804867451712,161137,0.559,121098,0.42
"5324","san joaquin",5324,"2021-01-07",1075,11211,680,8617,395,2594,0,0,786,9728,286,754,787,10482,"California",782545,0.000963522864499805,161137,0.559,121098,0.42
"5325","san joaquin",5325,"2021-01-08",1191,12402,819,9436,372,2966,0,0,707,9956,483,1237,711,11193,"California",782545,0.00158073976576427,161137,0.559,121098,0.42
"5326","san joaquin",5326,"2021-01-09",375,12777,299,9735,76,3042,0,0,246,10073,129,1366,246,11439,"California",782545,0.00174558651579142,161137,0.559,121098,0.42
"5327","san joaquin",5327,"2021-01-10",223,13000,115,9850,108,3150,0,0,171,10192,52,1418,171,11610,"California",782545,0.00181203636851555,161137,0.559,121098,0.42
"5328","san joaquin",5328,"2021-01-11",1525,14525,1319,11169,206,3356,0,0,861,10457,663,2081,928,12538,"California",782545,0.00265927199074814,161137,0.559,121098,0.42
"5329","san joaquin",5329,"2021-01-12",1455,15980,1049,12218,406,3762,0,0,686,10448,765,2846,756,13294,"California",782545,0.00363685155486266,161137,0.559,121098,0.42
"5330","san joaquin",5330,"2021-01-13",1527,17507,893,13111,634,4396,0,0,955,10837,571,3417,960,14254,"California",782545,0.00436652205304487,161137,0.559,121098,0.42
"5331","san joaquin",5331,"2021-01-14",1650,19157,877,13988,773,5169,0,0,1311,11844,319,3736,1326,15580,"California",782545,0.00477416634187171,161137,0.559,121098,0.42
"5332","san joaquin",5332,"2021-01-15",1600,20757,621,14609,979,6148,0,0,1381,13033,205,3941,1394,16974,"California",782545,0.00503613210741874,161137,0.559,121098,0.42
"5333","san joaquin",5333,"2021-01-16",1143,21900,193,14802,950,7098,0,0,1115,14121,27,3968,1115,18089,"California",782545,0.00507063491556396,161137,0.559,121098,0.42
"5334","san joaquin",5334,"2021-01-17",1614,23514,130,14932,1484,8582,0,0,1576,15661,38,4006,1578,19667,"California",782545,0.0051191944233239,161137,0.559,121098,0.42
"5335","san joaquin",5335,"2021-01-18",737,24251,237,15169,500,9082,0,0,617,16162,116,4122,617,20284,"California",782545,0.00526742871017002,161137,0.559,121098,0.42
"5336","san joaquin",5336,"2021-01-19",1858,26109,887,16056,971,10053,0,0,1178,16671,675,4797,1184,21468,"California",782545,0.00612999891380048,161137,0.559,121098,0.42
"5337","san joaquin",5337,"2021-01-20",2080,28189,1282,17338,798,10851,0,0,1430,17462,645,5442,1436,22904,"California",782545,0.00695423266393626,161137,0.559,121098,0.42
"5338","san joaquin",5338,"2021-01-21",1966,30155,892,18230,1074,11925,0,0,1570,18650,389,5831,1577,24481,"California",782545,0.00745132867758404,161137,0.559,121098,0.42
"5339","san joaquin",5339,"2021-01-22",1962,32117,914,19144,1048,12973,0,0,1819,20334,138,5969,1822,26303,"California",782545,0.0076276763636596,161137,0.559,121098,0.42
"5340","san joaquin",5340,"2021-01-23",894,33011,404,19548,490,13463,0,0,609,20662,284,6253,612,26915,"California",782545,0.00799059479007597,161137,0.559,121098,0.42
"5341","san joaquin",5341,"2021-01-24",348,33359,136,19684,212,13675,0,0,325,20967,20,6273,325,27240,"California",782545,0.0080161524257391,161137,0.559,121098,0.42
"5342","san joaquin",5342,"2021-01-25",1983,35342,1136,20820,847,14522,0,0,1423,21837,557,6830,1427,28667,"California",782545,0.00872793257895712,161137,0.559,121098,0.42
"5343","san joaquin",5343,"2021-01-26",2144,37486,1114,21934,1030,15552,0,0,1536,22773,605,7435,1541,30208,"California",782545,0.00950105105776665,161137,0.559,121098,0.42
"5344","san joaquin",5344,"2021-01-27",1724,39210,766,22700,958,16510,0,0,1230,23519,490,7925,1236,31444,"California",782545,0.0101272131315132,161137,0.559,121098,0.42
"5345","san joaquin",5345,"2021-01-28",2021,41231,760,23460,1261,17771,0,0,1373,24252,644,8569,1377,32821,"California",782545,0.0109501689998658,161137,0.559,121098,0.42
"5346","san joaquin",5346,"2021-01-29",2143,43374,1044,24504,1099,18870,0,0,1796,25714,342,8911,1804,34625,"California",782545,0.0113872045697053,161137,0.559,121098,0.42
"5347","san joaquin",5347,"2021-01-30",2162,45536,348,24852,1814,20684,0,0,1987,27530,173,9084,1989,36614,"California",782545,0.0116082781181913,161137,0.559,121098,0.42
"5348","san joaquin",5348,"2021-01-31",1555,47091,177,25029,1378,22062,0,0,1492,28961,62,9146,1493,38107,"California",782545,0.011687506788747,161137,0.559,121098,0.42
"5349","san joaquin",5349,"2021-02-01",2491,49582,1313,26342,1178,23240,0,0,1757,29988,733,9879,1760,39867,"California",782545,0.0126241941358005,161137,0.559,121098,0.42
"5350","san joaquin",5350,"2021-02-02",2587,52169,1171,27513,1416,24656,0,0,1962,31388,566,10445,1966,41833,"California",782545,0.0133474752250669,161137,0.559,121098,0.42
"5351","san joaquin",5351,"2021-02-03",3061,55230,1210,28723,1851,26507,0,0,2199,32737,855,11300,2204,44037,"California",782545,0.0144400641496655,161137,0.559,121098,0.42
"5352","san joaquin",5352,"2021-02-04",3434,58664,1712,30435,1722,28229,0,0,2627,34568,802,12102,2633,46670,"California",782545,0.0154649253397568,161137,0.559,121098,0.42
"5353","san joaquin",5353,"2021-02-05",3215,61879,1860,32295,1355,29584,0,0,2354,36073,854,12956,2359,49029,"California",782545,0.0165562363825722,161137,0.559,121098,0.42
"5354","san joaquin",5354,"2021-02-06",1119,62998,784,33079,335,29919,0,0,944,36846,173,13129,946,49975,"California",782545,0.0167773099310583,161137,0.559,121098,0.42
"5355","san joaquin",5355,"2021-02-07",615,63613,487,33566,128,30047,0,0,412,37063,196,13325,413,50388,"California",782545,0.0170277747605569,161137,0.559,121098,0.42
"5356","san joaquin",5356,"2021-02-08",1776,65389,1031,34597,745,30792,0,0,1441,38197,313,13638,1447,51835,"California",782545,0.0174277517586848,161137,0.559,121098,0.42
"5357","san joaquin",5357,"2021-02-09",2098,67487,1138,35735,960,31752,0,0,1569,39309,459,14097,1571,53406,"California",782545,0.0180142994971535,161137,0.559,121098,0.42
"5358","san joaquin",5358,"2021-02-10",2558,70045,1250,36985,1308,33060,0,0,1337,39454,1192,15289,1337,54743,"California",782545,0.0195375345826758,161137,0.559,121098,0.42
"5359","san joaquin",5359,"2021-02-11",2930,72975,1504,38489,1426,34486,0,0,1717,39993,1183,16472,1722,56465,"California",782545,0.0210492687321496,161137,0.559,121098,0.42
"5360","san joaquin",5360,"2021-02-12",2804,75779,1122,39611,1682,36168,0,0,1587,40385,1200,17672,1592,58057,"California",782545,0.0225827268719371,161137,0.559,121098,0.42
"5361","san joaquin",5361,"2021-02-13",2119,77898,399,40010,1720,37888,0,0,854,39992,1253,18925,860,58917,"California",782545,0.0241839127462318,161137,0.559,121098,0.42
"5362","san joaquin",5362,"2021-02-14",1903,79801,262,40272,1641,39529,0,0,689,39494,1188,20113,690,59607,"California",782545,0.0257020363046215,161137,0.559,121098,0.42
"5363","san joaquin",5363,"2021-02-15",1981,81782,836,41108,1145,40674,0,0,1194,39935,757,20870,1198,60805,"California",782545,0.0266693928144707,161137,0.559,121098,0.42
"5364","san joaquin",5364,"2021-02-16",3146,84928,1370,42478,1776,42450,0,0,1740,40291,1392,22262,1748,62553,"California",782545,0.0284482042566242,161137,0.559,121098,0.42
"5365","san joaquin",5365,"2021-02-17",3269,88197,1263,43741,2006,44456,0,0,1862,40761,1396,23658,1866,64419,"California",782545,0.0302321272259103,161137,0.559,121098,0.42
"5366","san joaquin",5366,"2021-02-18",3326,91523,1368,45109,1958,46414,0,0,1897,41264,1399,25057,1902,66321,"California",782545,0.0320198838405459,161137,0.559,121098,0.42
"5367","san joaquin",5367,"2021-02-19",4248,95771,2404,47513,1844,48258,0,0,2389,41848,1805,26862,2389,68710,"California",782545,0.0343264604591429,161137,0.559,121098,0.42
"5368","san joaquin",5368,"2021-02-20",1541,97312,653,48166,888,49146,0,0,1064,42436,476,27338,1064,69774,"California",782545,0.0349347321879253,161137,0.559,121098,0.42
"5369","san joaquin",5369,"2021-02-21",638,97950,480,48646,158,49304,0,0,402,42606,233,27571,403,70177,"California",782545,0.0352324786434007,161137,0.559,121098,0.42
"5370","san joaquin",5370,"2021-02-22",3516,101466,2476,51122,1040,50344,0,0,2520,44165,965,28536,2524,72701,"California",782545,0.0364656345641465,161137,0.559,121098,0.42
"5371","san joaquin",5371,"2021-02-23",4288,105754,2609,53731,1679,52023,0,0,2642,45195,1616,30152,2646,75347,"California",782545,0.038530691525727,161137,0.559,121098,0.42
"5372","san joaquin",5372,"2021-02-24",5699,111453,3389,57120,2310,54333,0,0,4099,47720,1576,31728,4101,79448,"California",782545,0.0405446332159812,161137,0.559,121098,0.42
"5373","san joaquin",5373,"2021-02-25",6297,117750,3891,61011,2406,56739,0,0,4071,49606,2195,33923,4081,83529,"California",782545,0.0433495837300091,161137,0.559,121098,0.42
"5374","san joaquin",5374,"2021-02-26",5467,123217,2851,63862,2616,59355,0,0,3759,51692,1678,35601,3764,87293,"California",782545,0.0454938693621453,161137,0.559,121098,0.42
"5375","san joaquin",5375,"2021-02-27",5440,128657,1617,65479,3823,63178,0,0,2613,51537,2779,38380,2624,89917,"California",782545,0.0490451028375365,161137,0.559,121098,0.42
"5376","san joaquin",5376,"2021-02-28",3079,131736,1105,66584,1974,65152,0,0,2034,52552,1021,39401,2036,91953,"California",782545,0.050349820138139,161137,0.559,121098,0.42
"5377","san joaquin",5377,"2021-03-01",4074,135810,1794,68378,2280,67432,0,0,2309,53119,1749,41150,2316,94269,"California",782545,0.0525848353768793,161137,0.559,121098,0.42
"5378","san joaquin",5378,"2021-03-02",4169,139979,1665,70043,2504,69936,0,0,2616,54257,1534,42684,2672,96941,"California",782545,0.054545106032241,161137,0.559,121098,0.42
"5379","san joaquin",5379,"2021-03-03",5746,145725,3410,73453,2334,72270,2,2,4147,56829,1576,44260,4148,101089,"California",782545,0.0565590477224952,161137,0.559,121098,0.42
"5380","san joaquin",5380,"2021-03-04",5685,151410,2253,75706,3429,75699,3,5,3720,58601,1952,46212,3724,104813,"California",782545,0.0590534729632162,161137,0.559,121098,0.42
"5381","san joaquin",5381,"2021-03-05",4409,155819,1866,77572,2539,78238,4,9,3040,60296,1353,47565,3048,107861,"California",782545,0.0607824470158266,161137,0.559,121098,0.42
"5382","san joaquin",5382,"2021-03-06",3282,159101,2163,79735,989,79227,130,139,2700,62550,579,48144,2833,110694,"California",782545,0.061522340568274,161137,0.559,121098,0.42
"5383","san joaquin",5383,"2021-03-07",1204,160305,552,80287,606,79833,46,185,922,63239,264,48408,953,111647,"California",782545,0.0618597013590273,161137,0.559,121098,0.42
"5384","san joaquin",5384,"2021-03-08",3122,163427,1253,81540,1744,81577,125,310,2113,64479,997,49405,2237,113884,"California",782545,0.063133749496834,161137,0.559,121098,0.42
"5385","san joaquin",5385,"2021-03-09",3960,167387,1778,83318,2055,83632,127,437,2621,65906,1324,50729,2751,116635,"California",782545,0.0648256649777329,161137,0.559,121098,0.42
"5386","san joaquin",5386,"2021-03-10",4633,172020,2462,85780,2033,85665,138,575,3411,68247,1209,51938,3550,120185,"California",782545,0.0663706240535688,161137,0.559,121098,0.42
"5387","san joaquin",5387,"2021-03-11",4926,176946,2337,88117,1989,87654,600,1175,2927,69790,1989,53927,3532,123717,"California",782545,0.0689123309202666,161137,0.559,121098,0.42
"5388","san joaquin",5388,"2021-03-12",6255,183201,3125,91242,2798,90452,332,1507,4153,72199,2081,56008,4490,128207,"California",782545,0.0715716029110147,161137,0.559,121098,0.42
"5389","san joaquin",5389,"2021-03-13",3052,186253,1447,92689,1479,91931,126,1633,2285,73857,760,56768,2418,130625,"California",782545,0.0725427930662134,161137,0.559,121098,0.42
"5390","san joaquin",5390,"2021-03-14",2152,188405,668,93357,1181,93112,303,1936,1038,74092,1110,57878,1345,131970,"California",782545,0.0739612418455169,161137,0.559,121098,0.42
"5391","san joaquin",5391,"2021-03-15",6050,194455,3481,96838,2165,95277,404,2340,3173,74829,2851,60729,3588,135558,"California",782545,0.0776044828092953,161137,0.559,121098,0.42
"5392","san joaquin",5392,"2021-03-16",6815,201270,3877,100715,2682,97959,256,2596,4022,76336,2779,63508,4286,139844,"California",782545,0.0811557162846865,161137,0.559,121098,0.42
"5393","san joaquin",5393,"2021-03-17",7750,209020,4645,105360,3035,100994,70,2666,4313,77326,3402,66910,4392,144236,"California",782545,0.085503070110984,161137,0.559,121098,0.42
"5394","san joaquin",5394,"2021-03-18",7616,216636,4478,109838,2632,103626,506,3172,3772,77806,3805,70715,4285,148521,"California",782545,0.0903654102958935,161137,0.559,121098,0.42
"5395","san joaquin",5395,"2021-03-19",7903,224539,4631,114469,2730,106356,542,3714,4791,80096,3091,73806,5381,153902,"California",782545,0.0943153428876295,161137,0.559,121098,0.42
"5396","san joaquin",5396,"2021-03-20",3666,228205,2120,116589,1303,107659,243,3957,1821,80341,1830,75636,2075,155977,"California",782545,0.0966538665508054,161137,0.559,121098,0.42
"5397","san joaquin",5397,"2021-03-21",2097,230302,1490,118079,401,108060,206,4163,1182,80865,908,76544,1432,157409,"California",782545,0.0978141832099113,161137,0.559,121098,0.42
"5398","san joaquin",5398,"2021-03-22",3950,234252,2018,120097,1515,109575,417,4580,2337,82023,1601,78145,2759,160168,"California",782545,0.0998600719447444,161137,0.559,121098,0.42
"5399","san joaquin",5399,"2021-03-23",5357,239609,2628,122725,2562,112137,167,4747,3708,84273,1631,79776,3881,164049,"California",782545,0.101944297133072,161137,0.559,121098,0.42
"5400","san joaquin",5400,"2021-03-24",6806,246415,4225,126950,2494,114631,87,4834,3024,83639,3753,83529,3119,167168,"California",782545,0.106740187465258,161137,0.559,121098,0.42
"5401","san joaquin",5401,"2021-03-25",5524,251939,3276,130226,2206,116837,42,4876,3288,84760,2216,85745,3337,170505,"California",782545,0.109571973496732,161137,0.559,121098,0.42
"5402","san joaquin",5402,"2021-03-26",6134,258073,2536,132762,3448,120285,150,5026,3234,85283,2880,88625,3403,173908,"California",782545,0.113252273032222,161137,0.559,121098,0.42
"5403","san joaquin",5403,"2021-03-27",4610,262683,2610,135372,1951,122236,49,5075,1802,84358,2786,91411,1861,175769,"California",782545,0.116812451680095,161137,0.559,121098,0.42
"5404","san joaquin",5404,"2021-03-28",2703,265386,1792,137164,886,123122,25,5100,1295,84367,1389,92800,1398,177167,"California",782545,0.118587429476899,161137,0.559,121098,0.42
"5405","san joaquin",5405,"2021-03-29",4014,269400,2169,139333,1823,124945,22,5122,2019,84441,1982,94782,2056,179223,"California",782545,0.121120191171115,161137,0.559,121098,0.42
"5406","san joaquin",5406,"2021-03-30",6192,275592,3147,142480,2953,127898,92,5214,3445,85274,2723,97505,3556,182779,"California",782545,0.124599863266649,161137,0.559,121098,0.42
"5407","san joaquin",5407,"2021-03-31",6565,282157,4135,146615,2371,130269,59,5273,3336,85479,3213,100718,3418,186197,"California",782545,0.12870569743593,161137,0.559,121098,0.42
"5408","san joaquin",5408,"2021-04-01",6362,288519,2952,149567,3328,133597,82,5355,2815,84902,3531,104249,2954,189151,"California",782545,0.133217898012255,161137,0.559,121098,0.42
"5409","san joaquin",5409,"2021-04-02",6307,294826,2868,152435,2950,136547,489,5844,2517,84172,3768,108017,3038,192189,"California",782545,0.138032956571188,161137,0.559,121098,0.42
"5410","san joaquin",5410,"2021-04-03",4119,298945,2320,154755,1473,138020,326,6170,1988,84377,2114,110131,2319,194508,"California",782545,0.14073439866078,161137,0.559,121098,0.42
"5411","san joaquin",5411,"2021-04-04",2269,301214,1356,156111,711,138731,202,6372,1544,85420,716,110847,1759,196267,"California",782545,0.14164936201752,161137,0.559,121098,0.42
"5412","san joaquin",5412,"2021-04-05",4542,305756,2815,158926,1547,140278,180,6552,2633,86342,1902,112749,2824,199091,"California",782545,0.144079893169083,161137,0.559,121098,0.42
"5413","san joaquin",5413,"2021-04-06",7004,312760,4506,163432,2237,142515,261,6813,3329,86292,3652,116401,3602,202693,"California",782545,0.14874671744117,161137,0.559,121098,0.42
"5414","san joaquin",5414,"2021-04-07",8291,321051,4511,167943,2206,144721,1574,8387,3490,86584,4787,121188,5079,207772,"California",782545,0.154863937537138,161137,0.559,121098,0.42
"5415","san joaquin",5415,"2021-04-08",8633,329684,4677,172620,1936,146657,2020,10407,3299,86594,5311,126499,5321,213093,"California",782545,0.161650767687481,161137,0.559,121098,0.42
"5416","san joaquin",5416,"2021-04-09",8822,338506,4252,176872,3017,149674,1553,11960,3201,85768,5599,132098,4773,217866,"California",782545,0.168805627791373,161137,0.559,121098,0.42
"5417","san joaquin",5417,"2021-04-10",5194,343700,1621,178493,1668,151342,1905,13865,1753,85990,3433,135531,3655,221521,"California",782545,0.173192595952948,161137,0.559,121098,0.42
"5418","san joaquin",5418,"2021-04-11",4053,347753,1543,180036,1345,152687,1165,15030,1748,86604,2294,137825,2908,224429,"California",782545,0.176124056763509,161137,0.559,121098,0.42
"5419","san joaquin",5419,"2021-04-12",5947,353700,2363,182399,2050,154737,1534,16564,2320,86854,3609,141434,3859,228288,"California",782545,0.18073593211892,161137,0.559,121098,0.42
"5420","san joaquin",5420,"2021-04-13",7421,361121,4278,186677,3137,157874,6,16570,4548,88562,2854,144288,4562,232850,"California",782545,0.184383006728048,161137,0.559,121098,0.42
"5421","san joaquin",5421,"2021-04-14",7407,368528,3700,190377,3707,161581,0,16570,4430,90043,2958,147246,4439,237289,"California",782545,0.188162981042624,161137,0.559,121098,0.42
"5422","san joaquin",5422,"2021-04-15",7734,376262,4569,194946,3165,164746,0,16570,4314,90975,3388,150634,4320,241609,"California",782545,0.192492444523957,161137,0.559,121098,0.42
"5423","san joaquin",5423,"2021-04-16",7360,383622,3849,198795,3508,168254,3,16573,4336,92329,2996,153630,4350,245959,"California",782545,0.196320978346293,161137,0.559,121098,0.42
"5424","san joaquin",5424,"2021-04-17",5102,388724,2752,201547,2348,170602,2,16575,3615,94484,1478,155108,3633,249592,"California",782545,0.198209687621798,161137,0.559,121098,0.42
"5425","san joaquin",5425,"2021-04-18",2440,391164,1349,202896,1091,171693,0,16575,1297,94660,1128,156236,1304,250896,"California",782545,0.199651138273198,161137,0.559,121098,0.42
"5426","san joaquin",5426,"2021-04-19",5079,396243,2730,205626,2349,174042,0,16575,2715,95043,2342,158578,2725,253621,"California",782545,0.20264393740935,161137,0.559,121098,0.42
"5427","san joaquin",5427,"2021-04-20",6186,402429,3248,208874,2938,176980,0,16575,2928,94748,3234,161812,2939,256560,"California",782545,0.206776607096078,161137,0.559,121098,0.42
"5428","san joaquin",5428,"2021-04-21",5335,407764,2830,211704,2505,179485,0,16575,2888,95242,2400,164212,2894,259454,"California",782545,0.209843523375653,161137,0.559,121098,0.42
"5429","san joaquin",5429,"2021-04-22",5143,412907,3000,214704,2142,181627,1,16576,2933,96000,2185,166397,2943,262397,"California",782545,0.212635695071849,161137,0.559,121098,0.42
"5430","san joaquin",5430,"2021-04-23",5800,418707,2748,217452,3051,184678,1,16577,3659,97542,2123,168520,3665,266062,"California",782545,0.21534863809749,161137,0.559,121098,0.42
"5431","san joaquin",5431,"2021-04-24",5156,423863,3543,220995,1612,186290,1,16578,3349,99112,1785,170305,3355,269417,"California",782545,0.217629657080423,161137,0.559,121098,0.42
"5432","san joaquin",5432,"2021-04-25",2969,426832,2497,223492,472,186762,0,16578,1945,100056,1007,171312,1951,271368,"California",782545,0.218916484036062,161137,0.559,121098,0.42
"5433","san joaquin",5433,"2021-04-26",3712,430544,2468,225960,1243,188005,1,16579,1966,100290,1736,173048,1970,273338,"California",782545,0.221134886811621,161137,0.559,121098,0.42
"5434","san joaquin",5434,"2021-04-27",4161,434705,2428,228388,1684,189689,49,16628,1757,99717,2387,175435,1814,275152,"California",782545,0.224185190628015,161137,0.559,121098,0.42
"5435","san joaquin",5435,"2021-04-28",5464,440169,3279,231667,2110,191799,75,16703,2681,99727,2754,178189,2764,277916,"California",782545,0.227704477058827,161137,0.559,121098,0.42
"5436","san joaquin",5436,"2021-04-29",4775,444944,2781,234448,1939,193738,55,16758,2426,99884,2330,180519,2487,280403,"California",782545,0.230681941613581,161137,0.559,121098,0.42
"5437","san joaquin",5437,"2021-04-30",4873,449817,2377,236825,2429,196167,67,16825,2502,100105,2356,182875,2577,282980,"California",782545,0.233692631094697,161137,0.559,121098,0.42
"5438","san joaquin",5438,"2021-05-01",3289,453106,1890,238715,1340,197507,59,16884,2083,101060,1200,184075,2155,285135,"California",782545,0.235226089234485,161137,0.559,121098,0.42
"5439","san joaquin",5439,"2021-05-02",2243,455349,1548,240263,640,198147,55,16939,1127,101133,1111,185186,1184,286319,"California",782545,0.236645815895571,161137,0.559,121098,0.42
"5440","san joaquin",5440,"2021-05-03",3167,458516,2128,242391,968,199115,71,17010,1330,100719,1825,187011,1411,287730,"California",782545,0.238977950149832,161137,0.559,121098,0.42
"5441","san joaquin",5441,"2021-05-04",4797,463313,3276,245667,1368,200483,153,17163,1752,99607,3027,190038,1915,289645,"California",782545,0.242846098307446,161137,0.559,121098,0.42
"5442","san joaquin",5442,"2021-05-05",4489,467802,2994,248661,1337,201820,158,17321,1750,98806,2717,192755,1916,291561,"California",782545,0.246318103112281,161137,0.559,121098,0.42
"5443","san joaquin",5443,"2021-05-06",4558,472360,3040,251701,1390,203210,128,17449,2028,98455,2514,195269,2163,293724,"California",782545,0.249530697915136,161137,0.559,121098,0.42
"5444","san joaquin",5444,"2021-05-07",4544,476904,2579,254280,1814,205024,151,17600,1817,97718,2716,197985,1979,295703,"California",782545,0.253001424838188,161137,0.559,121098,0.42
"5445","san joaquin",5445,"2021-05-08",3158,480062,2082,256362,979,206003,97,17697,1202,97084,1943,199928,1309,297012,"California",782545,0.255484349142861,161137,0.559,121098,0.42
"5446","san luis obispo",5446,"2020-12-16",4,4,4,4,0,0,0,0,4,4,0,0,4,4,"California",278862,0,88310,0.553,67436,0.422
"5447","san luis obispo",5447,"2020-12-17",196,200,196,200,0,0,0,0,196,200,0,0,196,200,"California",278862,0,88310,0.553,67436,0.422
"5448","san luis obispo",5448,"2020-12-18",224,424,224,424,0,0,0,0,224,424,0,0,224,424,"California",278862,0,88310,0.553,67436,0.422
"5449","san luis obispo",5449,"2020-12-19",162,586,162,586,0,0,0,0,162,586,0,0,162,586,"California",278862,0,88310,0.553,67436,0.422
"5450","san luis obispo",5450,"2020-12-20",215,801,215,801,0,0,0,0,215,801,0,0,215,801,"California",278862,0,88310,0.553,67436,0.422
"5451","san luis obispo",5451,"2020-12-21",549,1350,548,1349,1,1,0,0,549,1350,0,0,549,1350,"California",278862,0,88310,0.553,67436,0.422
"5452","san luis obispo",5452,"2020-12-22",309,1659,305,1654,4,5,0,0,309,1659,0,0,309,1659,"California",278862,0,88310,0.553,67436,0.422
"5453","san luis obispo",5453,"2020-12-23",682,2341,368,2022,314,319,0,0,682,2341,0,0,682,2341,"California",278862,0,88310,0.553,67436,0.422
"5454","san luis obispo",5454,"2020-12-24",194,2535,19,2041,175,494,0,0,194,2535,0,0,194,2535,"California",278862,0,88310,0.553,67436,0.422
"5455","san luis obispo",5455,"2020-12-25",2,2537,1,2042,1,495,0,0,2,2537,0,0,2,2537,"California",278862,0,88310,0.553,67436,0.422
"5456","san luis obispo",5456,"2020-12-26",89,2626,12,2054,77,572,0,0,89,2626,0,0,89,2626,"California",278862,0,88310,0.553,67436,0.422
"5457","san luis obispo",5457,"2020-12-27",76,2702,0,2054,76,648,0,0,76,2702,0,0,76,2702,"California",278862,0,88310,0.553,67436,0.422
"5458","san luis obispo",5458,"2020-12-28",880,3582,430,2484,450,1098,0,0,880,3582,0,0,880,3582,"California",278862,0,88310,0.553,67436,0.422
"5459","san luis obispo",5459,"2020-12-29",903,4485,502,2986,401,1499,0,0,903,4485,0,0,903,4485,"California",278862,0,88310,0.553,67436,0.422
"5460","san luis obispo",5460,"2020-12-30",1172,5657,681,3667,491,1990,0,0,1172,5657,0,0,1172,5657,"California",278862,0,88310,0.553,67436,0.422
"5461","san luis obispo",5461,"2020-12-31",107,5764,4,3671,103,2093,0,0,107,5764,0,0,107,5764,"California",278862,0,88310,0.553,67436,0.422
"5462","san luis obispo",5462,"2021-01-01",13,5777,8,3679,5,2098,0,0,13,5777,0,0,13,5777,"California",278862,0,88310,0.553,67436,0.422
"5463","san luis obispo",5463,"2021-01-02",33,5810,8,3687,25,2123,0,0,33,5810,0,0,33,5810,"California",278862,0,88310,0.553,67436,0.422
"5464","san luis obispo",5464,"2021-01-03",16,5826,6,3693,10,2133,0,0,16,5826,0,0,16,5826,"California",278862,0,88310,0.553,67436,0.422
"5465","san luis obispo",5465,"2021-01-04",679,6505,525,4218,154,2287,0,0,679,6505,0,0,679,6505,"California",278862,0,88310,0.553,67436,0.422
"5466","san luis obispo",5466,"2021-01-05",974,7479,756,4974,218,2505,0,0,972,7475,2,2,972,7477,"California",278862,7.1720062253014e-06,88310,0.553,67436,0.422
"5467","san luis obispo",5467,"2021-01-06",725,8204,480,5454,245,2750,0,0,717,8185,7,9,717,8194,"California",278862,3.22740280138563e-05,88310,0.553,67436,0.422
"5468","san luis obispo",5468,"2021-01-07",1126,9330,948,6402,178,2928,0,0,683,8425,443,452,683,8877,"California",278862,0.00162087340691812,88310,0.553,67436,0.422
"5469","san luis obispo",5469,"2021-01-08",882,10212,804,7206,78,3006,0,0,513,8570,368,820,513,9390,"California",278862,0.00294052255237358,88310,0.553,67436,0.422
"5470","san luis obispo",5470,"2021-01-09",204,10416,195,7401,9,3015,0,0,27,8420,177,997,27,9417,"California",278862,0.00357524510331275,88310,0.553,67436,0.422
"5471","san luis obispo",5471,"2021-01-10",12,10428,8,7409,4,3019,0,0,8,8424,4,1001,8,9425,"California",278862,0.00358958911576335,88310,0.553,67436,0.422
"5472","san luis obispo",5472,"2021-01-11",559,10987,508,7917,51,3070,0,0,299,8464,259,1260,299,9724,"California",278862,0.00451836392193988,88310,0.553,67436,0.422
"5473","san luis obispo",5473,"2021-01-12",597,11584,380,8297,217,3287,0,0,318,8503,279,1539,318,10042,"California",278862,0.00551885879036943,88310,0.553,67436,0.422
"5474","san luis obispo",5474,"2021-01-13",885,12469,256,8553,629,3916,0,0,645,8911,237,1776,645,10687,"California",278862,0.00636874152806765,88310,0.553,67436,0.422
"5475","san luis obispo",5475,"2021-01-14",729,13198,244,8797,485,4401,0,0,604,9403,112,1888,604,11291,"California",278862,0.00677037387668452,88310,0.553,67436,0.422
"5476","san luis obispo",5476,"2021-01-15",729,13927,288,9085,441,4842,0,0,554,9787,170,2058,554,11845,"California",278862,0.00737999440583514,88310,0.553,67436,0.422
"5477","san luis obispo",5477,"2021-01-16",100,14027,81,9166,19,4861,0,0,95,9877,5,2063,95,11940,"California",278862,0.0073979244213984,88310,0.553,67436,0.422
"5478","san luis obispo",5478,"2021-01-17",67,14094,61,9227,6,4867,0,0,67,9944,0,2063,67,12007,"California",278862,0.0073979244213984,88310,0.553,67436,0.422
"5479","san luis obispo",5479,"2021-01-18",1371,15465,389,9616,982,5849,0,0,1109,10791,262,2325,1109,13116,"California",278862,0.00833745723691288,88310,0.553,67436,0.422
"5480","san luis obispo",5480,"2021-01-19",1584,17049,417,10033,1167,7016,0,0,1176,11559,408,2733,1176,14292,"California",278862,0.00980054650687437,88310,0.553,67436,0.422
"5481","san luis obispo",5481,"2021-01-20",1884,18933,596,10629,1288,8304,0,0,1293,12264,589,3322,1294,15586,"California",278862,0.0119127023402256,88310,0.553,67436,0.422
"5482","san luis obispo",5482,"2021-01-21",1570,20503,466,11095,1104,9408,0,0,1197,13093,369,3691,1198,16784,"California",278862,0.0132359374887937,88310,0.553,67436,0.422
"5483","san luis obispo",5483,"2021-01-22",1521,22024,509,11604,1012,10420,0,0,1206,13986,313,4004,1206,17990,"California",278862,0.0143583564630534,88310,0.553,67436,0.422
"5484","san luis obispo",5484,"2021-01-23",312,22336,294,11898,18,10438,0,0,296,14266,16,4020,296,18286,"California",278862,0.0144157325128558,88310,0.553,67436,0.422
"5485","san luis obispo",5485,"2021-01-24",245,22581,237,12135,8,10446,0,0,239,14499,6,4026,239,18525,"California",278862,0.0144372485315317,88310,0.553,67436,0.422
"5486","san luis obispo",5486,"2021-01-25",2074,24655,606,12741,1468,11914,0,0,1244,14913,830,4856,1244,19769,"California",278862,0.0174136311150318,88310,0.553,67436,0.422
"5487","san luis obispo",5487,"2021-01-26",2002,26657,704,13445,1298,13212,0,0,1135,15181,867,5723,1135,20904,"California",278862,0.0205226958137,88310,0.553,67436,0.422
"5488","san luis obispo",5488,"2021-01-27",1611,28268,284,13729,1327,14539,0,0,1152,15874,459,6182,1152,22056,"California",278862,0.0221686712424066,88310,0.553,67436,0.422
"5489","san luis obispo",5489,"2021-01-28",1491,29759,343,14072,1148,15687,0,0,1229,16842,261,6443,1229,23285,"California",278862,0.0231046180548085,88310,0.553,67436,0.422
"5490","san luis obispo",5490,"2021-01-29",1735,31494,681,14753,1054,16741,0,0,1451,18009,284,6727,1451,24736,"California",278862,0.0241230429388013,88310,0.553,67436,0.422
"5491","san luis obispo",5491,"2021-01-30",37,31531,18,14771,19,16760,0,0,26,18025,10,6737,26,24762,"California",278862,0.0241589029699278,88310,0.553,67436,0.422
"5492","san luis obispo",5492,"2021-01-31",28,31559,20,14791,8,16768,0,0,25,18047,3,6740,25,24787,"California",278862,0.0241696609792657,88310,0.553,67436,0.422
"5493","san luis obispo",5493,"2021-02-01",1703,33262,738,15529,965,17733,0,0,1401,19147,301,7041,1401,26188,"California",278862,0.0252490479161736,88310,0.553,67436,0.422
"5494","san luis obispo",5494,"2021-02-02",1895,35157,677,16206,1218,18951,0,0,1521,20294,374,7415,1521,27709,"California",278862,0.026590213080305,88310,0.553,67436,0.422
"5495","san luis obispo",5495,"2021-02-03",1706,36863,728,16934,978,19929,0,0,1293,21174,413,7828,1293,29002,"California",278862,0.0280712323658297,88310,0.553,67436,0.422
"5496","san luis obispo",5496,"2021-02-04",1659,38522,801,17735,858,20787,0,0,1092,21699,567,8395,1092,30094,"California",278862,0.0301044961307026,88310,0.553,67436,0.422
"5497","san luis obispo",5497,"2021-02-05",1603,40125,717,18452,886,21673,0,0,1058,22212,546,8941,1059,31153,"California",278862,0.0320624538302099,88310,0.553,67436,0.422
"5498","san luis obispo",5498,"2021-02-06",159,40284,92,18544,67,21740,0,0,93,22239,66,9007,93,31246,"California",278862,0.0322991300356449,88310,0.553,67436,0.422
"5499","san luis obispo",5499,"2021-02-07",144,40428,99,18643,45,21785,0,0,74,22244,70,9077,75,31321,"California",278862,0.0325501502535304,88310,0.553,67436,0.422
"5500","san luis obispo",5500,"2021-02-08",858,41286,470,19113,388,22173,0,0,498,22383,359,9436,498,31819,"California",278862,0.033837525370972,88310,0.553,67436,0.422
"5501","san luis obispo",5501,"2021-02-09",1123,42409,449,19562,674,22847,0,0,542,22357,575,10011,549,32368,"California",278862,0.0358994771607462,88310,0.553,67436,0.422
"5502","san luis obispo",5502,"2021-02-10",1430,43839,487,20049,943,23790,0,0,524,21981,903,10914,527,32895,"California",278862,0.0391376379714698,88310,0.553,67436,0.422
"5503","san luis obispo",5503,"2021-02-11",1330,45169,844,20893,486,24276,0,0,655,21964,672,11586,655,33550,"California",278862,0.041547432063171,88310,0.553,67436,0.422
"5504","san luis obispo",5504,"2021-02-12",786,45955,363,21256,423,24699,0,0,417,22012,369,11955,417,33967,"California",278862,0.0428706672117391,88310,0.553,67436,0.422
"5505","san luis obispo",5505,"2021-02-13",393,46348,127,21383,266,24965,0,0,285,22190,107,12062,285,34252,"California",278862,0.0432543695447928,88310,0.553,67436,0.422
"5506","san luis obispo",5506,"2021-02-14",318,46666,41,21424,277,25242,0,0,282,22437,36,12098,283,34535,"California",278862,0.0433834656568482,88310,0.553,67436,0.422
"5507","san luis obispo",5507,"2021-02-15",725,47391,137,21561,588,25830,0,0,469,22653,253,12351,469,35004,"California",278862,0.0442907244443488,88310,0.553,67436,0.422
"5508","san luis obispo",5508,"2021-02-16",2963,50354,1196,22757,1767,27597,0,0,1359,22414,1598,13949,1359,36363,"California",278862,0.0500211574183646,88310,0.553,67436,0.422
"5509","san luis obispo",5509,"2021-02-17",2776,53130,1238,23995,1538,29135,0,0,1029,21705,1738,15687,1029,37392,"California",278862,0.0562536308281516,88310,0.553,67436,0.422
"5510","san luis obispo",5510,"2021-02-18",2823,55953,1457,25452,1366,30501,0,0,1133,21157,1682,17369,1134,38526,"California",278862,0.06228528806363,88310,0.553,67436,0.422
"5511","san luis obispo",5511,"2021-02-19",1456,57409,1336,26788,120,30621,0,0,1133,21968,322,17691,1133,39659,"California",278862,0.0634399810659036,88310,0.553,67436,0.422
"5512","san luis obispo",5512,"2021-02-20",252,57661,81,26869,171,30792,0,0,215,22146,37,17728,215,39874,"California",278862,0.0635726631810716,88310,0.553,67436,0.422
"5513","san luis obispo",5513,"2021-02-21",54,57715,50,26919,4,30796,0,0,31,22154,23,17751,31,39905,"California",278862,0.0636551412526626,88310,0.553,67436,0.422
"5514","san luis obispo",5514,"2021-02-22",2411,60126,1864,28783,547,31343,0,0,1466,22676,945,18696,1467,41372,"California",278862,0.0670439141941175,88310,0.553,67436,0.422
"5515","san luis obispo",5515,"2021-02-23",1856,61982,1741,30524,115,31458,0,0,1363,23548,492,19188,1364,42736,"California",278862,0.0688082277255417,88310,0.553,67436,0.422
"5516","san luis obispo",5516,"2021-02-24",2644,64626,1301,31825,1343,32801,0,0,836,22579,1805,20993,836,43572,"California",278862,0.0752809633438762,88310,0.553,67436,0.422
"5517","san luis obispo",5517,"2021-02-25",2130,66756,1243,33068,887,33688,0,0,1206,22869,917,21910,1207,44779,"California",278862,0.0785693281981769,88310,0.553,67436,0.422
"5518","san luis obispo",5518,"2021-02-26",2644,69400,1148,34216,1496,35184,0,0,1324,22881,1312,23222,1324,46103,"California",278862,0.0832741642819746,88310,0.553,67436,0.422
"5519","san luis obispo",5519,"2021-02-27",565,69965,339,34555,226,35410,0,0,519,23354,46,23268,519,46622,"California",278862,0.0834391204251565,88310,0.553,67436,0.422
"5520","san luis obispo",5520,"2021-02-28",200,70165,73,34628,127,35537,0,0,163,23484,33,23301,163,46785,"California",278862,0.083557458527874,88310,0.553,67436,0.422
"5521","san luis obispo",5521,"2021-03-01",2964,73129,1846,36474,1116,36653,2,2,2039,24600,926,24227,2042,48827,"California",278862,0.0868780974101886,88310,0.553,67436,0.422
"5522","san luis obispo",5522,"2021-03-02",2992,76121,1887,38361,1105,37758,0,2,1847,25307,1141,25368,1848,50675,"California",278862,0.090969726961723,88310,0.553,67436,0.422
"5523","san luis obispo",5523,"2021-03-03",2278,78399,332,38693,1946,39704,0,2,830,24696,1442,26810,831,51506,"California",278862,0.0961407434501653,88310,0.553,67436,0.422
"5524","san luis obispo",5524,"2021-03-04",2181,80580,1152,39845,1029,40733,0,2,1168,24855,1011,27821,1170,52676,"California",278862,0.0997661925970552,88310,0.553,67436,0.422
"5525","san luis obispo",5525,"2021-03-05",2295,82875,1018,40863,1207,41940,70,72,1291,25227,989,28810,1361,54037,"California",278862,0.103312749675467,88310,0.553,67436,0.422
"5526","san luis obispo",5526,"2021-03-06",833,83708,309,41172,417,42357,107,179,613,25721,220,29030,714,54751,"California",278862,0.10410167036025,88310,0.553,67436,0.422
"5527","san luis obispo",5527,"2021-03-07",200,83908,32,41204,84,42441,84,263,71,25749,128,29158,156,54907,"California",278862,0.104560678758669,88310,0.553,67436,0.422
"5528","san luis obispo",5528,"2021-03-08",2727,86635,754,41958,1659,44100,314,577,1540,26418,1184,30342,1853,56760,"California",278862,0.108806506444048,88310,0.553,67436,0.422
"5529","san luis obispo",5529,"2021-03-09",2928,89563,955,42913,1726,45826,247,824,1508,26758,1416,31758,1756,58516,"California",278862,0.113884286851561,88310,0.553,67436,0.422
"5530","san luis obispo",5530,"2021-03-10",3192,92755,1238,44151,1672,47498,282,1106,1816,27484,1372,33130,2098,60614,"California",278862,0.118804283122118,88310,0.553,67436,0.422
"5531","san luis obispo",5531,"2021-03-11",3129,95884,1274,45425,1533,49031,322,1428,1703,28091,1417,34547,2024,62638,"California",278862,0.123885649532744,88310,0.553,67436,0.422
"5532","san luis obispo",5532,"2021-03-12",3211,99095,1281,46706,1592,50623,338,1766,1597,28423,1606,36153,1938,64576,"California",278862,0.129644770531661,88310,0.553,67436,0.422
"5533","san luis obispo",5533,"2021-03-13",794,99889,262,46968,423,51046,109,1875,431,28600,362,36515,539,65115,"California",278862,0.13094290365844,88310,0.553,67436,0.422
"5534","san luis obispo",5534,"2021-03-14",514,100403,53,47021,350,51396,111,1986,135,28468,378,36893,246,65361,"California",278862,0.132298412835022,88310,0.553,67436,0.422
"5535","san luis obispo",5535,"2021-03-15",3054,103457,1096,48117,1860,53256,98,2084,1530,28576,1520,38413,1628,66989,"California",278862,0.137749137566251,88310,0.553,67436,0.422
"5536","san luis obispo",5536,"2021-03-16",2848,106305,1509,49626,1229,54485,110,2194,1438,28719,1404,39817,1547,68536,"California",278862,0.142783885936413,88310,0.553,67436,0.422
"5537","san luis obispo",5537,"2021-03-17",3425,109730,1449,51075,1715,56200,261,2455,1977,29519,1437,41254,2237,70773,"California",278862,0.147936972409292,88310,0.553,67436,0.422
"5538","san luis obispo",5538,"2021-03-18",2809,112539,1448,52523,1150,57350,211,2666,1339,29603,1465,42719,1549,72322,"California",278862,0.153190466969325,88310,0.553,67436,0.422
"5539","san luis obispo",5539,"2021-03-19",2585,115124,1563,54086,701,58051,321,2987,961,29271,1616,44335,1284,73606,"California",278862,0.158985447999369,88310,0.553,67436,0.422
"5540","san luis obispo",5540,"2021-03-20",833,115957,496,54582,300,58351,37,3024,385,29245,448,44783,422,74028,"California",278862,0.160591977393836,88310,0.553,67436,0.422
"5541","san luis obispo",5541,"2021-03-21",187,116144,45,54627,139,58490,3,3027,157,29376,29,44812,160,74188,"California",278862,0.160695971484103,88310,0.553,67436,0.422
"5542","san luis obispo",5542,"2021-03-22",2684,118828,1169,55796,1467,59957,48,3075,1863,30471,816,45628,1911,76099,"California",278862,0.163622150024026,88310,0.553,67436,0.422
"5543","san luis obispo",5543,"2021-03-23",3370,122198,2210,58006,1131,61088,29,3104,2267,31668,1099,46727,2296,78395,"California",278862,0.167563167444829,88310,0.553,67436,0.422
"5544","san luis obispo",5544,"2021-03-24",3501,125699,2132,60138,1285,62373,84,3188,2614,33483,882,47609,2697,81092,"California",278862,0.170726022190187,88310,0.553,67436,0.422
"5545","san luis obispo",5545,"2021-03-25",3663,129362,2291,62429,1360,63733,12,3200,2633,35101,1026,48635,2644,83736,"California",278862,0.174405261383767,88310,0.553,67436,0.422
"5546","san luis obispo",5546,"2021-03-26",3143,132505,1755,64184,956,64689,432,3632,1747,35889,1391,50026,2179,85915,"California",278862,0.179393391713464,88310,0.553,67436,0.422
"5547","san luis obispo",5547,"2021-03-27",993,133498,508,64692,393,65082,92,3724,452,35894,539,50565,544,86459,"California",278862,0.181326247391183,88310,0.553,67436,0.422
"5548","san luis obispo",5548,"2021-03-28",443,133941,151,64843,236,65318,56,3780,242,35991,201,50766,298,86757,"California",278862,0.182047034016826,88310,0.553,67436,0.422
"5549","san luis obispo",5549,"2021-03-29",2575,136516,1275,66118,1167,66485,133,3913,1647,36857,914,51680,1780,88537,"California",278862,0.185324640861788,88310,0.553,67436,0.422
"5550","san luis obispo",5550,"2021-03-30",3495,140011,1907,68025,1447,67932,141,4054,2344,38194,1146,52826,2483,91020,"California",278862,0.189434200428886,88310,0.553,67436,0.422
"5551","san luis obispo",5551,"2021-03-31",3842,143853,2459,70484,1236,69168,147,4201,2475,39460,1357,54183,2623,93643,"California",278862,0.194300406652753,88310,0.553,67436,0.422
"5552","san luis obispo",5552,"2021-04-01",3820,147673,2418,72902,1286,70454,116,4317,2683,41132,1126,55309,2798,96441,"California",278862,0.198338246157598,88310,0.553,67436,0.422
"5553","san luis obispo",5553,"2021-04-02",1752,149425,686,73588,755,71209,311,4628,955,41600,796,56105,1264,97705,"California",278862,0.201192704635268,88310,0.553,67436,0.422
"5554","san luis obispo",5554,"2021-04-03",1103,150528,554,74142,422,71631,127,4755,487,41602,612,56717,614,98319,"California",278862,0.20338733854021,88310,0.553,67436,0.422
"5555","san luis obispo",5555,"2021-04-04",380,150908,130,74272,210,71841,40,4795,234,41730,146,56863,274,98593,"California",278862,0.203910894994657,88310,0.553,67436,0.422
"5556","san luis obispo",5556,"2021-04-05",3610,154518,1944,76216,1556,73397,110,4905,2044,42319,1563,58426,2152,100745,"California",278862,0.20951581785973,88310,0.553,67436,0.422
"5557","san luis obispo",5557,"2021-04-06",4032,158550,2146,78362,1564,74961,322,5227,1955,42527,2069,60495,2277,103022,"California",278862,0.216935258299804,88310,0.553,67436,0.422
"5558","san luis obispo",5558,"2021-04-07",4286,162836,2341,80703,1583,76544,362,5589,2470,43555,1802,62297,2830,105852,"California",278862,0.223397235908801,88310,0.553,67436,0.422
"5559","san luis obispo",5559,"2021-04-08",4023,166859,2196,82899,1425,77969,402,5991,2179,44299,1837,64134,2581,108433,"California",278862,0.22998472362674,88310,0.553,67436,0.422
"5560","san luis obispo",5560,"2021-04-09",3646,170505,1733,84632,1157,79126,756,6747,1539,44491,2098,66232,2290,110723,"California",278862,0.237508158157081,88310,0.553,67436,0.422
"5561","san luis obispo",5561,"2021-04-10",1571,172076,558,85190,351,79477,662,7409,483,44546,1088,67320,1143,111866,"California",278862,0.241409729543645,88310,0.553,67436,0.422
"5562","san luis obispo",5562,"2021-04-11",311,172387,63,85253,185,79662,63,7472,124,44548,185,67505,187,112053,"California",278862,0.242073140119486,88310,0.553,67436,0.422
"5563","san luis obispo",5563,"2021-04-12",3373,175760,1696,86949,1513,81175,164,7636,1414,44168,1957,69462,1577,113630,"California",278862,0.249090948210943,88310,0.553,67436,0.422
"5564","san luis obispo",5564,"2021-04-13",3640,179400,2096,89045,1543,82718,1,7637,1970,44473,1667,71129,1972,115602,"California",278862,0.255068815399732,88310,0.553,67436,0.422
"5565","san luis obispo",5565,"2021-04-14",2847,182247,1681,90726,1163,83881,3,7640,1662,44961,1174,72303,1662,117264,"California",278862,0.259278783053984,88310,0.553,67436,0.422
"5566","san luis obispo",5566,"2021-04-15",3666,185913,2376,93102,1289,85170,1,7641,1957,45228,1692,73995,1959,119223,"California",278862,0.265346300320589,88310,0.553,67436,0.422
"5567","san luis obispo",5567,"2021-04-16",3604,189517,2189,95291,1412,86582,3,7644,1797,45223,1803,75798,1798,121021,"California",278862,0.271811863932698,88310,0.553,67436,0.422
"5568","san luis obispo",5568,"2021-04-17",1099,190616,433,95724,664,87246,2,7646,716,45561,380,76178,718,121739,"California",278862,0.273174545115505,88310,0.553,67436,0.422
"5569","san luis obispo",5569,"2021-04-18",319,190935,97,95821,221,87467,1,7647,109,45463,207,76385,109,121848,"California",278862,0.273916847759824,88310,0.553,67436,0.422
"5570","san luis obispo",5570,"2021-04-19",3078,194013,1285,97106,1755,89222,38,7685,1131,44689,1944,78329,1170,123018,"California",278862,0.280888037810817,88310,0.553,67436,0.422
"5571","san luis obispo",5571,"2021-04-20",3559,197572,1933,99039,1626,90848,0,7685,1373,43888,2174,80503,1373,124391,"California",278862,0.288684008577719,88310,0.553,67436,0.422
"5572","san luis obispo",5572,"2021-04-21",3901,201473,1792,100831,2109,92957,0,7685,1628,43260,2256,82759,1628,126019,"California",278862,0.296774031599859,88310,0.553,67436,0.422
"5573","san luis obispo",5573,"2021-04-22",4574,206047,2060,102891,2514,95471,0,7685,1504,41711,3055,85814,1506,127525,"California",278862,0.307729271109007,88310,0.553,67436,0.422
"5574","san luis obispo",5574,"2021-04-23",1467,207514,850,103741,613,96084,4,7689,704,41669,757,86571,715,128240,"California",278862,0.310443875465284,88310,0.553,67436,0.422
"5575","san luis obispo",5575,"2021-04-24",1083,208597,444,104185,620,96704,19,7708,494,41599,583,87154,513,128753,"California",278862,0.312534515279959,88310,0.553,67436,0.422
"5576","san luis obispo",5576,"2021-04-25",345,208942,162,104347,183,96887,0,7708,113,41481,231,87385,113,128866,"California",278862,0.313362881998982,88310,0.553,67436,0.422
"5577","san luis obispo",5577,"2021-04-26",913,209855,292,104639,604,97491,17,7725,334,41264,567,87952,350,129216,"California",278862,0.315396145763854,88310,0.553,67436,0.422
"5578","san luis obispo",5578,"2021-04-27",3593,213448,1842,106481,1684,99175,67,7792,1373,40490,2213,90165,1439,130655,"California",278862,0.323331970652151,88310,0.553,67436,0.422
"5579","san luis obispo",5579,"2021-04-28",3706,217154,2081,108562,1553,100728,72,7864,1277,39423,2416,92581,1349,132004,"California",278862,0.331995754172315,88310,0.553,67436,0.422
"5580","san luis obispo",5580,"2021-04-29",3625,220779,2095,110657,1460,102188,70,7934,1187,38255,2426,95007,1258,133262,"California",278862,0.340695397723605,88310,0.553,67436,0.422
"5581","san luis obispo",5581,"2021-04-30",2934,223713,1641,112298,1220,103408,73,8007,911,37228,2010,97017,983,134245,"California",278862,0.347903263980033,88310,0.553,67436,0.422
"5582","san luis obispo",5582,"2021-05-01",465,224178,158,112456,271,103679,36,8043,97,37000,360,97377,132,134377,"California",278862,0.349194225100587,88310,0.553,67436,0.422
"5583","san luis obispo",5583,"2021-05-02",168,224346,52,112508,96,103775,20,8063,42,36936,126,97503,62,134439,"California",278862,0.349646061492781,88310,0.553,67436,0.422
"5584","san luis obispo",5584,"2021-05-03",881,225227,289,112797,493,104268,99,8162,225,36607,652,98155,323,134762,"California",278862,0.35198413552223,88310,0.553,67436,0.422
"5585","san luis obispo",5585,"2021-05-04",2921,228148,1887,114684,968,105236,66,8228,864,35485,2050,100205,928,135690,"California",278862,0.359335441903164,88310,0.553,67436,0.422
"5586","san luis obispo",5586,"2021-05-05",2798,230946,1853,116537,884,106120,61,8289,695,34150,2092,102297,757,136447,"California",278862,0.366837360414829,88310,0.553,67436,0.422
"5587","san luis obispo",5587,"2021-05-06",2763,233709,1868,118405,840,106960,55,8344,726,32909,2022,104319,781,137228,"California",278862,0.374088258708609,88310,0.553,67436,0.422
"5588","san luis obispo",5588,"2021-05-07",2294,236003,1736,120141,495,107455,63,8407,599,31902,1670,105989,663,137891,"California",278862,0.380076883906735,88310,0.553,67436,0.422
"5589","san luis obispo",5589,"2021-05-08",566,236569,340,120481,202,107657,24,8431,189,31756,359,106348,213,138104,"California",278862,0.381364259024177,88310,0.553,67436,0.422
"5590","san mateo",5590,"2020-12-15",26,26,26,26,0,0,0,0,26,26,0,0,26,26,"California",778001,0,291496,0.779,75584,0.202
"5591","san mateo",5591,"2020-12-16",111,137,111,137,0,0,0,0,111,137,0,0,111,137,"California",778001,0,291496,0.779,75584,0.202
"5592","san mateo",5592,"2020-12-17",164,301,164,301,0,0,0,0,164,301,0,0,164,301,"California",778001,0,291496,0.779,75584,0.202
"5593","san mateo",5593,"2020-12-18",741,1042,739,1040,2,2,0,0,741,1042,0,0,741,1042,"California",778001,0,291496,0.779,75584,0.202
"5594","san mateo",5594,"2020-12-19",514,1556,514,1554,0,2,0,0,514,1556,0,0,514,1556,"California",778001,0,291496,0.779,75584,0.202
"5595","san mateo",5595,"2020-12-20",512,2068,510,2064,2,4,0,0,512,2068,0,0,512,2068,"California",778001,0,291496,0.779,75584,0.202
"5596","san mateo",5596,"2020-12-21",1156,3224,1156,3220,0,4,0,0,1156,3224,0,0,1156,3224,"California",778001,0,291496,0.779,75584,0.202
"5597","san mateo",5597,"2020-12-22",1523,4747,1516,4736,7,11,0,0,1523,4747,0,0,1523,4747,"California",778001,0,291496,0.779,75584,0.202
"5598","san mateo",5598,"2020-12-23",1575,6322,1386,6122,189,200,0,0,1575,6322,0,0,1575,6322,"California",778001,0,291496,0.779,75584,0.202
"5599","san mateo",5599,"2020-12-24",868,7190,611,6733,257,457,0,0,868,7190,0,0,868,7190,"California",778001,0,291496,0.779,75584,0.202
"5600","san mateo",5600,"2020-12-25",115,7305,111,6844,4,461,0,0,115,7305,0,0,115,7305,"California",778001,0,291496,0.779,75584,0.202
"5601","san mateo",5601,"2020-12-26",561,7866,418,7262,143,604,0,0,561,7866,0,0,561,7866,"California",778001,0,291496,0.779,75584,0.202
"5602","san mateo",5602,"2020-12-27",307,8173,176,7438,131,735,0,0,307,8173,0,0,307,8173,"California",778001,0,291496,0.779,75584,0.202
"5603","san mateo",5603,"2020-12-28",1052,9225,705,8143,347,1082,0,0,1052,9225,0,0,1052,9225,"California",778001,0,291496,0.779,75584,0.202
"5604","san mateo",5604,"2020-12-29",1130,10355,706,8849,424,1506,0,0,1130,10355,0,0,1130,10355,"California",778001,0,291496,0.779,75584,0.202
"5605","san mateo",5605,"2020-12-30",1264,11619,760,9609,504,2010,0,0,1264,11619,0,0,1264,11619,"California",778001,0,291496,0.779,75584,0.202
"5606","san mateo",5606,"2020-12-31",716,12335,231,9840,485,2495,0,0,715,12333,1,1,715,12334,"California",778001,1.2853453915869e-06,291496,0.779,75584,0.202
"5607","san mateo",5607,"2021-01-01",63,12398,44,9884,19,2514,0,0,63,12396,0,1,63,12397,"California",778001,1.2853453915869e-06,291496,0.779,75584,0.202
"5608","san mateo",5608,"2021-01-02",400,12798,270,10154,130,2644,0,0,400,12796,0,1,400,12797,"California",778001,1.2853453915869e-06,291496,0.779,75584,0.202
"5609","san mateo",5609,"2021-01-03",283,13081,208,10362,75,2719,0,0,280,13073,3,4,280,13077,"California",778001,5.1413815663476e-06,291496,0.779,75584,0.202
"5610","san mateo",5610,"2021-01-04",1053,14134,680,11042,373,3092,0,0,1053,14126,0,4,1053,14130,"California",778001,5.1413815663476e-06,291496,0.779,75584,0.202
"5611","san mateo",5611,"2021-01-05",1201,15335,705,11747,496,3588,0,0,1172,15270,29,33,1173,15303,"California",778001,4.24163979223677e-05,291496,0.779,75584,0.202
"5612","san mateo",5612,"2021-01-06",1449,16784,951,12698,498,4086,0,0,1267,16358,180,213,1268,16571,"California",778001,0.00027377856840801,291496,0.779,75584,0.202
"5613","san mateo",5613,"2021-01-07",1457,18241,811,13509,646,4732,0,0,1167,17243,283,496,1168,17739,"California",778001,0.000637531314227103,291496,0.779,75584,0.202
"5614","san mateo",5614,"2021-01-08",1840,20081,1191,14700,649,5381,0,0,1141,17693,692,1188,1142,18881,"California",778001,0.00152699032520524,291496,0.779,75584,0.202
"5615","san mateo",5615,"2021-01-09",1181,21262,777,15477,404,5785,0,0,722,17956,459,1647,722,19603,"California",778001,0.00211696385994362,291496,0.779,75584,0.202
"5616","san mateo",5616,"2021-01-10",704,21966,575,16052,129,5914,0,0,266,17784,438,2085,266,19869,"California",778001,0.00267994514145869,291496,0.779,75584,0.202
"5617","san mateo",5617,"2021-01-11",2593,24559,1485,17537,1108,7022,0,0,1526,18244,1068,3153,1528,21397,"California",778001,0.0040526940196735,291496,0.779,75584,0.202
"5618","san mateo",5618,"2021-01-12",3285,27844,1777,19314,1508,8530,0,0,2100,19164,1183,4336,2103,23500,"California",778001,0.0055732576179208,291496,0.779,75584,0.202
"5619","san mateo",5619,"2021-01-13",3484,31328,1755,21069,1729,10259,0,0,2448,20579,1036,5372,2451,25951,"California",778001,0.00690487544360483,291496,0.779,75584,0.202
"5620","san mateo",5620,"2021-01-14",3777,35105,1584,22653,2193,12452,0,0,3091,22989,686,6058,3096,29047,"California",778001,0.00778662238223344,291496,0.779,75584,0.202
"5621","san mateo",5621,"2021-01-15",4328,39433,1709,24362,2619,15071,0,0,3799,26263,527,6585,3801,32848,"California",778001,0.00846399940359974,291496,0.779,75584,0.202
"5622","san mateo",5622,"2021-01-16",3086,42519,776,25138,2310,17381,0,0,2765,28707,321,6906,2765,35613,"California",778001,0.00887659527429913,291496,0.779,75584,0.202
"5623","san mateo",5623,"2021-01-17",1312,43831,310,25448,1002,18383,0,0,1102,29599,210,7116,1102,36715,"California",778001,0.00914651780653238,291496,0.779,75584,0.202
"5624","san mateo",5624,"2021-01-18",1364,45195,533,25981,831,19214,0,0,990,30222,371,7487,994,37709,"California",778001,0.00962338094681112,291496,0.779,75584,0.202
"5625","san mateo",5625,"2021-01-19",2798,47993,1786,27767,1012,20226,0,0,2004,31435,791,8278,2004,39713,"California",778001,0.0106400891515564,291496,0.779,75584,0.202
"5626","san mateo",5626,"2021-01-20",2799,50792,1544,29311,1255,21481,0,0,1954,32548,842,9120,1955,41668,"California",778001,0.0117223499712725,291496,0.779,75584,0.202
"5627","san mateo",5627,"2021-01-21",2846,53638,1297,30608,1549,23030,0,0,2253,34213,591,9711,2256,43924,"California",778001,0.0124819890977004,291496,0.779,75584,0.202
"5628","san mateo",5628,"2021-01-22",2798,56436,1137,31745,1661,24691,0,0,2499,36416,297,10008,2500,46424,"California",778001,0.0128637366790017,291496,0.779,75584,0.202
"5629","san mateo",5629,"2021-01-23",2885,59321,1690,33435,1195,25886,0,0,2521,38574,364,10372,2522,48946,"California",778001,0.0133316024015393,291496,0.779,75584,0.202
"5630","san mateo",5630,"2021-01-24",1521,60842,375,33810,1146,27032,0,0,1209,39473,311,10683,1210,50156,"California",778001,0.0137313448183229,291496,0.779,75584,0.202
"5631","san mateo",5631,"2021-01-25",4434,65276,3149,36959,1285,28317,0,0,3538,42120,894,11577,3541,53697,"California",778001,0.0148804435984015,291496,0.779,75584,0.202
"5632","san mateo",5632,"2021-01-26",4294,69570,2979,39938,1315,29632,0,0,3391,44609,902,12479,3391,57088,"California",778001,0.0160398251416129,291496,0.779,75584,0.202
"5633","san mateo",5633,"2021-01-27",2791,72361,1473,41411,1318,30950,0,0,1794,45414,990,13469,1795,58883,"California",778001,0.017312317079284,291496,0.779,75584,0.202
"5634","san mateo",5634,"2021-01-28",2806,75167,1357,42768,1449,32399,0,0,1955,46533,836,14305,1955,60838,"California",778001,0.0183868658266506,291496,0.779,75584,0.202
"5635","san mateo",5635,"2021-01-29",2985,78152,1340,44108,1645,34044,0,0,2152,47858,830,15135,2155,62993,"California",778001,0.0194537025016677,291496,0.779,75584,0.202
"5636","san mateo",5636,"2021-01-30",3373,81525,1476,45584,1897,35941,0,0,2915,50317,457,15592,2916,65909,"California",778001,0.020041105345623,291496,0.779,75584,0.202
"5637","san mateo",5637,"2021-01-31",1681,83206,897,46481,784,36725,0,0,1518,51674,161,15753,1518,67427,"California",778001,0.0202480459536684,291496,0.779,75584,0.202
"5638","san mateo",5638,"2021-02-01",2929,86135,1345,47826,1584,38309,0,0,2221,53192,704,16457,2222,69649,"California",778001,0.0211529291093456,291496,0.779,75584,0.202
"5639","san mateo",5639,"2021-02-02",3178,89313,1731,49557,1447,39756,0,0,2158,54333,1017,17474,2158,71807,"California",778001,0.0224601253725895,291496,0.779,75584,0.202
"5640","san mateo",5640,"2021-02-03",4885,94198,1952,51509,2933,42689,0,0,3831,57114,1051,18525,3832,75639,"California",778001,0.0238110233791473,291496,0.779,75584,0.202
"5641","san mateo",5641,"2021-02-04",6297,100495,2592,54101,3705,46394,0,0,4938,60702,1353,19878,4941,80580,"California",778001,0.0255500956939644,291496,0.779,75584,0.202
"5642","san mateo",5642,"2021-02-05",6800,107295,2551,56652,4249,50643,0,0,4976,63871,1807,21685,4976,85556,"California",778001,0.0278727148165619,291496,0.779,75584,0.202
"5643","san mateo",5643,"2021-02-06",3282,110577,1916,58568,1366,52009,0,0,2617,65826,664,22349,2619,88175,"California",778001,0.0287261841565756,291496,0.779,75584,0.202
"5644","san mateo",5644,"2021-02-07",1896,112473,1342,59910,554,52563,0,0,1709,67348,187,22536,1709,89884,"California",778001,0.0289665437448024,291496,0.779,75584,0.202
"5645","san mateo",5645,"2021-02-08",5281,117754,2248,62158,3033,55596,0,0,3107,68346,2109,24645,3107,92991,"California",778001,0.0316773371756592,291496,0.779,75584,0.202
"5646","san mateo",5646,"2021-02-09",6190,123944,3225,65383,2965,58561,0,0,3343,68847,2842,27487,3343,96334,"California",778001,0.0353302887785491,291496,0.779,75584,0.202
"5647","san mateo",5647,"2021-02-10",6502,130446,3274,68657,3228,61789,0,0,3428,69210,3065,30552,3428,99762,"California",778001,0.039269872403763,291496,0.779,75584,0.202
"5648","san mateo",5648,"2021-02-11",7058,137504,3582,72239,3476,65265,0,0,3803,69771,3245,33797,3806,103568,"California",778001,0.0434408181994625,291496,0.779,75584,0.202
"5649","san mateo",5649,"2021-02-12",6621,144125,2952,75191,3669,68934,0,0,4699,72552,1920,35717,4701,108269,"California",778001,0.0459086813513093,291496,0.779,75584,0.202
"5650","san mateo",5650,"2021-02-13",6096,150221,3995,79186,2101,71035,0,0,2642,71744,3450,39167,2642,110911,"California",778001,0.0503431229522841,291496,0.779,75584,0.202
"5651","san mateo",5651,"2021-02-14",4634,154855,3018,82204,1616,72651,0,0,1986,71087,2644,41811,1987,112898,"California",778001,0.0537415761676399,291496,0.779,75584,0.202
"5652","san mateo",5652,"2021-02-15",3166,158021,1459,83663,1707,74358,0,0,1784,71494,1378,43189,1785,114683,"California",778001,0.0555127821172466,291496,0.779,75584,0.202
"5653","san mateo",5653,"2021-02-16",7152,165173,1876,85539,5276,79634,0,0,5283,74911,1868,45057,5285,119968,"California",778001,0.057913807308731,291496,0.779,75584,0.202
"5654","san mateo",5654,"2021-02-17",7057,172230,1938,87477,5119,84753,0,0,5061,77983,1991,47048,5063,125031,"California",778001,0.0604729299833805,291496,0.779,75584,0.202
"5655","san mateo",5655,"2021-02-18",6700,178930,4628,92105,2072,86825,0,0,4451,80193,2244,49292,4454,129485,"California",778001,0.0633572450421015,291496,0.779,75584,0.202
"5656","san mateo",5656,"2021-02-19",7811,186741,5612,97717,2199,89024,0,0,5816,84020,1989,51281,5816,135301,"California",778001,0.0659137970259678,291496,0.779,75584,0.202
"5657","san mateo",5657,"2021-02-20",3734,190475,2419,100136,1315,90339,0,0,2308,84909,1419,52700,2308,137609,"California",778001,0.0677377021366296,291496,0.779,75584,0.202
"5658","san mateo",5658,"2021-02-21",2311,192786,1467,101603,844,91183,0,0,1264,85132,1041,53741,1264,138873,"California",778001,0.0690757466892716,291496,0.779,75584,0.202
"5659","san mateo",5659,"2021-02-22",4420,197206,3197,104800,1223,92406,0,0,2780,86279,1634,55375,2781,141654,"California",778001,0.0711760010591246,291496,0.779,75584,0.202
"5660","san mateo",5660,"2021-02-23",4292,201498,3047,107847,1245,93651,0,0,2484,86962,1801,57176,2484,144138,"California",778001,0.0734909081093726,291496,0.779,75584,0.202
"5661","san mateo",5661,"2021-02-24",7273,208771,3254,111101,4019,97670,0,0,4847,89389,2421,59597,4848,148986,"California",778001,0.0766027293024045,291496,0.779,75584,0.202
"5662","san mateo",5662,"2021-02-25",9091,217862,4013,115114,5078,102748,0,0,6017,92347,3059,62656,6017,155003,"California",778001,0.0805346008552688,291496,0.779,75584,0.202
"5663","san mateo",5663,"2021-02-26",9774,227636,3718,118832,6056,108804,0,0,6848,96287,2912,65568,6852,161855,"California",778001,0.0842775266355699,291496,0.779,75584,0.202
"5664","san mateo",5664,"2021-02-27",6681,234317,3413,122245,3267,112071,1,1,3633,96884,3042,68610,3639,165494,"California",778001,0.0881875473167772,291496,0.779,75584,0.202
"5665","san mateo",5665,"2021-02-28",4123,238440,2505,124750,1618,113689,0,1,2553,97874,1564,70174,2554,168048,"California",778001,0.0901978275092191,291496,0.779,75584,0.202
"5666","san mateo",5666,"2021-03-01",5659,244099,3539,128289,2119,115808,1,2,2799,97826,2848,73022,2800,170848,"California",778001,0.0938584911844586,291496,0.779,75584,0.202
"5667","san mateo",5667,"2021-03-02",5802,249901,3990,132279,1811,117619,1,3,3340,98714,2454,75476,3342,174190,"California",778001,0.0970127287754129,291496,0.779,75584,0.202
"5668","san mateo",5668,"2021-03-03",8355,258256,3903,136182,4450,122069,2,5,3605,97584,4738,80214,3608,177798,"California",778001,0.103102695240752,291496,0.779,75584,0.202
"5669","san mateo",5669,"2021-03-04",8425,266681,3939,140121,4483,126552,3,8,3803,96789,4603,84817,3808,181606,"California",778001,0.109019140078226,291496,0.779,75584,0.202
"5670","san mateo",5670,"2021-03-05",9102,275783,5991,146112,3107,129659,4,12,6420,100556,2661,87478,6428,188034,"California",778001,0.112439444165239,291496,0.779,75584,0.202
"5671","san mateo",5671,"2021-03-06",7858,283641,5444,151556,2238,131897,176,188,5745,104371,2104,89582,5919,193953,"California",778001,0.115143810869138,291496,0.779,75584,0.202
"5672","san mateo",5672,"2021-03-07",3473,287114,2317,153873,1089,132986,67,255,2008,104985,1461,91043,2075,196028,"California",778001,0.117021700486246,291496,0.779,75584,0.202
"5673","san mateo",5673,"2021-03-08",4449,291563,2481,156354,1750,134736,218,473,3224,107211,1217,92260,3443,199471,"California",778001,0.118585965827807,291496,0.779,75584,0.202
"5674","san mateo",5674,"2021-03-09",4563,296126,2131,158485,2159,136895,273,746,3014,108955,1541,93801,3285,202756,"California",778001,0.120566683076243,291496,0.779,75584,0.202
"5675","san mateo",5675,"2021-03-10",6922,303048,2644,161129,3991,140886,287,1033,4566,111465,2342,96143,4852,207608,"California",778001,0.123576961983339,291496,0.779,75584,0.202
"5676","san mateo",5676,"2021-03-11",9140,312188,5739,166868,3008,143894,393,1426,3719,110185,5391,101534,4111,211719,"California",778001,0.130506258989384,291496,0.779,75584,0.202
"5677","san mateo",5677,"2021-03-12",10512,322700,6610,173478,3520,147414,382,1808,3507,107087,6988,108522,3890,215609,"California",778001,0.139488252585794,291496,0.779,75584,0.202
"5678","san mateo",5678,"2021-03-13",8108,330808,3423,176901,3057,150471,1628,3436,3916,108442,4180,112702,5535,221144,"California",778001,0.144860996322627,291496,0.779,75584,0.202
"5679","san mateo",5679,"2021-03-14",4937,335745,3305,180206,1525,151996,107,3543,2899,109417,2031,114733,3006,224150,"California",778001,0.14747153281294,291496,0.779,75584,0.202
"5680","san mateo",5680,"2021-03-15",7128,342873,4581,184787,2371,154367,176,3719,3770,110012,3352,118085,3947,228097,"California",778001,0.151780010565539,291496,0.779,75584,0.202
"5681","san mateo",5681,"2021-03-16",11912,354785,4360,189147,7429,161796,123,3842,4860,107961,7036,125121,4985,233082,"California",778001,0.160823700740745,291496,0.779,75584,0.202
"5682","san mateo",5682,"2021-03-17",10800,365585,4366,193513,6309,168105,125,3967,4897,107110,5877,130998,5026,238108,"California",778001,0.168377675607101,291496,0.779,75584,0.202
"5683","san mateo",5683,"2021-03-18",7245,372830,4042,197555,3020,171125,183,4150,4317,108687,2921,133919,4498,242606,"California",778001,0.172132169495926,291496,0.779,75584,0.202
"5684","san mateo",5684,"2021-03-19",7362,380192,4721,202276,1974,173099,667,4817,3610,109222,3742,137661,4277,246883,"California",778001,0.176941931951244,291496,0.779,75584,0.202
"5685","san mateo",5685,"2021-03-20",8291,388483,6435,208711,1520,174619,336,5153,5417,112115,2859,140520,5752,252635,"California",778001,0.180616734425791,291496,0.779,75584,0.202
"5686","san mateo",5686,"2021-03-21",4157,392640,3126,211837,800,175419,231,5384,2347,112891,1799,142319,2575,255210,"California",778001,0.182929070785256,291496,0.779,75584,0.202
"5687","san mateo",5687,"2021-03-22",5225,397865,3547,215384,1259,176678,419,5803,2862,113824,2349,144668,3282,258492,"California",778001,0.185948347110094,291496,0.779,75584,0.202
"5688","san mateo",5688,"2021-03-23",9782,407647,4449,219833,5137,181815,196,5999,4662,113590,5091,149759,4857,263349,"California",778001,0.192492040498663,291496,0.779,75584,0.202
"5689","san mateo",5689,"2021-03-24",9445,417092,5446,225279,3859,185674,140,6139,4107,112563,5271,155030,4244,267593,"California",778001,0.199267096057717,291496,0.779,75584,0.202
"5690","san mateo",5690,"2021-03-25",10021,427113,4883,230162,4870,190544,268,6407,4431,111777,5488,160518,4702,272295,"California",778001,0.206321071566746,291496,0.779,75584,0.202
"5691","san mateo",5691,"2021-03-26",11150,438263,7666,237828,3319,193863,165,6572,4453,109736,6660,167178,4619,276914,"California",778001,0.214881471874715,291496,0.779,75584,0.202
"5692","san mateo",5692,"2021-03-27",10437,448700,7969,245797,2363,196226,105,6677,4698,108815,5721,172899,4800,281714,"California",778001,0.222234932859983,291496,0.779,75584,0.202
"5693","san mateo",5693,"2021-03-28",4214,452914,2699,248496,1404,197630,111,6788,2105,108932,2100,174999,2217,283931,"California",778001,0.224934158182316,291496,0.779,75584,0.202
"5694","san mateo",5694,"2021-03-29",6020,458934,3746,252242,2021,199651,253,7041,2851,108886,3150,178149,3104,287035,"California",778001,0.228982996165815,291496,0.779,75584,0.202
"5695","san mateo",5695,"2021-03-30",7084,466018,4016,256258,2913,202564,155,7196,4462,110896,2607,180756,4617,291652,"California",778001,0.232333891601682,291496,0.779,75584,0.202
"5696","san mateo",5696,"2021-03-31",7210,473228,4554,260812,2518,205082,138,7334,4062,111964,3132,183888,4200,295852,"California",778001,0.236359593368132,291496,0.779,75584,0.202
"5697","san mateo",5697,"2021-04-01",10424,483652,5117,265929,4126,209208,1181,8515,5602,113960,4782,188670,6778,302630,"California",778001,0.2425061150307,291496,0.779,75584,0.202
"5698","san mateo",5698,"2021-04-02",10665,494317,5080,271009,4021,213229,1564,10079,5605,116084,5043,193713,7167,309797,"California",778001,0.248988111840473,291496,0.779,75584,0.202
"5699","san mateo",5699,"2021-04-03",9690,504007,5495,276504,2459,215688,1736,11815,4904,117944,4782,198495,6642,316439,"California",778001,0.255134633503042,291496,0.779,75584,0.202
"5700","san mateo",5700,"2021-04-04",5405,509412,2605,279109,1552,217240,1248,13063,1721,117239,3672,202167,2967,319406,"California",778001,0.259854421780949,291496,0.779,75584,0.202
"5701","san mateo",5701,"2021-04-05",8966,518378,4773,283882,2458,219698,1735,14798,3865,117751,5086,207253,5598,325004,"California",778001,0.26639168844256,291496,0.779,75584,0.202
"5702","san mateo",5702,"2021-04-06",13120,531498,8208,292090,3062,222760,1850,16648,7499,121500,5608,212861,9357,334361,"California",778001,0.273599905398579,291496,0.779,75584,0.202
"5703","san mateo",5703,"2021-04-07",11338,542836,5246,297336,4418,227178,1674,18322,4820,121492,6496,219357,6488,340849,"California",778001,0.281949509062328,291496,0.779,75584,0.202
"5704","san mateo",5704,"2021-04-08",10078,552914,5032,302368,2461,229639,2585,20907,4479,122962,5584,224941,7054,347903,"California",778001,0.289126877728949,291496,0.779,75584,0.202
"5705","san mateo",5705,"2021-04-09",11256,564170,5470,307838,3309,232948,2477,23384,5085,124347,6169,231110,7554,355457,"California",778001,0.297056173449649,291496,0.779,75584,0.202
"5706","san mateo",5706,"2021-04-10",11152,575322,5671,313509,4052,237000,1429,24813,4630,123900,6502,237612,6055,361512,"California",778001,0.305413489185747,291496,0.779,75584,0.202
"5707","san mateo",5707,"2021-04-11",6615,581937,3284,316793,882,237882,2449,27262,2343,124420,4266,241878,4786,366298,"California",778001,0.310896772626256,291496,0.779,75584,0.202
"5708","san mateo",5708,"2021-04-12",7312,589249,4472,321265,1879,239761,961,28223,3555,125197,3739,245617,4516,370814,"California",778001,0.3157026790454,291496,0.779,75584,0.202
"5709","san mateo",5709,"2021-04-13",8158,597407,5096,326361,3053,242814,9,28232,4335,125726,3817,249434,4346,375160,"California",778001,0.320608842405087,291496,0.779,75584,0.202
"5710","san mateo",5710,"2021-04-14",8355,605762,5431,331792,2923,245737,1,28233,4327,126043,4017,253451,4334,379494,"California",778001,0.325772074843091,291496,0.779,75584,0.202
"5711","san mateo",5711,"2021-04-15",11077,616839,7373,339165,3702,249439,2,28235,7269,129531,3785,257236,7273,386767,"California",778001,0.330637107150248,291496,0.779,75584,0.202
"5712","san mateo",5712,"2021-04-16",9941,626780,6866,346031,3059,252498,16,28251,6328,132284,3596,260832,6349,393116,"California",778001,0.335259209178394,291496,0.779,75584,0.202
"5713","san mateo",5713,"2021-04-17",9635,636415,6427,352458,3205,255703,3,28254,6113,134892,3513,264345,6121,399237,"California",778001,0.339774627539039,291496,0.779,75584,0.202
"5714","san mateo",5714,"2021-04-18",5400,641815,2593,355051,2807,258510,0,28254,3654,136817,1736,266081,3661,402898,"California",778001,0.342005987138834,291496,0.779,75584,0.202
"5715","san mateo",5715,"2021-04-19",8314,650129,5407,360458,2907,261417,0,28254,5390,139300,2915,268996,5398,408296,"California",778001,0.34575276895531,291496,0.779,75584,0.202
"5716","san mateo",5716,"2021-04-20",10192,660321,5657,366115,4535,265952,0,28254,6545,142223,3632,272628,6555,414851,"California",778001,0.350421143417553,291496,0.779,75584,0.202
"5717","san mateo",5717,"2021-04-21",8986,669307,6093,372208,2893,268845,0,28254,5572,144401,3401,276029,5579,420430,"California",778001,0.354792603094341,291496,0.779,75584,0.202
"5718","san mateo",5718,"2021-04-22",9558,678865,6402,378610,3155,272000,1,28255,5315,145511,4211,280240,5321,425751,"California",778001,0.360205192538313,291496,0.779,75584,0.202
"5719","san mateo",5719,"2021-04-23",9449,688314,6218,384828,3231,275231,0,28255,5317,146736,4107,284347,5332,431083,"California",778001,0.36548410606156,291496,0.779,75584,0.202
"5720","san mateo",5720,"2021-04-24",11202,699516,8008,392836,3194,278425,0,28255,6041,147644,5141,289488,6049,437132,"California",778001,0.372092066719709,291496,0.779,75584,0.202
"5721","san mateo",5721,"2021-04-25",5490,705006,3856,396692,1633,280058,1,28256,3903,149983,1574,291062,3913,441045,"California",778001,0.374115200366066,291496,0.779,75584,0.202
"5722","san mateo",5722,"2021-04-26",5999,711005,4387,401079,1605,281663,7,28263,3486,150982,2506,293568,3505,444550,"California",778001,0.377336275917383,291496,0.779,75584,0.202
"5723","san mateo",5723,"2021-04-27",10647,721652,7539,408618,3004,284667,104,28367,4256,148981,6365,299933,4364,448914,"California",778001,0.385517499334834,291496,0.779,75584,0.202
"5724","san mateo",5724,"2021-04-28",7658,729310,4427,413045,3027,287694,204,28571,4012,149563,3638,303571,4220,453134,"California",778001,0.390193585869427,291496,0.779,75584,0.202
"5725","san mateo",5725,"2021-04-29",7905,737215,3705,416750,4025,291719,175,28746,3502,148873,4378,307949,3688,456822,"California",778001,0.395820827993794,291496,0.779,75584,0.202
"5726","san mateo",5726,"2021-04-30",8045,745260,5071,421821,2819,294538,155,28901,3412,147841,4612,312561,3580,460402,"California",778001,0.401748840939793,291496,0.779,75584,0.202
"5727","san mateo",5727,"2021-05-01",6140,751400,4120,425941,1901,296439,119,29020,2658,147162,3467,316028,2788,463190,"California",778001,0.406205133412425,291496,0.779,75584,0.202
"5728","san mateo",5728,"2021-05-02",3166,754566,1741,427682,1354,297793,71,29091,1143,146365,2015,318043,1218,464408,"California",778001,0.408795104376473,291496,0.779,75584,0.202
"5729","san mateo",5729,"2021-05-03",6034,760600,4515,432197,1376,299169,143,29234,1893,144270,4131,322174,2036,466444,"California",778001,0.414104866189118,291496,0.779,75584,0.202
"5730","san mateo",5730,"2021-05-04",7224,767824,4903,437100,2151,301320,170,29404,2454,142151,4754,326928,2635,469079,"California",778001,0.420215398180722,291496,0.779,75584,0.202
"5731","san mateo",5731,"2021-05-05",6874,774698,4536,441636,2180,303500,158,29562,2433,140331,4414,331342,2594,471673,"California",778001,0.425888912739187,291496,0.779,75584,0.202
"5732","san mateo",5732,"2021-05-06",8490,783188,6607,448243,1702,305202,181,29743,1716,135482,6752,338094,1903,473576,"California",778001,0.434567564823181,291496,0.779,75584,0.202
"5733","san mateo",5733,"2021-05-07",8102,791290,5814,454057,2015,307217,273,30016,1809,131308,6268,344362,2094,475670,"California",778001,0.442624109737648,291496,0.779,75584,0.202
"5734","san mateo",5734,"2021-05-08",6482,797772,3891,457948,2358,309575,233,30249,1811,128693,4663,349025,2048,477718,"California",778001,0.448617675298618,291496,0.779,75584,0.202
"5735","santa barbara",5735,"2020-12-15",2,2,2,2,0,0,0,0,2,2,0,0,2,2,"California",456373,0,129963,0.649,65736,0.328
"5736","santa barbara",5736,"2020-12-16",2,4,2,4,0,0,0,0,2,4,0,0,2,4,"California",456373,0,129963,0.649,65736,0.328
"5737","santa barbara",5737,"2020-12-17",56,60,56,60,0,0,0,0,56,60,0,0,56,60,"California",456373,0,129963,0.649,65736,0.328
"5738","santa barbara",5738,"2020-12-18",378,438,377,437,1,1,0,0,378,438,0,0,378,438,"California",456373,0,129963,0.649,65736,0.328
"5739","santa barbara",5739,"2020-12-19",325,763,325,762,0,1,0,0,325,763,0,0,325,763,"California",456373,0,129963,0.649,65736,0.328
"5740","santa barbara",5740,"2020-12-20",235,998,235,997,0,1,0,0,235,998,0,0,235,998,"California",456373,0,129963,0.649,65736,0.328
"5741","santa barbara",5741,"2020-12-21",652,1650,650,1647,2,3,0,0,652,1650,0,0,652,1650,"California",456373,0,129963,0.649,65736,0.328
"5742","santa barbara",5742,"2020-12-22",244,1894,242,1889,2,5,0,0,244,1894,0,0,244,1894,"California",456373,0,129963,0.649,65736,0.328
"5743","santa barbara",5743,"2020-12-23",320,2214,202,2091,118,123,0,0,320,2214,0,0,320,2214,"California",456373,0,129963,0.649,65736,0.328
"5744","santa barbara",5744,"2020-12-24",88,2302,40,2131,48,171,0,0,88,2302,0,0,88,2302,"California",456373,0,129963,0.649,65736,0.328
"5745","santa barbara",5745,"2020-12-26",326,2628,66,2197,260,431,0,0,326,2628,0,0,326,2628,"California",456373,0,129963,0.649,65736,0.328
"5746","santa barbara",5746,"2020-12-27",62,2690,1,2198,61,492,0,0,62,2690,0,0,62,2690,"California",456373,0,129963,0.649,65736,0.328
"5747","santa barbara",5747,"2020-12-28",356,3046,223,2421,133,625,0,0,356,3046,0,0,356,3046,"California",456373,0,129963,0.649,65736,0.328
"5748","santa barbara",5748,"2020-12-29",555,3601,361,2782,194,819,0,0,555,3601,0,0,555,3601,"California",456373,0,129963,0.649,65736,0.328
"5749","santa barbara",5749,"2020-12-30",585,4186,403,3185,182,1001,0,0,585,4186,0,0,585,4186,"California",456373,0,129963,0.649,65736,0.328
"5750","santa barbara",5750,"2020-12-31",240,4426,114,3299,126,1127,0,0,240,4426,0,0,240,4426,"California",456373,0,129963,0.649,65736,0.328
"5751","santa barbara",5751,"2021-01-01",112,4538,108,3407,4,1131,0,0,112,4538,0,0,112,4538,"California",456373,0,129963,0.649,65736,0.328
"5752","santa barbara",5752,"2021-01-02",589,5127,224,3631,365,1496,0,0,589,5127,0,0,589,5127,"California",456373,0,129963,0.649,65736,0.328
"5753","santa barbara",5753,"2021-01-03",23,5150,15,3646,8,1504,0,0,23,5150,0,0,23,5150,"California",456373,0,129963,0.649,65736,0.328
"5754","santa barbara",5754,"2021-01-04",309,5459,246,3892,63,1567,0,0,308,5458,0,0,308,5458,"California",456373,0,129963,0.649,65736,0.328
"5755","santa barbara",5755,"2021-01-05",753,6212,380,4272,373,1940,0,0,726,6157,27,27,726,6184,"California",456373,5.91621327291492e-05,129963,0.649,65736,0.328
"5756","santa barbara",5756,"2021-01-06",656,6868,276,4548,380,2320,0,0,595,6692,60,87,595,6779,"California",456373,0.000190633538793925,129963,0.649,65736,0.328
"5757","santa barbara",5757,"2021-01-07",1033,7901,711,5259,322,2642,0,0,527,6717,502,589,527,7306,"California",456373,0.00129061096953588,129963,0.649,65736,0.328
"5758","santa barbara",5758,"2021-01-08",1203,9104,843,6102,360,3002,0,0,710,6934,493,1082,710,8016,"California",456373,0.00237086768936813,129963,0.649,65736,0.328
"5759","santa barbara",5759,"2021-01-09",566,9670,293,6395,273,3275,0,0,320,7008,246,1328,320,8336,"California",456373,0.00290990045423371,129963,0.649,65736,0.328
"5760","santa barbara",5760,"2021-01-10",62,9732,50,6445,12,3287,0,0,46,7038,16,1344,46,8382,"California",456373,0.00294495949585098,129963,0.649,65736,0.328
"5761","santa barbara",5761,"2021-01-11",839,10571,670,7115,169,3456,0,0,616,7432,222,1566,616,8998,"California",456373,0.00343140369829065,129963,0.649,65736,0.328
"5762","santa barbara",5762,"2021-01-12",1427,11998,635,7750,792,4248,0,0,1270,8545,157,1723,1270,10268,"California",456373,0.00377542054416015,129963,0.649,65736,0.328
"5763","santa barbara",5763,"2021-01-13",1227,13225,280,8030,947,5195,0,0,1102,9521,126,1849,1102,11370,"California",456373,0.00405151049689618,129963,0.649,65736,0.328
"5764","santa barbara",5764,"2021-01-14",1248,14473,132,8162,1116,6311,0,0,1194,10663,53,1902,1195,12565,"California",456373,0.0041676435722534,129963,0.649,65736,0.328
"5765","santa barbara",5765,"2021-01-15",1802,16275,420,8582,1382,7693,0,0,1722,12306,79,1981,1722,14287,"California",456373,0.00434074759023869,129963,0.649,65736,0.328
"5766","santa barbara",5766,"2021-01-16",1272,17547,202,8784,1070,8763,0,0,1233,13501,38,2019,1233,15520,"California",456373,0.00442401281407971,129963,0.649,65736,0.328
"5767","santa barbara",5767,"2021-01-17",123,17670,20,8804,103,8866,0,0,120,13618,3,2022,120,15640,"California",456373,0.00443058638438295,129963,0.649,65736,0.328
"5768","santa barbara",5768,"2021-01-18",1151,18821,417,9221,734,9600,0,0,966,14399,185,2207,966,16606,"California",456373,0.00483595655308268,129963,0.649,65736,0.328
"5769","santa barbara",5769,"2021-01-19",1638,20459,570,9791,1068,10668,0,0,1359,15480,278,2485,1359,17965,"California",456373,0.0054451074011828,129963,0.649,65736,0.328
"5770","santa barbara",5770,"2021-01-20",2095,22554,544,10335,1551,12219,0,0,1737,16860,357,2842,1737,19702,"California",456373,0.00622736226726822,129963,0.649,65736,0.328
"5771","santa barbara",5771,"2021-01-21",3089,25643,1818,12153,1271,13490,0,0,2930,19632,159,3001,2931,22633,"California",456373,0.00657576149333988,129963,0.649,65736,0.328
"5772","santa barbara",5772,"2021-01-22",3017,28660,1864,14017,1153,14643,0,0,2853,22325,161,3162,2854,25487,"California",456373,0.00692854309961369,129963,0.649,65736,0.328
"5773","santa barbara",5773,"2021-01-23",1734,30394,1106,15123,628,15271,0,0,1222,23036,511,3673,1222,26709,"California",456373,0.00804824124126537,129963,0.649,65736,0.328
"5774","santa barbara",5774,"2021-01-24",844,31238,752,15875,92,15363,0,0,835,23862,9,3682,835,27544,"California",456373,0.00806796195217509,129963,0.649,65736,0.328
"5775","santa barbara",5775,"2021-01-25",1244,32482,501,16376,743,16106,0,0,1004,24626,240,3922,1004,28548,"California",456373,0.00859384757643419,129963,0.649,65736,0.328
"5776","santa barbara",5776,"2021-01-26",2051,34533,468,16844,1583,17689,0,0,1664,25905,385,4307,1664,30212,"California",456373,0.00943745576534983,129963,0.649,65736,0.328
"5777","santa barbara",5777,"2021-01-27",1163,35696,400,17244,763,18452,0,0,902,26548,260,4567,903,31115,"California",456373,0.0100071651916305,129963,0.649,65736,0.328
"5778","santa barbara",5778,"2021-01-28",896,36592,298,17542,598,19050,0,0,681,27017,212,4779,681,31796,"California",456373,0.0104716974930594,129963,0.649,65736,0.328
"5779","santa barbara",5779,"2021-01-29",1333,37925,538,18080,795,19845,0,0,978,27645,352,5131,980,32776,"California",456373,0.0112429964086394,129963,0.649,65736,0.328
"5780","santa barbara",5780,"2021-01-30",1892,39817,1420,19500,472,20317,0,0,1488,28732,401,5532,1488,34264,"California",456373,0.0121216636391723,129963,0.649,65736,0.328
"5781","santa barbara",5781,"2021-01-31",1455,41272,1217,20717,238,20555,0,0,1416,30109,39,5571,1416,35680,"California",456373,0.0122071200531144,129963,0.649,65736,0.328
"5782","santa barbara",5782,"2021-02-01",942,42214,520,21237,422,20977,0,0,554,30275,388,5959,554,36234,"California",456373,0.0130573018123333,129963,0.649,65736,0.328
"5783","santa barbara",5783,"2021-02-02",1828,44042,700,21937,1128,22105,0,0,1053,30555,773,6732,1053,37287,"California",456373,0.0147510917604679,129963,0.649,65736,0.328
"5784","santa barbara",5784,"2021-02-03",1942,45984,1078,23015,864,22969,0,0,1500,31623,432,7164,1500,38787,"California",456373,0.0156976858841343,129963,0.649,65736,0.328
"5785","santa barbara",5785,"2021-02-04",2775,48759,1862,24877,913,23882,0,0,2481,33815,289,7453,2481,41268,"California",456373,0.0163309398233463,129963,0.649,65736,0.328
"5786","santa barbara",5786,"2021-02-05",2906,51665,2061,26938,845,24727,0,0,2262,35435,642,8095,2262,43530,"California",456373,0.0177376838682394,129963,0.649,65736,0.328
"5787","santa barbara",5787,"2021-02-06",1204,52869,338,27276,866,25593,0,0,794,35819,410,8505,794,44324,"California",456373,0.018636071809682,129963,0.649,65736,0.328
"5788","santa barbara",5788,"2021-02-07",301,53170,263,27539,38,25631,0,0,266,36051,34,8539,266,44590,"California",456373,0.0187105722731187,129963,0.649,65736,0.328
"5789","santa barbara",5789,"2021-02-08",956,54126,311,27850,645,26276,0,0,668,36431,288,8827,668,45258,"California",456373,0.0193416350222296,129963,0.649,65736,0.328
"5790","santa barbara",5790,"2021-02-09",2438,56564,313,28163,2125,28401,0,0,1121,36245,1307,10134,1121,46379,"California",456373,0.0222055204843407,129963,0.649,65736,0.328
"5791","santa barbara",5791,"2021-02-10",2764,59328,1498,29661,1266,29667,0,0,780,35050,1975,12109,780,47159,"California",456373,0.0265331209339729,129963,0.649,65736,0.328
"5792","santa barbara",5792,"2021-02-11",4184,63512,2806,32467,1378,31045,0,0,625,32125,3550,15659,625,47784,"California",456373,0.0343118457928054,129963,0.649,65736,0.328
"5793","santa barbara",5793,"2021-02-12",3309,66821,949,33416,2360,33405,0,0,774,30370,2529,18188,774,48558,"California",456373,0.0398533655584358,129963,0.649,65736,0.328
"5794","santa barbara",5794,"2021-02-13",1235,68056,341,33757,894,34299,0,0,561,30261,670,18858,561,49119,"California",456373,0.0413214629261591,129963,0.649,65736,0.328
"5795","santa barbara",5795,"2021-02-14",331,68387,34,33791,297,34596,0,0,285,30500,46,18904,285,49404,"California",456373,0.0414222576708087,129963,0.649,65736,0.328
"5796","santa barbara",5796,"2021-02-15",968,69355,338,34129,630,35226,0,0,493,30524,470,19374,494,49898,"California",456373,0.0424521170183162,129963,0.649,65736,0.328
"5797","santa barbara",5797,"2021-02-16",2108,71463,397,34526,1711,36937,0,0,716,29852,1388,20762,716,50614,"California",456373,0.0454934888786146,129963,0.649,65736,0.328
"5798","santa barbara",5798,"2021-02-17",1436,72899,321,34847,1115,38052,0,0,522,29462,912,21674,522,51136,"California",456373,0.0474918542507992,129963,0.649,65736,0.328
"5799","santa barbara",5799,"2021-02-18",3254,76153,2647,37494,607,38659,0,0,1519,29281,1700,23374,1519,52655,"California",456373,0.0512168774226346,129963,0.649,65736,0.328
"5800","santa barbara",5800,"2021-02-19",3594,79747,2641,40135,953,39612,0,0,2328,30346,1263,24637,2328,54983,"California",456373,0.0539843505202981,129963,0.649,65736,0.328
"5801","santa barbara",5801,"2021-02-20",2221,81968,1435,41570,786,40398,0,0,1666,31466,546,25183,1666,56649,"California",456373,0.0551807403154876,129963,0.649,65736,0.328
"5802","santa barbara",5802,"2021-02-21",127,82095,98,41668,29,40427,0,0,58,31455,69,25252,58,56707,"California",456373,0.055331932432462,129963,0.649,65736,0.328
"5803","santa barbara",5803,"2021-02-22",939,83034,247,41915,692,41119,0,0,261,31045,671,25923,261,56968,"California",456373,0.0568022209902865,129963,0.649,65736,0.328
"5804","santa barbara",5804,"2021-02-23",3188,86222,1045,42960,2143,43262,0,0,421,28703,2763,28686,421,57389,"California",456373,0.0628564792395694,129963,0.649,65736,0.328
"5805","santa barbara",5805,"2021-02-24",3199,89421,1088,44048,2111,45373,0,0,720,26955,2468,31154,720,58109,"California",456373,0.0682643364090338,129963,0.649,65736,0.328
"5806","santa barbara",5806,"2021-02-25",3451,92872,1918,45966,1533,46906,0,0,985,25482,2459,33613,986,59095,"California",456373,0.0736524728675886,129963,0.649,65736,0.328
"5807","santa barbara",5807,"2021-02-26",3665,96537,2175,48141,1490,48396,0,0,1979,25782,1679,35292,1979,61074,"California",456373,0.0773314810473012,129963,0.649,65736,0.328
"5808","santa barbara",5808,"2021-02-27",1528,98065,563,48704,965,49361,0,0,847,25956,675,35967,849,61923,"California",456373,0.07881053436553,129963,0.649,65736,0.328
"5809","santa barbara",5809,"2021-02-28",1085,99150,221,48925,864,50225,0,0,893,26663,187,36154,894,62817,"California",456373,0.0792202869144318,129963,0.649,65736,0.328
"5810","santa barbara",5810,"2021-03-01",1635,100785,466,49391,1169,51394,0,0,1085,27212,537,36691,1086,63903,"California",456373,0.0803969559987116,129963,0.649,65736,0.328
"5811","santa barbara",5811,"2021-03-02",2619,103404,414,49805,2205,53599,0,0,2118,28843,488,37179,2119,66022,"California",456373,0.0814662567680384,129963,0.649,65736,0.328
"5812","santa barbara",5812,"2021-03-03",4627,108031,2099,51904,2526,56125,2,2,4032,32295,585,37764,4037,70059,"California",456373,0.08274810297717,129963,0.649,65736,0.328
"5813","santa barbara",5813,"2021-03-04",3415,111446,2281,54185,1134,57259,0,2,2860,34608,547,38311,2860,72919,"California",456373,0.0839466839624605,129963,0.649,65736,0.328
"5814","santa barbara",5814,"2021-03-05",3809,115255,2160,56345,1590,58849,59,61,3084,37032,719,39030,3143,76062,"California",456373,0.0855221496451368,129963,0.649,65736,0.328
"5815","santa barbara",5815,"2021-03-06",2432,117687,724,57069,1488,60337,220,281,1666,38155,762,39792,1885,77947,"California",456373,0.0871918365021594,129963,0.649,65736,0.328
"5816","santa barbara",5816,"2021-03-07",561,118248,122,57191,309,60646,130,411,382,38490,178,39970,513,78460,"California",456373,0.0875818683401516,129963,0.649,65736,0.328
"5817","santa barbara",5817,"2021-03-08",1576,119824,379,57570,855,61501,342,753,794,38850,776,40746,1136,79596,"California",456373,0.0892822318585894,129963,0.649,65736,0.328
"5818","santa barbara",5818,"2021-03-09",2773,122597,323,57893,1675,63176,775,1528,717,38285,2053,42799,1488,81084,"California",456373,0.0937807451361058,129963,0.649,65736,0.328
"5819","santa barbara",5819,"2021-03-10",2750,125347,544,58437,1159,64335,1047,2575,1034,38655,1710,44509,2080,83164,"California",456373,0.0975276802089519,129963,0.649,65736,0.328
"5820","santa barbara",5820,"2021-03-11",5575,130922,3029,61466,1431,65766,1115,3690,2280,38763,3282,47791,3390,86554,"California",456373,0.104719166120695,129963,0.649,65736,0.328
"5821","santa barbara",5821,"2021-03-12",3664,134586,2092,63558,1143,66909,429,4119,2173,39879,1483,49274,2599,89153,"California",456373,0.107968701040596,129963,0.649,65736,0.328
"5822","santa barbara",5822,"2021-03-13",3472,138058,1923,65481,1340,68249,209,4328,2693,42005,777,50051,2903,92056,"California",456373,0.109671255749135,129963,0.649,65736,0.328
"5823","santa barbara",5823,"2021-03-14",783,138841,371,65852,355,68604,57,4385,465,42209,318,50369,522,92578,"California",456373,0.110368054201278,129963,0.649,65736,0.328
"5824","santa barbara",5824,"2021-03-15",2106,140947,693,66545,1122,69726,291,4676,1267,42931,834,51203,1556,94134,"California",456373,0.112195506745579,129963,0.649,65736,0.328
"5825","santa barbara",5825,"2021-03-16",3724,144671,1171,67716,2211,71937,342,5018,2739,45030,982,52185,3081,97215,"California",456373,0.114347255424839,129963,0.649,65736,0.328
"5826","santa barbara",5826,"2021-03-17",3297,147968,972,68688,1920,73857,405,5423,2309,46754,986,53171,2710,99925,"California",456373,0.116507768864503,129963,0.649,65736,0.328
"5827","santa barbara",5827,"2021-03-18",5221,153189,2799,71487,2221,76078,201,5624,3998,49744,1209,54380,4199,104124,"California",456373,0.119156917696709,129963,0.649,65736,0.328
"5828","santa barbara",5828,"2021-03-19",4439,157628,2765,74252,1342,77420,332,5956,3050,51740,1385,55765,3381,107505,"California",456373,0.122191715986704,129963,0.649,65736,0.328
"5829","santa barbara",5829,"2021-03-20",2163,159791,827,75079,1325,78745,11,5967,1329,52247,832,56597,1339,108844,"California",456373,0.124014786150802,129963,0.649,65736,0.328
"5830","santa barbara",5830,"2021-03-21",1163,160954,382,75461,752,79497,29,5996,838,52791,323,56920,867,109711,"California",456373,0.124722540553451,129963,0.649,65736,0.328
"5831","santa barbara",5831,"2021-03-22",2777,163731,1912,77373,821,80318,44,6040,2223,54512,546,57466,2267,111978,"California",456373,0.12591893034864,129963,0.649,65736,0.328
"5832","santa barbara",5832,"2021-03-23",4477,168208,2251,79624,2126,82444,100,6140,3711,57567,756,58222,3811,115789,"California",456373,0.127575470065056,129963,0.649,65736,0.328
"5833","santa barbara",5833,"2021-03-24",5404,173612,3155,82779,1511,83955,738,6878,2969,58859,2414,60636,3706,119495,"California",456373,0.132865002969063,129963,0.649,65736,0.328
"5834","santa barbara",5834,"2021-03-25",5553,179165,3278,86057,2088,86043,187,7065,2780,59069,2757,63393,2967,122462,"California",456373,0.138906114077739,129963,0.649,65736,0.328
"5835","santa barbara",5835,"2021-03-26",5081,184246,3220,89277,1562,87605,299,7364,2239,58781,2826,66219,2538,125000,"California",456373,0.14509841730339,129963,0.649,65736,0.328
"5836","santa barbara",5836,"2021-03-27",2924,187170,1220,90497,1661,89266,43,7407,1594,59091,1325,67544,1635,126635,"California",456373,0.14800174418732,129963,0.649,65736,0.328
"5837","santa barbara",5837,"2021-03-28",2771,189941,1647,92144,1096,90362,28,7435,1887,60128,879,68423,1916,128551,"California",456373,0.149927800286169,129963,0.649,65736,0.328
"5838","santa barbara",5838,"2021-03-29",4043,193984,2086,94230,1886,92248,71,7506,3233,62626,806,69229,3304,131855,"California",456373,0.15169389950764,129963,0.649,65736,0.328
"5839","santa barbara",5839,"2021-03-30",6796,200780,3512,97742,3134,95382,150,7656,4567,65127,2214,71443,4715,136570,"California",456373,0.15654519439143,129963,0.649,65736,0.328
"5840","santa barbara",5840,"2021-03-31",8641,209421,5512,103254,3062,98444,67,7723,5051,66673,3572,75015,5118,141688,"California",456373,0.164372125432486,129963,0.649,65736,0.328
"5841","santa barbara",5841,"2021-04-01",7000,216421,5176,108430,1565,100009,259,7982,4152,68250,2832,77847,4409,146097,"California",456373,0.170577575798744,129963,0.649,65736,0.328
"5842","santa barbara",5842,"2021-04-02",6591,223012,4517,112947,1481,101490,593,8575,3380,69018,3204,81051,3972,150069,"California",456373,0.177598148882603,129963,0.649,65736,0.328
"5843","santa barbara",5843,"2021-04-03",3779,226791,2098,115045,1613,103103,68,8643,2493,70296,1282,82333,2560,152629,"California",456373,0.180407254592187,129963,0.649,65736,0.328
"5844","santa barbara",5844,"2021-04-04",898,227689,445,115490,413,103516,40,8683,499,70439,397,82730,540,153169,"California",456373,0.181277157062315,129963,0.649,65736,0.328
"5845","santa barbara",5845,"2021-04-05",3448,231137,2277,117767,914,104430,257,8940,2160,71574,1282,84012,2417,155586,"California",456373,0.184086262771899,129963,0.649,65736,0.328
"5846","santa barbara",5846,"2021-04-06",5446,236583,2808,120575,2103,106533,535,9475,3330,73334,2102,86114,3862,159448,"California",456373,0.188692144364369,129963,0.649,65736,0.328
"5847","santa barbara",5847,"2021-04-07",5982,242565,3282,123857,2160,108693,540,10015,4076,76053,1896,88010,4615,164063,"California",456373,0.192846640796016,129963,0.649,65736,0.328
"5848","santa barbara",5848,"2021-04-08",7363,249928,5012,128869,640,109333,1711,11726,3395,77190,3966,91976,5103,169166,"California",456373,0.201536900736897,129963,0.649,65736,0.328
"5849","santa barbara",5849,"2021-04-09",7247,257175,4825,133694,1077,110410,1345,13071,3259,77809,3980,95956,4599,173765,"California",456373,0.210257837339194,129963,0.649,65736,0.328
"5850","santa barbara",5850,"2021-04-10",6632,263807,4591,138285,1424,111834,617,13688,4507,80812,2120,98076,5123,178888,"California",456373,0.214903160353483,129963,0.649,65736,0.328
"5851","santa barbara",5851,"2021-04-11",2645,266452,1931,140216,415,112249,299,13987,1824,82115,815,98891,2118,181006,"California",456373,0.216688980285863,129963,0.649,65736,0.328
"5852","santa barbara",5852,"2021-04-12",4378,270830,2799,143015,1026,113275,553,14540,1874,82043,2497,101388,2425,183431,"California",456373,0.222160381968258,129963,0.649,65736,0.328
"5853","santa barbara",5853,"2021-04-13",6305,277135,4145,147160,2154,115429,6,14546,2620,80987,3681,105069,2625,186056,"California",456373,0.230226152730332,129963,0.649,65736,0.328
"5854","santa barbara",5854,"2021-04-14",6671,283806,4342,151502,2327,117756,2,14548,4153,82633,2508,107577,4154,190210,"California",456373,0.23572165750384,129963,0.649,65736,0.328
"5855","santa barbara",5855,"2021-04-15",6942,290748,4093,155595,2848,120604,1,14549,3768,83239,3164,110741,3770,193980,"California",456373,0.242654582983656,129963,0.649,65736,0.328
"5856","santa barbara",5856,"2021-04-16",6375,297123,3748,159343,2616,123220,11,14560,4392,85672,1969,112710,4402,198382,"California",456373,0.246969036292682,129963,0.649,65736,0.328
"5857","santa barbara",5857,"2021-04-17",5311,302434,3868,163211,1443,124663,0,14560,4104,88577,1199,113909,4104,202486,"California",456373,0.249596273223876,129963,0.649,65736,0.328
"5858","santa barbara",5858,"2021-04-18",2125,304559,1475,164686,650,125313,0,14560,370,87197,1751,115660,371,202857,"California",456373,0.253433047090866,129963,0.649,65736,0.328
"5859","santa barbara",5859,"2021-04-19",3199,307758,2217,166903,977,126290,5,14565,1001,86010,2194,117854,1007,203864,"California",456373,0.258240518172635,129963,0.649,65736,0.328
"5860","santa barbara",5860,"2021-04-20",5868,313626,3946,170849,1921,128211,1,14566,1658,83470,4198,122052,1658,205522,"California",456373,0.267439134216967,129963,0.649,65736,0.328
"5861","santa barbara",5861,"2021-04-21",5473,319099,3636,174485,1837,130048,0,14566,1742,81493,3719,125771,1742,207264,"California",456373,0.275588170202882,129963,0.649,65736,0.328
"5862","santa barbara",5862,"2021-04-22",5075,324174,2549,177034,2525,132573,1,14567,1450,79336,3610,129381,1453,208717,"California",456373,0.28349836646778,129963,0.649,65736,0.328
"5863","santa barbara",5863,"2021-04-23",5529,329703,3875,180909,1654,134227,0,14567,1955,77727,3564,132945,1955,210672,"California",456373,0.291307767988027,129963,0.649,65736,0.328
"5864","santa barbara",5864,"2021-04-24",4421,334124,2877,183786,1539,135766,5,14572,1664,76647,2749,135694,1669,212341,"California",456373,0.297331349575895,129963,0.649,65736,0.328
"5865","santa barbara",5865,"2021-04-25",1830,335954,1184,184970,646,136412,0,14572,501,75826,1322,137016,501,212842,"California",456373,0.300228102889522,129963,0.649,65736,0.328
"5866","santa barbara",5866,"2021-04-26",2855,338809,1775,186745,1060,137472,20,14592,431,73859,2418,139434,451,213293,"California",456373,0.305526400553933,129963,0.649,65736,0.328
"5867","santa barbara",5867,"2021-04-27",3596,342405,1982,188727,1527,138999,87,14679,1082,72521,2506,141940,1168,214461,"California",456373,0.311017522947238,129963,0.649,65736,0.328
"5868","santa barbara",5868,"2021-04-28",4886,347291,2864,191591,1906,140905,116,14795,1400,70564,3475,145415,1518,215979,"California",456373,0.31863190854849,129963,0.649,65736,0.328
"5869","santa barbara",5869,"2021-04-29",5249,352540,3802,195393,1220,142125,227,15022,1445,68446,3788,149203,1670,217649,"California",456373,0.326932136651379,129963,0.649,65736,0.328
"5870","santa barbara",5870,"2021-04-30",4945,357485,3694,199087,1087,143212,164,15186,1423,66523,3509,152712,1586,219235,"California",456373,0.334621022716068,129963,0.649,65736,0.328
"5871","santa barbara",5871,"2021-05-01",5239,362724,4062,203149,1145,144357,32,15218,908,63141,4324,157036,942,220177,"California",456373,0.344095728713136,129963,0.649,65736,0.328
"5872","santa barbara",5872,"2021-05-02",1134,363858,666,203815,339,144696,129,15347,310,62757,823,157859,439,220616,"California",456373,0.345899078166324,129963,0.649,65736,0.328
"5873","santa barbara",5873,"2021-05-03",2075,365933,1352,205167,582,145278,141,15488,448,61724,1622,159481,589,221205,"California",456373,0.349453188510276,129963,0.649,65736,0.328
"5874","santa barbara",5874,"2021-05-04",3300,369233,1677,206844,1556,146834,67,15555,1152,60807,2135,161616,1218,222423,"California",456373,0.354131379376081,129963,0.649,65736,0.328
"5875","santa barbara",5875,"2021-05-05",5417,374650,3670,210514,1604,148438,143,15698,629,56804,4776,166392,773,223196,"California",456373,0.364596503298837,129963,0.649,65736,0.328
"5876","santa barbara",5876,"2021-05-06",5038,379688,3897,214411,1035,149473,106,15804,969,53825,4054,170446,1075,224271,"California",456373,0.373479587968613,129963,0.649,65736,0.328
"5877","santa barbara",5877,"2021-05-07",4642,384330,3638,218049,830,150303,174,15978,1003,51366,3634,174080,1175,225446,"California",456373,0.381442372795937,129963,0.649,65736,0.328
"5878","santa barbara",5878,"2021-05-08",4200,388530,3158,221207,947,151250,95,16073,853,48982,3332,177412,948,226394,"California",456373,0.388743418212734,129963,0.649,65736,0.328
"5879","santa clara",5879,"2020-12-15",65,65,65,65,0,0,0,0,65,65,0,0,65,65,"California",1967585,0,617967,0.727,214612,0.252
"5880","santa clara",5880,"2020-12-16",136,201,136,201,0,0,0,0,136,201,0,0,136,201,"California",1967585,0,617967,0.727,214612,0.252
"5881","santa clara",5881,"2020-12-17",392,593,392,593,0,0,0,0,392,593,0,0,392,593,"California",1967585,0,617967,0.727,214612,0.252
"5882","santa clara",5882,"2020-12-18",1677,2270,1677,2270,0,0,0,0,1677,2270,0,0,1677,2270,"California",1967585,0,617967,0.727,214612,0.252
"5883","santa clara",5883,"2020-12-19",2075,4345,2075,4345,0,0,0,0,2074,4344,0,0,2074,4344,"California",1967585,0,617967,0.727,214612,0.252
"5884","santa clara",5884,"2020-12-20",1895,6240,1894,6239,1,1,0,0,1892,6236,0,0,1892,6236,"California",1967585,0,617967,0.727,214612,0.252
"5885","santa clara",5885,"2020-12-21",2672,8912,2672,8911,0,1,0,0,2671,8907,0,0,2671,8907,"California",1967585,0,617967,0.727,214612,0.252
"5886","santa clara",5886,"2020-12-22",3120,12032,3113,12024,7,8,0,0,3117,12024,0,0,3117,12024,"California",1967585,0,617967,0.727,214612,0.252
"5887","santa clara",5887,"2020-12-23",3262,15294,3075,15099,187,195,0,0,3260,15284,0,0,3260,15284,"California",1967585,0,617967,0.727,214612,0.252
"5888","santa clara",5888,"2020-12-24",1896,17190,1710,16809,186,381,0,0,1890,17173,1,1,1890,17174,"California",1967585,5.08237255315526e-07,617967,0.727,214612,0.252
"5889","santa clara",5889,"2020-12-25",343,17533,342,17151,1,382,0,0,343,17516,0,1,343,17517,"California",1967585,5.08237255315526e-07,617967,0.727,214612,0.252
"5890","santa clara",5890,"2020-12-26",1265,18798,1032,18183,233,615,0,0,1264,18780,0,1,1264,18781,"California",1967585,5.08237255315526e-07,617967,0.727,214612,0.252
"5891","santa clara",5891,"2020-12-27",648,19446,508,18691,140,755,0,0,648,19428,0,1,648,19429,"California",1967585,5.08237255315526e-07,617967,0.727,214612,0.252
"5892","santa clara",5892,"2020-12-28",2332,21778,1730,20421,602,1357,0,0,2332,21760,0,1,2332,21761,"California",1967585,5.08237255315526e-07,617967,0.727,214612,0.252
"5893","santa clara",5893,"2020-12-29",2328,24106,1468,21889,860,2217,0,0,2326,24086,0,1,2326,24087,"California",1967585,5.08237255315526e-07,617967,0.727,214612,0.252
"5894","santa clara",5894,"2020-12-30",2993,27099,1901,23790,1092,3309,0,0,2991,27075,2,3,2991,27078,"California",1967585,1.52471176594658e-06,617967,0.727,214612,0.252
"5895","santa clara",5895,"2020-12-31",1217,28316,393,24183,824,4133,0,0,1216,28290,1,4,1216,28294,"California",1967585,2.03294902126211e-06,617967,0.727,214612,0.252
"5896","santa clara",5896,"2021-01-01",145,28461,12,24195,133,4266,0,0,144,28433,1,5,144,28438,"California",1967585,2.54118627657763e-06,617967,0.727,214612,0.252
"5897","santa clara",5897,"2021-01-02",1087,29548,817,25012,270,4536,0,0,1087,29520,0,5,1087,29525,"California",1967585,2.54118627657763e-06,617967,0.727,214612,0.252
"5898","santa clara",5898,"2021-01-03",583,30131,368,25380,215,4751,0,0,578,30095,3,8,578,30103,"California",1967585,4.06589804252421e-06,617967,0.727,214612,0.252
"5899","santa clara",5899,"2021-01-04",2470,32601,1670,27050,800,5551,0,0,2467,32562,0,8,2467,32570,"California",1967585,4.06589804252421e-06,617967,0.727,214612,0.252
"5900","santa clara",5900,"2021-01-05",3065,35666,2009,29059,1056,6607,0,0,2877,35258,187,195,2883,35453,"California",1967585,9.91062647865276e-05,617967,0.727,214612,0.252
"5901","santa clara",5901,"2021-01-06",3326,38992,1961,31020,1365,7972,0,0,2751,37439,571,766,2752,38205,"California",1967585,0.000389309737571693,617967,0.727,214612,0.252
"5902","santa clara",5902,"2021-01-07",4215,43207,2557,33577,1658,9630,0,0,3147,39533,1058,1824,3152,41357,"California",1967585,0.00092702475369552,617967,0.727,214612,0.252
"5903","santa clara",5903,"2021-01-08",5847,49054,3821,37398,2026,11656,0,0,3793,41276,2050,3874,3793,45150,"California",1967585,0.00196891112709235,617967,0.727,214612,0.252
"5904","santa clara",5904,"2021-01-09",2973,52027,1865,39263,1108,12764,0,0,1689,41684,1284,5158,1692,46842,"California",1967585,0.00262148776291749,617967,0.727,214612,0.252
"5905","santa clara",5905,"2021-01-10",1955,53982,1510,40773,445,13209,0,0,745,41220,1209,6367,745,47587,"California",1967585,0.00323594660459396,617967,0.727,214612,0.252
"5906","santa clara",5906,"2021-01-11",5943,59925,3741,44514,2202,15411,0,0,3379,42041,2563,8930,3384,50971,"California",1967585,0.00453855868996765,617967,0.727,214612,0.252
"5907","santa clara",5907,"2021-01-12",6806,66731,3402,47916,3404,18815,0,0,4563,44363,2242,11172,4564,55535,"California",1967585,0.00567802661638506,617967,0.727,214612,0.252
"5908","santa clara",5908,"2021-01-13",7365,74096,3046,50962,4319,23134,0,0,5198,47397,2165,13337,5199,60734,"California",1967585,0.00677836027414318,617967,0.727,214612,0.252
"5909","santa clara",5909,"2021-01-14",8226,82322,2791,53753,5435,28569,0,0,6485,52150,1734,15071,6487,67221,"California",1967585,0.0076596436748603,617967,0.727,214612,0.252
"5910","santa clara",5910,"2021-01-15",9457,91779,2683,56436,6774,35343,0,0,8139,58979,1315,16386,8144,75365,"California",1967585,0.00832797566560022,617967,0.727,214612,0.252
"5911","santa clara",5911,"2021-01-16",4301,96080,1229,57665,3072,38415,0,0,3466,61614,831,17217,3466,78831,"California",1967585,0.00875032082476742,617967,0.727,214612,0.252
"5912","santa clara",5912,"2021-01-17",3217,99297,606,58271,2611,41026,0,0,2720,63837,497,17714,2720,81551,"California",1967585,0.00900291474065923,617967,0.727,214612,0.252
"5913","santa clara",5913,"2021-01-18",5090,104387,1152,59423,3938,44964,0,0,4537,67822,553,18267,4538,86089,"California",1967585,0.00928396994284872,617967,0.727,214612,0.252
"5914","santa clara",5914,"2021-01-19",8479,112866,2671,62094,5808,50772,0,0,6803,72955,1673,19940,6806,92895,"California",1967585,0.0101342508709916,617967,0.727,214612,0.252
"5915","santa clara",5915,"2021-01-20",8079,120945,4105,66199,3974,54746,0,0,6530,77941,1544,21484,6530,99425,"California",1967585,0.0109189691931988,617967,0.727,214612,0.252
"5916","santa clara",5916,"2021-01-21",8648,129593,3738,69937,4910,59656,0,0,7447,84191,1199,22683,7449,106874,"California",1967585,0.0115283456623221,617967,0.727,214612,0.252
"5917","santa clara",5917,"2021-01-22",8620,138213,3241,73178,5379,65035,0,0,8055,91685,564,23247,8058,114932,"California",1967585,0.01181499147432,617967,0.727,214612,0.252
"5918","santa clara",5918,"2021-01-23",3782,141995,1690,74868,2092,67127,0,0,2822,93548,960,24207,2823,117755,"California",1967585,0.0123028992394229,617967,0.727,214612,0.252
"5919","santa clara",5919,"2021-01-24",2825,144820,1422,76290,1403,68530,0,0,2339,95404,483,24690,2339,120094,"California",1967585,0.0125483778337403,617967,0.727,214612,0.252
"5920","santa clara",5920,"2021-01-25",8372,153192,3783,80073,4589,73119,0,0,6307,99658,2057,26747,6311,126405,"California",1967585,0.0135938218679244,617967,0.727,214612,0.252
"5921","santa clara",5921,"2021-01-26",8239,161431,3769,83842,4470,77589,0,0,6122,103675,2107,28854,6124,132529,"California",1967585,0.0146646777648742,617967,0.727,214612,0.252
"5922","santa clara",5922,"2021-01-27",8715,170146,3831,87673,4884,82473,0,0,6792,108566,1902,30756,6793,139322,"California",1967585,0.0156313450244843,617967,0.727,214612,0.252
"5923","santa clara",5923,"2021-01-28",9461,179607,3795,91468,5666,88139,0,0,7503,114136,1937,32693,7507,146829,"California",1967585,0.0166158005880305,617967,0.727,214612,0.252
"5924","santa clara",5924,"2021-01-29",9506,189113,3942,95410,5564,93703,0,0,7337,119314,2160,34853,7338,154167,"California",1967585,0.017713593059512,617967,0.727,214612,0.252
"5925","santa clara",5925,"2021-01-30",4185,193298,2076,97486,2109,95812,0,0,2979,121095,1199,36052,2980,157147,"California",1967585,0.0183229695286354,617967,0.727,214612,0.252
"5926","santa clara",5926,"2021-01-31",2174,195472,1305,98791,869,96681,0,0,1582,122088,589,36641,1582,158729,"California",1967585,0.0186223212720162,617967,0.727,214612,0.252
"5927","santa clara",5927,"2021-02-01",7829,203301,3485,102276,4344,101025,0,0,6141,126550,1680,38321,6142,164871,"California",1967585,0.0194761598609463,617967,0.727,214612,0.252
"5928","santa clara",5928,"2021-02-02",8524,211825,2874,105150,5650,106675,0,0,6526,131088,1991,40312,6529,171400,"California",1967585,0.0204880602362795,617967,0.727,214612,0.252
"5929","santa clara",5929,"2021-02-03",9196,221021,3481,108631,5715,112390,0,0,6917,135738,2273,42585,6923,178323,"California",1967585,0.0216432835176117,617967,0.727,214612,0.252
"5930","santa clara",5930,"2021-02-04",10911,231932,4119,112750,6792,119182,0,0,8626,142092,2275,44860,8629,186952,"California",1967585,0.0227995232734545,617967,0.727,214612,0.252
"5931","santa clara",5931,"2021-02-05",11914,243846,4348,117098,7566,126748,0,0,8453,147100,3446,48306,8454,195406,"California",1967585,0.0245509088552718,617967,0.727,214612,0.252
"5932","santa clara",5932,"2021-02-06",5183,249029,2818,119916,2365,129113,0,0,4020,149963,1159,49465,4022,199428,"California",1967585,0.0251399558341825,617967,0.727,214612,0.252
"5933","santa clara",5933,"2021-02-07",3473,252502,2348,122264,1125,130238,0,0,3020,152532,452,49917,3021,202449,"California",1967585,0.0253696790735851,617967,0.727,214612,0.252
"5934","santa clara",5934,"2021-02-08",10007,262509,3481,125745,6526,136764,0,0,7293,157126,2700,52617,7294,209743,"California",1967585,0.0267419196629371,617967,0.727,214612,0.252
"5935","santa clara",5935,"2021-02-09",11157,273666,3816,129561,7341,144105,0,0,7672,161326,3475,56092,7675,217418,"California",1967585,0.0285080441251585,617967,0.727,214612,0.252
"5936","santa clara",5936,"2021-02-10",12635,286301,4908,134469,7727,151832,0,0,6835,162376,5787,61879,6837,224255,"California",1967585,0.0314492131216695,617967,0.727,214612,0.252
"5937","santa clara",5937,"2021-02-11",13497,299798,4714,139183,8783,160615,0,0,7676,164247,5806,67685,7677,231932,"California",1967585,0.0344000386260314,617967,0.727,214612,0.252
"5938","santa clara",5938,"2021-02-12",14546,314344,4490,143673,10056,170671,0,0,6978,163679,7548,75233,6980,238912,"California",1967585,0.038236213429153,617967,0.727,214612,0.252
"5939","santa clara",5939,"2021-02-13",6073,320417,1458,145131,4615,175286,0,0,2220,162055,3846,79079,2222,241134,"California",1967585,0.0401908939130965,617967,0.727,214612,0.252
"5940","santa clara",5940,"2021-02-14",4614,325031,1143,146274,3471,178757,0,0,1468,160381,3144,82223,1470,242604,"California",1967585,0.0417887918438085,617967,0.727,214612,0.252
"5941","santa clara",5941,"2021-02-15",6252,331283,2796,149070,3456,182213,0,0,2703,159543,3541,85764,2703,245307,"California",1967585,0.0435884599648808,617967,0.727,214612,0.252
"5942","santa clara",5942,"2021-02-16",13772,345055,4000,153070,9772,191985,0,0,6930,159649,6824,92588,6930,252237,"California",1967585,0.047056670995154,617967,0.727,214612,0.252
"5943","santa clara",5943,"2021-02-17",14068,359123,5488,158558,8580,200565,0,0,7047,159698,7003,99591,7052,259289,"California",1967585,0.0506158564941286,617967,0.727,214612,0.252
"5944","santa clara",5944,"2021-02-18",14189,373312,8358,166916,5831,206396,0,0,7229,160012,6918,106509,7232,266521,"California",1967585,0.0541318418264014,617967,0.727,214612,0.252
"5945","santa clara",5945,"2021-02-19",14806,388118,9519,176435,5287,211683,0,0,8616,162459,6174,112683,8621,275142,"California",1967585,0.0572696986407195,617967,0.727,214612,0.252
"5946","santa clara",5946,"2021-02-20",6819,394937,5105,181540,1714,213397,0,0,3673,162996,3136,115819,3673,278815,"California",1967585,0.058863530673389,617967,0.727,214612,0.252
"5947","santa clara",5947,"2021-02-21",3248,398185,2431,183971,817,214214,0,0,1165,162088,2075,117894,1167,279982,"California",1967585,0.0599181229781687,617967,0.727,214612,0.252
"5948","santa clara",5948,"2021-02-22",10158,408343,6084,190055,4074,218288,0,0,4733,161407,5415,123309,4734,284716,"California",1967585,0.0626702277157022,617967,0.727,214612,0.252
"5949","santa clara",5949,"2021-02-23",11875,420218,7705,197760,4170,222458,0,0,6739,163027,5123,128432,6743,291459,"California",1967585,0.0652739271746837,617967,0.727,214612,0.252
"5950","santa clara",5950,"2021-02-24",14139,434357,9105,206865,5034,227492,0,0,8753,166410,5370,133802,8753,300212,"California",1967585,0.0680031612357281,617967,0.727,214612,0.252
"5951","santa clara",5951,"2021-02-25",14603,448960,9239,216104,5364,232856,0,0,7882,167597,6700,140502,7887,308099,"California",1967585,0.0714083508463421,617967,0.727,214612,0.252
"5952","santa clara",5952,"2021-02-26",14555,463515,8435,224539,6120,238976,0,0,7997,169064,6533,147035,8000,316099,"California",1967585,0.0747286648353184,617967,0.727,214612,0.252
"5953","santa clara",5953,"2021-02-27",8066,471581,5500,230039,2565,241541,1,1,4461,169938,3595,150630,4469,320568,"California",1967585,0.0765557777681777,617967,0.727,214612,0.252
"5954","santa clara",5954,"2021-02-28",4723,476304,3075,233114,1648,243189,0,1,2204,169632,2510,153140,2204,322772,"California",1967585,0.0778314532790197,617967,0.727,214612,0.252
"5955","santa clara",5955,"2021-03-01",14066,490370,7976,241090,6087,249276,3,4,8704,172996,5343,158483,8707,331479,"California",1967585,0.0805469649341706,617967,0.727,214612,0.252
"5956","santa clara",5956,"2021-03-02",15866,506236,9391,250481,6474,255750,1,5,10112,177380,5730,164213,10114,341593,"California",1967585,0.0834591644071285,617967,0.727,214612,0.252
"5957","santa clara",5957,"2021-03-03",18428,524664,9041,259522,9386,265136,1,6,11443,181882,6948,171161,11450,353043,"California",1967585,0.0869903968570608,617967,0.727,214612,0.252
"5958","santa clara",5958,"2021-03-04",16413,541077,8937,268459,7473,272609,3,9,9545,184643,6789,177950,9550,362593,"California",1967585,0.0904408195833979,617967,0.727,214612,0.252
"5959","santa clara",5959,"2021-03-05",16479,557556,9147,277606,7207,279816,125,134,9133,186579,7326,185276,9262,371855,"California",1967585,0.0941641657158395,617967,0.727,214612,0.252
"5960","santa clara",5960,"2021-03-06",9362,566918,6274,283880,2652,282468,436,570,7048,191762,2301,187577,7484,379339,"California",1967585,0.0953336196403205,617967,0.727,214612,0.252
"5961","santa clara",5961,"2021-03-07",6729,573647,4413,288293,2083,284551,233,803,5358,195989,1363,188940,5590,384929,"California",1967585,0.0960263470193156,617967,0.727,214612,0.252
"5962","santa clara",5962,"2021-03-08",12837,586484,6682,294975,5594,290145,561,1364,8222,200175,4598,193538,8784,393713,"California",1967585,0.0983632219192564,617967,0.727,214612,0.252
"5963","santa clara",5963,"2021-03-09",14924,601408,6214,301189,7380,297525,1330,2694,6604,199804,8302,201840,7931,401644,"California",1967585,0.102582607612886,617967,0.727,214612,0.252
"5964","santa clara",5964,"2021-03-10",15007,616415,6482,307671,6421,303946,2104,4798,6117,199139,8865,210705,8200,409844,"California",1967585,0.107088130881258,617967,0.727,214612,0.252
"5965","santa clara",5965,"2021-03-11",17008,633423,7746,315417,7759,311705,1503,6301,6037,195723,10943,221648,7527,417371,"California",1967585,0.112649771166176,617967,0.727,214612,0.252
"5966","santa clara",5966,"2021-03-12",17637,651060,9069,324486,6998,318703,1570,7871,5954,191588,11643,233291,7508,424879,"California",1967585,0.118567177529814,617967,0.727,214612,0.252
"5967","santa clara",5967,"2021-03-13",10706,661766,6194,330680,3020,321723,1492,9363,4795,191970,5888,239179,6270,431149,"California",1967585,0.121559678489112,617967,0.727,214612,0.252
"5968","santa clara",5968,"2021-03-14",6480,668246,3349,334029,1823,323546,1308,10671,3195,193195,3269,242448,4494,435643,"California",1967585,0.123221106076739,617967,0.727,214612,0.252
"5969","santa clara",5969,"2021-03-15",12749,680995,6521,340550,5959,329505,269,10940,5975,192687,6752,249200,6244,441887,"California",1967585,0.126652724024629,617967,0.727,214612,0.252
"5970","santa clara",5970,"2021-03-16",18140,699135,10255,350805,7677,337182,208,11148,8794,192369,9318,258518,9000,450887,"California",1967585,0.131388478769659,617967,0.727,214612,0.252
"5971","santa clara",5971,"2021-03-17",19828,718963,11233,362038,8427,345609,168,11316,10238,193229,9541,268059,10401,461288,"California",1967585,0.136237570422625,617967,0.727,214612,0.252
"5972","santa clara",5972,"2021-03-18",19004,737967,8893,370931,8950,354559,1161,12477,9060,193553,9891,277950,10215,471503,"California",1967585,0.141264545114951,617967,0.727,214612,0.252
"5973","santa clara",5973,"2021-03-19",19175,757142,9860,380791,8317,362876,998,13475,9959,195342,9159,287109,10948,482451,"California",1967585,0.145919490136385,617967,0.727,214612,0.252
"5974","santa clara",5974,"2021-03-20",11473,768615,6299,387090,4347,367223,827,14302,6755,198230,4689,291798,7577,490028,"California",1967585,0.14830261462656,617967,0.727,214612,0.252
"5975","santa clara",5975,"2021-03-21",8264,776879,3737,390827,3128,370351,1399,15701,5548,202462,2704,294502,6936,496964,"California",1967585,0.149676888164933,617967,0.727,214612,0.252
"5976","santa clara",5976,"2021-03-22",16263,793142,9071,399898,6847,377198,345,16046,9294,205155,6945,301447,9638,506602,"California",1967585,0.153206595903099,617967,0.727,214612,0.252
"5977","santa clara",5977,"2021-03-23",19171,812313,12197,412095,6459,383657,515,16561,11242,209029,7883,309330,11757,518359,"California",1967585,0.157213030186752,617967,0.727,214612,0.252
"5978","santa clara",5978,"2021-03-24",22537,834850,14516,426611,7612,391269,409,16970,14642,216230,7852,317182,15053,533412,"California",1967585,0.161203709115489,617967,0.727,214612,0.252
"5979","santa clara",5979,"2021-03-25",22849,857699,13081,439692,8783,400052,985,17955,14756,223926,8032,325214,15728,549140,"California",1967585,0.165285870750184,617967,0.727,214612,0.252
"5980","santa clara",5980,"2021-03-26",21836,879535,13915,453607,7538,407590,383,18338,13513,229531,8286,333500,13891,563031,"California",1967585,0.169497124647728,617967,0.727,214612,0.252
"5981","santa clara",5981,"2021-03-27",15621,895156,10386,463993,4471,412061,764,19102,8429,231570,7150,340650,9189,572220,"California",1967585,0.173131021023234,617967,0.727,214612,0.252
"5982","santa clara",5982,"2021-03-28",11995,907151,8298,472291,2983,415044,714,19816,6492,233294,5477,346127,7201,579421,"California",1967585,0.175914636470597,617967,0.727,214612,0.252
"5983","santa clara",5983,"2021-03-29",20531,927682,12590,484881,7216,422260,725,20541,11192,235903,9300,355427,11909,591330,"California",1967585,0.180641242945032,617967,0.727,214612,0.252
"5984","santa clara",5984,"2021-03-30",25541,953223,15206,500087,8401,430661,1934,22475,16353,245031,9153,364580,18281,609611,"California",1967585,0.185293138542935,617967,0.727,214612,0.252
"5985","santa clara",5985,"2021-03-31",20369,973592,11814,511901,7430,438091,1125,23600,12611,251035,7720,372300,13724,623335,"California",1967585,0.18921673015397,617967,0.727,214612,0.252
"5986","santa clara",5986,"2021-04-01",31572,1005164,19731,531632,8847,446938,2994,26594,19989,262484,11521,383821,22970,646305,"California",1967585,0.195072131572461,617967,0.727,214612,0.252
"5987","santa clara",5987,"2021-04-02",24939,1030103,14229,545861,8590,455528,2120,28714,16290,272268,8614,392435,18398,664703,"California",1967585,0.199450087289749,617967,0.727,214612,0.252
"5988","santa clara",5988,"2021-04-03",15153,1045256,9170,555031,3484,459012,2499,31213,8420,276461,6714,399149,10907,675610,"California",1967585,0.202862392221937,617967,0.727,214612,0.252
"5989","santa clara",5989,"2021-04-04",7593,1052849,4018,559049,2418,461430,1157,32370,3955,277942,3629,402778,5110,680720,"California",1967585,0.204706785221477,617967,0.727,214612,0.252
"5990","santa clara",5990,"2021-04-05",21717,1074566,14494,573543,4762,466192,2461,34831,14172,287047,7521,410299,16626,697346,"California",1967585,0.208529237618705,617967,0.727,214612,0.252
"5991","santa clara",5991,"2021-04-06",29347,1103913,16180,589723,7757,473949,5410,40241,17616,298364,11690,421989,23007,720353,"California",1967585,0.214470531133344,617967,0.727,214612,0.252
"5992","santa clara",5992,"2021-04-07",30605,1134518,15812,605535,8367,482316,6426,46667,18700,311608,11854,433843,25098,745451,"California",1967585,0.220495175557854,617967,0.727,214612,0.252
"5993","santa clara",5993,"2021-04-08",29624,1164142,16172,621707,5949,488265,7503,54170,16126,321781,13428,447271,23601,769052,"California",1967585,0.227319785422231,617967,0.727,214612,0.252
"5994","santa clara",5994,"2021-04-09",27696,1191838,13727,635434,6803,495068,7166,61336,14138,329552,13503,460774,21274,790326,"California",1967585,0.234182513080756,617967,0.727,214612,0.252
"5995","santa clara",5995,"2021-04-10",21251,1213089,12298,647732,3758,498826,5195,66531,11402,336299,9817,470591,16564,806890,"California",1967585,0.239171878216189,617967,0.727,214612,0.252
"5996","santa clara",5996,"2021-04-11",15960,1229049,9565,657297,2636,501462,3759,70290,8292,340694,7640,478231,12035,818925,"California",1967585,0.2430548108468,617967,0.727,214612,0.252
"5997","santa clara",5997,"2021-04-12",26757,1255806,18842,676139,5497,506959,2418,72708,18271,352935,8437,486668,20678,839603,"California",1967585,0.247342808569897,617967,0.727,214612,0.252
"5998","santa clara",5998,"2021-04-13",34216,1290022,26968,703107,7221,514180,27,72735,26418,371680,7722,494390,26467,866070,"California",1967585,0.251267416655443,617967,0.727,214612,0.252
"5999","santa clara",5999,"2021-04-14",36449,1326471,27619,730726,8827,523007,3,72738,25906,387132,10483,504873,25935,892005,"California",1967585,0.256595267802916,617967,0.727,214612,0.252
"6000","santa clara",6000,"2021-04-15",43858,1370329,34044,764770,9813,532820,1,72739,33823,411047,9933,514806,33848,925853,"California",1967585,0.261643588459965,617967,0.727,214612,0.252
"6001","santa clara",6001,"2021-04-16",38152,1408481,26186,790956,11963,544783,3,72742,27365,427715,10723,525529,27391,953244,"California",1967585,0.267093416548713,617967,0.727,214612,0.252
"6002","santa clara",6002,"2021-04-17",21922,1430403,15000,805956,6921,551704,1,72743,15039,435928,6842,532371,15055,968299,"California",1967585,0.270570775849582,617967,0.727,214612,0.252
"6003","santa clara",6003,"2021-04-18",16324,1446727,10597,816553,5727,557431,0,72743,10212,440069,6082,538453,10223,978522,"California",1967585,0.273661874836411,617967,0.727,214612,0.252
"6004","santa clara",6004,"2021-04-19",28542,1475269,20608,837161,7933,565364,1,72744,17131,445884,11347,549800,17162,995684,"California",1967585,0.279428842972476,617967,0.727,214612,0.252
"6005","santa clara",6005,"2021-04-20",36648,1511917,22217,859378,14431,579795,0,72744,22468,454308,14073,563873,22497,1018181,"California",1967585,0.286581265866532,617967,0.727,214612,0.252
"6006","santa clara",6006,"2021-04-21",36652,1548569,21226,880604,15425,595220,1,72745,24283,466336,12288,576161,24316,1042497,"California",1967585,0.292826485259849,617967,0.727,214612,0.252
"6007","santa clara",6007,"2021-04-22",37123,1585692,24747,905351,12375,607595,1,72746,17567,464507,19461,595622,17632,1060129,"California",1967585,0.302717290485544,617967,0.727,214612,0.252
"6008","santa clara",6008,"2021-04-23",31817,1617509,19394,924745,12423,620018,0,72746,14969,462776,16749,612371,15018,1075147,"California",1967585,0.311229756274824,617967,0.727,214612,0.252
"6009","santa clara",6009,"2021-04-24",20645,1638154,14999,939744,5645,625663,1,72747,11590,465404,8989,621360,11617,1086764,"California",1967585,0.315798300962855,617967,0.727,214612,0.252
"6010","santa clara",6010,"2021-04-25",13204,1651358,9470,949214,3727,629390,7,72754,8301,468875,4860,626220,8331,1095095,"California",1967585,0.318268334023689,617967,0.727,214612,0.252
"6011","santa clara",6011,"2021-04-26",23417,1674775,18190,967404,5170,634560,57,72811,9575,464777,13752,639972,9654,1104749,"California",1967585,0.325257612758788,617967,0.727,214612,0.252
"6012","santa clara",6012,"2021-04-27",25860,1700635,18490,985894,7083,641643,287,73098,11294,461915,14477,654449,11615,1116364,"California",1967585,0.332615363503991,617967,0.727,214612,0.252
"6013","santa clara",6013,"2021-04-28",25213,1725848,18591,1004485,6184,647827,438,73536,10387,458050,14744,669193,10879,1127243,"California",1967585,0.340108813596363,617967,0.727,214612,0.252
"6014","santa clara",6014,"2021-04-29",23117,1748965,16795,1021280,5926,653753,396,73932,8379,452216,14671,683864,8837,1136080,"California",1967585,0.347565162369097,617967,0.727,214612,0.252
"6015","santa clara",6015,"2021-04-30",22820,1771785,15652,1036932,6808,660561,360,74292,9726,449359,13008,696872,10151,1146231,"California",1967585,0.354176312586241,617967,0.727,214612,0.252
"6016","santa clara",6016,"2021-05-01",17367,1789152,14441,1051373,2666,663227,260,74552,5478,443298,11840,708712,5779,1152010,"California",1967585,0.360193841689177,617967,0.727,214612,0.252
"6017","santa clara",6017,"2021-05-02",11289,1800441,9366,1060739,1695,664922,228,74780,3498,439295,7751,716463,3748,1155758,"California",1967585,0.364133188655128,617967,0.727,214612,0.252
"6018","santa clara",6018,"2021-05-03",22732,1823173,19334,1080073,2964,667886,434,75214,5124,427343,17538,734001,5586,1161344,"California",1967585,0.373046653638852,617967,0.727,214612,0.252
"6019","santa clara",6019,"2021-05-04",30489,1853662,23875,1103948,6080,673966,534,75748,5457,408431,24937,758938,6025,1167369,"California",1967585,0.385720566074655,617967,0.727,214612,0.252
"6020","santa clara",6020,"2021-05-05",31849,1885511,24132,1128080,7177,681143,540,76288,5396,388030,26364,785302,5963,1173332,"California",1967585,0.399119733073794,617967,0.727,214612,0.252
"6021","santa clara",6021,"2021-05-06",34935,1920446,29034,1157114,5429,686572,472,76760,4613,362942,30196,815498,5108,1178440,"California",1967585,0.414466465235301,617967,0.727,214612,0.252
"6022","santa clara",6022,"2021-05-07",32034,1952480,25702,1182816,5853,692425,479,77239,4619,340800,27280,842778,5138,1183578,"California",1967585,0.428331177560309,617967,0.727,214612,0.252
"6023","santa clara",6023,"2021-05-08",16300,1968780,13261,1196077,2622,695047,417,77656,3473,331957,12749,855527,3906,1187484,"California",1967585,0.434810694328326,617967,0.727,214612,0.252
"6024","santa cruz",6024,"2020-12-15",2,2,2,2,0,0,0,0,2,2,0,0,2,2,"California",273999,0,114246,0.789,26937,0.186
"6025","santa cruz",6025,"2020-12-16",58,60,58,60,0,0,0,0,58,60,0,0,58,60,"California",273999,0,114246,0.789,26937,0.186
"6026","santa cruz",6026,"2020-12-17",389,449,389,449,0,0,0,0,389,449,0,0,389,449,"California",273999,0,114246,0.789,26937,0.186
"6027","santa cruz",6027,"2020-12-18",464,913,464,913,0,0,0,0,464,913,0,0,464,913,"California",273999,0,114246,0.789,26937,0.186
"6028","santa cruz",6028,"2020-12-19",179,1092,178,1091,1,1,0,0,179,1092,0,0,179,1092,"California",273999,0,114246,0.789,26937,0.186
"6029","santa cruz",6029,"2020-12-20",95,1187,95,1186,0,1,0,0,95,1187,0,0,95,1187,"California",273999,0,114246,0.789,26937,0.186
"6030","santa cruz",6030,"2020-12-21",437,1624,437,1623,0,1,0,0,437,1624,0,0,437,1624,"California",273999,0,114246,0.789,26937,0.186
"6031","santa cruz",6031,"2020-12-22",424,2048,423,2046,1,2,0,0,424,2048,0,0,424,2048,"California",273999,0,114246,0.789,26937,0.186
"6032","santa cruz",6032,"2020-12-23",372,2420,329,2375,43,45,0,0,372,2420,0,0,372,2420,"California",273999,0,114246,0.789,26937,0.186
"6033","santa cruz",6033,"2020-12-24",125,2545,49,2424,76,121,0,0,125,2545,0,0,125,2545,"California",273999,0,114246,0.789,26937,0.186
"6034","santa cruz",6034,"2020-12-25",11,2556,11,2435,0,121,0,0,11,2556,0,0,11,2556,"California",273999,0,114246,0.789,26937,0.186
"6035","santa cruz",6035,"2020-12-26",64,2620,45,2480,19,140,0,0,64,2620,0,0,64,2620,"California",273999,0,114246,0.789,26937,0.186
"6036","santa cruz",6036,"2020-12-27",32,2652,27,2507,5,145,0,0,32,2652,0,0,32,2652,"California",273999,0,114246,0.789,26937,0.186
"6037","santa cruz",6037,"2020-12-28",485,3137,108,2615,377,522,0,0,485,3137,0,0,485,3137,"California",273999,0,114246,0.789,26937,0.186
"6038","santa cruz",6038,"2020-12-29",798,3935,369,2984,429,951,0,0,798,3935,0,0,798,3935,"California",273999,0,114246,0.789,26937,0.186
"6039","santa cruz",6039,"2020-12-30",356,4291,164,3148,192,1143,0,0,356,4291,0,0,356,4291,"California",273999,0,114246,0.789,26937,0.186
"6040","santa cruz",6040,"2020-12-31",313,4604,11,3159,302,1445,0,0,313,4604,0,0,313,4604,"California",273999,0,114246,0.789,26937,0.186
"6041","santa cruz",6041,"2021-01-01",33,4637,1,3160,32,1477,0,0,33,4637,0,0,33,4637,"California",273999,0,114246,0.789,26937,0.186
"6042","santa cruz",6042,"2021-01-02",71,4708,57,3217,14,1491,0,0,71,4708,0,0,71,4708,"California",273999,0,114246,0.789,26937,0.186
"6043","santa cruz",6043,"2021-01-03",15,4723,7,3224,8,1499,0,0,15,4723,0,0,15,4723,"California",273999,0,114246,0.789,26937,0.186
"6044","santa cruz",6044,"2021-01-04",281,5004,123,3347,158,1657,0,0,279,5002,0,0,279,5002,"California",273999,0,114246,0.789,26937,0.186
"6045","santa cruz",6045,"2021-01-05",566,5570,429,3776,137,1794,0,0,264,4964,302,302,264,5266,"California",273999,0.00110219380362702,114246,0.789,26937,0.186
"6046","santa cruz",6046,"2021-01-06",803,6373,670,4446,133,1927,0,0,464,5090,338,640,464,5730,"California",273999,0.00233577494808375,114246,0.789,26937,0.186
"6047","santa cruz",6047,"2021-01-07",538,6911,211,4657,327,2254,0,0,385,5323,153,793,386,6116,"California",273999,0.00289417114661002,114246,0.789,26937,0.186
"6048","santa cruz",6048,"2021-01-08",936,7847,562,5219,374,2628,0,0,488,5364,448,1241,489,6605,"California",273999,0.00452921361026865,114246,0.789,26937,0.186
"6049","santa cruz",6049,"2021-01-09",464,8311,123,5342,341,2969,0,0,410,5720,54,1295,410,7015,"California",273999,0.00472629462151322,114246,0.789,26937,0.186
"6050","santa cruz",6050,"2021-01-10",80,8391,70,5412,10,2979,0,0,21,5682,59,1354,21,7036,"California",273999,0.00494162387453969,114246,0.789,26937,0.186
"6051","santa cruz",6051,"2021-01-11",726,9117,592,6004,134,3113,0,0,191,5339,535,1889,192,7228,"California",273999,0.00689418574520345,114246,0.789,26937,0.186
"6052","santa cruz",6052,"2021-01-12",736,9853,532,6536,204,3317,0,0,493,5589,243,2132,493,7721,"California",273999,0.007781050295804,114246,0.789,26937,0.186
"6053","santa cruz",6053,"2021-01-13",525,10378,228,6764,297,3614,0,0,441,5949,81,2213,441,8162,"California",273999,0.00807667181267085,114246,0.789,26937,0.186
"6054","santa cruz",6054,"2021-01-14",559,10937,103,6867,456,4070,0,0,493,6376,66,2279,493,8655,"California",273999,0.00831754860419199,114246,0.789,26937,0.186
"6055","santa cruz",6055,"2021-01-15",1458,12395,77,6944,1381,5451,0,0,1393,7707,64,2343,1395,10050,"California",273999,0.00855112609900036,114246,0.789,26937,0.186
"6056","santa cruz",6056,"2021-01-16",426,12821,53,6997,373,5824,0,0,407,8095,19,2362,407,10457,"California",273999,0.0086204694177716,114246,0.789,26937,0.186
"6057","santa cruz",6057,"2021-01-17",297,13118,41,7038,256,6080,0,0,272,8342,25,2387,272,10729,"California",273999,0.00871171062668112,114246,0.789,26937,0.186
"6058","santa cruz",6058,"2021-01-18",1016,14134,106,7144,910,6990,0,0,954,9234,62,2449,954,11683,"California",273999,0.00893798882477673,114246,0.789,26937,0.186
"6059","santa cruz",6059,"2021-01-19",1623,15757,525,7669,1098,8088,0,0,1270,10154,351,2800,1271,12954,"California",273999,0.0102190153978664,114246,0.789,26937,0.186
"6060","santa cruz",6060,"2021-01-20",1241,16998,182,7851,1059,9147,0,0,1045,11006,193,2993,1045,13999,"California",273999,0.0109233975306479,114246,0.789,26937,0.186
"6061","santa cruz",6061,"2021-01-21",1711,18709,201,8052,1510,10657,0,0,1603,12503,108,3101,1605,15604,"California",273999,0.0113175595531371,114246,0.789,26937,0.186
"6062","santa cruz",6062,"2021-01-22",1800,20509,532,8584,1268,11925,0,0,1698,14103,99,3200,1699,17303,"California",273999,0.0116788747404188,114246,0.789,26937,0.186
"6063","santa cruz",6063,"2021-01-23",402,20911,147,8731,255,12180,0,0,342,14386,59,3259,342,17645,"California",273999,0.0118942039934452,114246,0.789,26937,0.186
"6064","santa cruz",6064,"2021-01-24",116,21027,21,8752,95,12275,0,0,98,14466,18,3277,98,17743,"California",273999,0.0119598976638601,114246,0.789,26937,0.186
"6065","santa cruz",6065,"2021-01-25",1064,22091,362,9114,702,12977,0,0,553,14508,511,3788,553,18296,"California",273999,0.0138248679739707,114246,0.789,26937,0.186
"6066","santa cruz",6066,"2021-01-26",1696,23787,249,9363,1447,14424,0,0,1183,15178,513,4301,1183,19479,"California",273999,0.0156971375807941,114246,0.789,26937,0.186
"6067","santa cruz",6067,"2021-01-27",1653,25440,449,9812,1204,15628,0,0,1269,16065,382,4683,1269,20748,"California",273999,0.0170913032529316,114246,0.789,26937,0.186
"6068","santa cruz",6068,"2021-01-28",1752,27192,291,10103,1461,17089,0,0,1475,17264,277,4960,1476,22224,"California",273999,0.0181022558476491,114246,0.789,26937,0.186
"6069","santa cruz",6069,"2021-01-29",1736,28928,490,10593,1246,18335,0,0,1606,18741,129,5089,1606,23830,"California",273999,0.0185730604856222,114246,0.789,26937,0.186
"6070","santa cruz",6070,"2021-01-30",1060,29988,309,10902,751,19086,0,0,926,19533,134,5223,926,24756,"California",273999,0.0190621133653772,114246,0.789,26937,0.186
"6071","santa cruz",6071,"2021-01-31",222,30210,113,11015,109,19195,0,0,208,19727,14,5237,208,24964,"California",273999,0.0191132084423666,114246,0.789,26937,0.186
"6072","santa cruz",6072,"2021-02-01",1235,31445,761,11776,474,19669,0,0,828,20148,407,5644,828,25792,"California",273999,0.0205986153234136,114246,0.789,26937,0.186
"6073","santa cruz",6073,"2021-02-02",1010,32455,128,11904,882,20551,0,0,856,20851,153,5797,856,26648,"California",273999,0.0211570115219399,114246,0.789,26937,0.186
"6074","santa cruz",6074,"2021-02-03",2239,34694,962,12866,1277,21828,0,0,1924,22464,311,6108,1924,28572,"California",273999,0.0222920521607743,114246,0.789,26937,0.186
"6075","santa cruz",6075,"2021-02-04",1855,36549,774,13640,1081,22909,0,0,1517,23644,337,6445,1517,30089,"California",273999,0.0235219836568747,114246,0.789,26937,0.186
"6076","santa cruz",6076,"2021-02-05",3172,39721,793,14433,2379,25288,0,0,2851,26175,320,6765,2851,32940,"California",273999,0.0246898711309165,114246,0.789,26937,0.186
"6077","santa cruz",6077,"2021-02-06",2588,42309,163,14596,2425,27713,0,0,2242,28071,346,7111,2242,35182,"California",273999,0.0259526494622243,114246,0.789,26937,0.186
"6078","santa cruz",6078,"2021-02-07",909,43218,122,14718,787,28500,0,0,891,28944,18,7129,891,36073,"California",273999,0.0260183431326392,114246,0.789,26937,0.186
"6079","santa cruz",6079,"2021-02-08",717,43935,203,14921,514,29014,0,0,516,29260,200,7329,516,36589,"California",273999,0.0267482728039153,114246,0.789,26937,0.186
"6080","santa cruz",6080,"2021-02-09",2377,46312,1056,15977,1321,30335,0,0,2109,31105,264,7593,2109,38698,"California",273999,0.0277117799699999,114246,0.789,26937,0.186
"6081","santa cruz",6081,"2021-02-10",2203,48515,580,16557,1623,31958,0,0,1502,31916,692,8285,1503,40201,"California",273999,0.0302373366326154,114246,0.789,26937,0.186
"6082","santa cruz",6082,"2021-02-11",1861,50376,318,16875,1543,33501,0,0,1332,32721,527,8812,1332,41533,"California",273999,0.0321607013164282,114246,0.789,26937,0.186
"6083","santa cruz",6083,"2021-02-12",3228,53604,421,17296,2807,36308,0,0,1819,33142,1400,10212,1821,43354,"California",273999,0.0372702090153614,114246,0.789,26937,0.186
"6084","santa cruz",6084,"2021-02-13",1713,55317,124,17420,1589,37897,0,0,1299,34027,414,10626,1299,44653,"California",273999,0.038781163434903,114246,0.789,26937,0.186
"6085","santa cruz",6085,"2021-02-14",1411,56728,70,17490,1341,39238,0,0,1147,34910,264,10890,1147,45800,"California",273999,0.0397446706009876,114246,0.789,26937,0.186
"6086","santa cruz",6086,"2021-02-15",1585,58313,281,17771,1304,40542,0,0,567,34460,1018,11908,568,46368,"California",273999,0.0434600126277833,114246,0.789,26937,0.186
"6087","santa cruz",6087,"2021-02-16",1698,60011,208,17979,1490,42032,0,0,539,33862,1137,13045,539,46907,"California",273999,0.0476096628089884,114246,0.789,26937,0.186
"6088","santa cruz",6088,"2021-02-17",2923,62934,977,18956,1946,43978,0,0,1218,33391,1692,14737,1221,48128,"California",273999,0.0537848678279848,114246,0.789,26937,0.186
"6089","santa cruz",6089,"2021-02-18",2883,65817,638,19594,2245,46223,0,0,1232,32976,1647,16384,1232,49360,"California",273999,0.0597958386709441,114246,0.789,26937,0.186
"6090","santa cruz",6090,"2021-02-19",3273,69090,1148,20742,2125,48348,0,0,2012,33730,1258,17642,2012,51372,"California",273999,0.0643870963032712,114246,0.789,26937,0.186
"6091","santa cruz",6091,"2021-02-20",2388,71478,1500,22242,888,49236,0,0,1892,35126,496,18138,1892,53264,"California",273999,0.0661973218880361,114246,0.789,26937,0.186
"6092","santa cruz",6092,"2021-02-21",831,72309,364,22606,467,49703,0,0,703,35703,126,18264,703,53967,"California",273999,0.0666571775809401,114246,0.789,26937,0.186
"6093","santa cruz",6093,"2021-02-22",1259,73568,967,23573,292,49995,0,0,535,35516,722,18986,535,54502,"California",273999,0.0692922236942471,114246,0.789,26937,0.186
"6094","santa cruz",6094,"2021-02-23",2100,75668,938,24511,1162,51157,0,0,710,34837,1389,20375,710,55212,"California",273999,0.0743615852612601,114246,0.789,26937,0.186
"6095","santa cruz",6095,"2021-02-24",3196,78864,1674,26185,1522,52679,0,0,1217,34079,1975,22350,1217,56429,"California",273999,0.0815696407651123,114246,0.789,26937,0.186
"6096","santa cruz",6096,"2021-02-25",3250,82114,1438,27623,1812,54491,0,0,1786,34409,1457,23807,1787,58216,"California",273999,0.0868871784203592,114246,0.789,26937,0.186
"6097","santa cruz",6097,"2021-02-26",2730,84844,767,28390,1963,56454,0,0,1553,34791,1173,24980,1555,59771,"California",273999,0.091168215942394,114246,0.789,26937,0.186
"6098","santa cruz",6098,"2021-02-27",2635,87479,932,29322,1703,58157,0,0,1834,35826,799,25779,1834,61605,"California",273999,0.0940842849791423,114246,0.789,26937,0.186
"6099","santa cruz",6099,"2021-02-28",1302,88781,361,29683,941,59098,0,0,1086,36699,213,25992,1086,62691,"California",273999,0.0948616600790514,114246,0.789,26937,0.186
"6100","santa cruz",6100,"2021-03-01",1830,90611,1255,30938,575,59673,0,0,690,36252,1137,27129,690,63381,"California",273999,0.0990113102602564,114246,0.789,26937,0.186
"6101","santa cruz",6101,"2021-03-02",1537,92148,362,31300,1175,60848,0,0,860,36440,675,27804,863,64244,"California",273999,0.101474822900814,114246,0.789,26937,0.186
"6102","santa cruz",6102,"2021-03-03",2371,94519,633,31933,1738,62586,0,0,1300,36672,1068,28872,1300,65544,"California",273999,0.105372647345428,114246,0.789,26937,0.186
"6103","santa cruz",6103,"2021-03-04",3019,97538,1416,33349,1602,64188,1,1,2034,37734,974,29846,2036,67580,"California",273999,0.108927404844543,114246,0.789,26937,0.186
"6104","santa cruz",6104,"2021-03-05",2617,100155,488,33837,2111,66299,18,19,1135,37408,1479,31325,1153,68733,"California",273999,0.114325234763631,114246,0.789,26937,0.186
"6105","santa cruz",6105,"2021-03-06",3874,104029,1348,35185,2421,68720,105,124,2161,37959,1713,33038,2264,70997,"California",273999,0.120577082398111,114246,0.789,26937,0.186
"6106","santa cruz",6106,"2021-03-07",1348,105377,129,35314,1145,69865,74,198,557,37800,790,33828,631,71628,"California",273999,0.123460304599652,114246,0.789,26937,0.186
"6107","santa cruz",6107,"2021-03-08",1085,106462,219,35533,737,70602,129,327,653,38151,431,34259,782,72410,"California",273999,0.125033303041252,114246,0.789,26937,0.186
"6108","santa cruz",6108,"2021-03-09",1775,108237,244,35777,1384,71986,147,474,701,37927,1072,35331,848,73258,"California",273999,0.128945726079292,114246,0.789,26937,0.186
"6109","santa cruz",6109,"2021-03-10",3866,112103,2093,37870,1623,73609,150,624,1997,38209,1867,37198,2149,75407,"California",273999,0.135759619560655,114246,0.789,26937,0.186
"6110","santa cruz",6110,"2021-03-11",2809,114912,1220,39090,1414,75023,175,799,1547,38672,1261,38459,1724,77131,"California",273999,0.140361826138052,114246,0.789,26937,0.186
"6111","santa cruz",6111,"2021-03-12",2768,117680,892,39982,1582,76605,294,1093,912,38025,1852,40311,1205,78336,"California",273999,0.147120974894069,114246,0.789,26937,0.186
"6112","santa cruz",6112,"2021-03-13",2316,119996,1336,41318,936,77541,44,1137,1181,38120,1132,41443,1227,79563,"California",273999,0.151252376833492,114246,0.789,26937,0.186
"6113","santa cruz",6113,"2021-03-14",907,120903,217,41535,676,78217,14,1151,441,38110,464,41907,454,80017,"California",273999,0.152945813670853,114246,0.789,26937,0.186
"6114","santa cruz",6114,"2021-03-15",1359,122262,483,42018,840,79057,36,1187,585,37961,771,42678,622,80639,"California",273999,0.155759692553622,114246,0.789,26937,0.186
"6115","santa cruz",6115,"2021-03-16",2319,124581,1089,43107,1188,80245,42,1229,1340,38367,975,43653,1381,82020,"California",273999,0.159318099701094,114246,0.789,26937,0.186
"6116","santa cruz",6116,"2021-03-17",3872,128453,2236,45343,1626,81871,10,1239,2518,39548,1350,45003,2531,84551,"California",273999,0.164245124982208,114246,0.789,26937,0.186
"6117","santa cruz",6117,"2021-03-18",3869,132322,2094,47437,1655,83526,120,1359,2065,39932,1801,46804,2185,86736,"California",273999,0.17081814167205,114246,0.789,26937,0.186
"6118","santa cruz",6118,"2021-03-19",3285,135607,1325,48762,1735,85261,225,1584,1653,40183,1627,48431,1878,88614,"California",273999,0.176756119547882,114246,0.789,26937,0.186
"6119","santa cruz",6119,"2021-03-20",2172,137779,1615,50377,520,85781,37,1621,1097,40245,1072,49503,1134,89748,"California",273999,0.180668542585922,114246,0.789,26937,0.186
"6120","santa cruz",6120,"2021-03-21",828,138607,441,50818,265,86046,122,1743,445,40432,381,49884,568,90316,"California",273999,0.182059058609703,114246,0.789,26937,0.186
"6121","santa cruz",6121,"2021-03-22",1379,139986,852,51670,504,86550,23,1766,946,40972,430,50314,970,91286,"California",273999,0.183628407402947,114246,0.789,26937,0.186
"6122","santa cruz",6122,"2021-03-23",2569,142555,1445,53115,1074,87624,50,1816,1713,41881,854,51168,1763,93049,"California",273999,0.186745207099296,114246,0.789,26937,0.186
"6123","santa cruz",6123,"2021-03-24",3036,145591,2040,55155,975,88599,21,1837,1999,42868,1032,52200,2019,95068,"California",273999,0.190511644203081,114246,0.789,26937,0.186
"6124","santa cruz",6124,"2021-03-25",2655,148246,1334,56489,1285,89884,36,1873,1358,42972,1290,53490,1394,96462,"California",273999,0.195219690582812,114246,0.789,26937,0.186
"6125","santa cruz",6125,"2021-03-26",3040,151286,1836,58325,1177,91061,27,1900,2055,44076,978,54468,2082,98544,"California",273999,0.198789046675353,114246,0.789,26937,0.186
"6126","santa cruz",6126,"2021-03-27",3241,154527,2015,60340,1201,92262,25,1925,1530,43930,1702,56170,1556,100100,"California",273999,0.205000748177913,114246,0.789,26937,0.186
"6127","santa cruz",6127,"2021-03-28",934,155461,573,60913,347,92609,14,1939,497,44008,433,56603,511,100611,"California",273999,0.206581045916226,114246,0.789,26937,0.186
"6128","santa cruz",6128,"2021-03-29",1981,157442,886,61799,1027,93636,68,2007,1281,44660,697,57300,1349,101960,"California",273999,0.209124850820623,114246,0.789,26937,0.186
"6129","santa cruz",6129,"2021-03-30",2732,160174,821,62620,1748,95384,163,2170,1756,45606,973,58273,1919,103879,"California",273999,0.212675958671382,114246,0.789,26937,0.186
"6130","santa cruz",6130,"2021-03-31",4093,164267,2739,65359,1306,96690,48,2218,2107,45780,1982,60255,2156,106035,"California",273999,0.219909561713729,114246,0.789,26937,0.186
"6131","santa cruz",6131,"2021-04-01",4069,168336,2175,67534,1787,98477,107,2325,2071,45965,1993,62248,2178,108213,"California",273999,0.227183310887996,114246,0.789,26937,0.186
"6132","santa cruz",6132,"2021-04-02",3180,171516,1431,68965,1567,100044,182,2507,1770,46512,1405,63653,1952,110165,"California",273999,0.232311066828711,114246,0.789,26937,0.186
"6133","santa cruz",6133,"2021-04-03",2264,173780,1234,70199,895,100939,135,2642,892,46168,1370,65023,1026,111191,"California",273999,0.237311085076953,114246,0.789,26937,0.186
"6134","santa cruz",6134,"2021-04-04",939,174719,491,70690,393,101332,55,2697,551,46387,388,65411,607,111798,"California",273999,0.238727148639229,114246,0.789,26937,0.186
"6135","santa cruz",6135,"2021-04-05",2278,176997,795,71485,1313,102645,170,2867,1408,47097,869,66280,1579,113377,"California",273999,0.241898693060924,114246,0.789,26937,0.186
"6136","santa cruz",6136,"2021-04-06",3418,180415,1657,73142,1378,104023,383,3250,1980,48030,1428,67708,2361,115738,"California",273999,0.247110390913835,114246,0.789,26937,0.186
"6137","santa cruz",6137,"2021-04-07",4167,184582,1640,74782,2162,106185,365,3615,1873,47977,2290,69998,2237,117975,"California",273999,0.255468085649948,114246,0.789,26937,0.186
"6138","santa cruz",6138,"2021-04-08",4274,188856,2353,77135,1403,107588,518,4133,2516,49259,1750,71748,3032,121007,"California",273999,0.261854970273614,114246,0.789,26937,0.186
"6139","santa cruz",6139,"2021-04-09",3576,192432,1511,78646,1663,109251,402,4535,1966,50023,1605,73353,2369,123376,"California",273999,0.267712655885605,114246,0.789,26937,0.186
"6140","santa cruz",6140,"2021-04-10",2266,194698,1093,79739,921,110172,252,4787,1070,50153,1191,74544,1321,124697,"California",273999,0.272059387078055,114246,0.789,26937,0.186
"6141","santa cruz",6141,"2021-04-11",994,195692,519,80258,383,110555,92,4879,480,50210,514,75058,571,125268,"California",273999,0.273935306333235,114246,0.789,26937,0.186
"6142","santa cruz",6142,"2021-04-12",2290,197982,820,81078,1039,111594,431,5310,1088,50542,1186,76244,1518,126786,"California",273999,0.278263789283902,114246,0.789,26937,0.186
"6143","santa cruz",6143,"2021-04-13",2907,200889,1468,82546,1437,113031,2,5312,1638,50918,1264,77508,1640,128426,"California",273999,0.282876944806368,114246,0.789,26937,0.186
"6144","santa cruz",6144,"2021-04-14",4647,205536,2264,84810,2383,115414,0,5312,2383,51047,2256,79764,2385,130811,"California",273999,0.291110551498363,114246,0.789,26937,0.186
"6145","santa cruz",6145,"2021-04-15",5012,210548,3195,88005,1817,117231,0,5312,3166,52378,1835,81599,3166,133977,"California",273999,0.297807656232322,114246,0.789,26937,0.186
"6146","santa cruz",6146,"2021-04-16",4434,214982,2550,90555,1882,119113,2,5314,2473,52900,1954,83553,2476,136453,"California",273999,0.30493906912069,114246,0.789,26937,0.186
"6147","santa cruz",6147,"2021-04-17",2277,217259,897,91452,1380,120493,0,5314,1513,53651,762,84315,1513,137966,"California",273999,0.307720101168252,114246,0.789,26937,0.186
"6148","santa cruz",6148,"2021-04-18",1079,218338,519,91971,559,121052,1,5315,602,53779,475,84790,603,138569,"California",273999,0.309453684137533,114246,0.789,26937,0.186
"6149","santa cruz",6149,"2021-04-19",2440,220778,1529,93500,910,121962,1,5316,1507,54356,930,85720,1507,140076,"California",273999,0.312847857108968,114246,0.789,26937,0.186
"6150","santa cruz",6150,"2021-04-20",3121,223899,1691,95191,1430,123392,0,5316,1766,54780,1343,87063,1767,141843,"California",273999,0.317749334851587,114246,0.789,26937,0.186
"6151","santa cruz",6151,"2021-04-21",4289,228188,2903,98094,1386,124778,0,5316,2418,55342,1856,88919,2418,144261,"California",273999,0.32452308220103,114246,0.789,26937,0.186
"6152","santa cruz",6152,"2021-04-22",4350,232538,2935,101029,1415,126193,0,5316,2448,55898,1892,90811,2448,146709,"California",273999,0.331428216891303,114246,0.789,26937,0.186
"6153","santa cruz",6153,"2021-04-23",3087,235625,1747,102776,1339,127532,1,5317,1391,55604,1686,92497,1392,148101,"California",273999,0.337581524020161,114246,0.789,26937,0.186
"6154","santa cruz",6154,"2021-04-24",2255,237880,1086,103862,1166,128698,3,5320,695,54751,1551,94048,698,148799,"California",273999,0.343242128620907,114246,0.789,26937,0.186
"6155","santa cruz",6155,"2021-04-25",1097,238977,701,104563,384,129082,12,5332,452,54577,637,94685,463,149262,"California",273999,0.345566954623922,114246,0.789,26937,0.186
"6156","santa cruz",6156,"2021-04-26",1777,240754,910,105473,853,129935,14,5346,673,54171,1094,95779,688,149950,"California",273999,0.349559669925803,114246,0.789,26937,0.186
"6157","santa cruz",6157,"2021-04-27",2772,243526,852,106325,1854,131789,66,5412,1383,54236,1384,97163,1449,151399,"California",273999,0.354610783251034,114246,0.789,26937,0.186
"6158","santa cruz",6158,"2021-04-28",3445,246971,1912,108237,1458,133247,75,5487,1811,54497,1622,98785,1883,153282,"California",273999,0.360530512885084,114246,0.789,26937,0.186
"6159","santa cruz",6159,"2021-04-29",3745,250716,2487,110724,1195,134442,63,5550,1295,53419,2437,101222,1359,154641,"California",273999,0.369424705929584,114246,0.789,26937,0.186
"6160","santa cruz",6160,"2021-04-30",2272,252988,1221,111945,1008,135450,43,5593,1014,53227,1250,102472,1058,155699,"California",273999,0.37398676637506,114246,0.789,26937,0.186
"6161","santa cruz",6161,"2021-05-01",1306,254294,1039,112984,234,135684,33,5626,605,53166,699,103171,638,156337,"California",273999,0.37653787057617,114246,0.789,26937,0.186
"6162","santa cruz",6162,"2021-05-02",639,254933,465,113449,149,135833,25,5651,202,52957,437,103608,228,156565,"California",273999,0.378132766907908,114246,0.789,26937,0.186
"6163","santa cruz",6163,"2021-05-03",1883,256816,989,114438,828,136661,66,5717,622,52396,1250,104858,689,157254,"California",273999,0.382694827353385,114246,0.789,26937,0.186
"6164","santa cruz",6164,"2021-05-04",2699,259515,1574,116012,1053,137714,72,5789,867,51506,1828,106686,938,158192,"California",273999,0.389366384548849,114246,0.789,26937,0.186
"6165","santa cruz",6165,"2021-05-05",2698,262213,1323,117335,1313,139027,62,5851,657,50227,2002,108688,723,158915,"California",273999,0.396672980558323,114246,0.789,26937,0.186
"6166","santa cruz",6166,"2021-05-06",3783,265996,2402,119737,1159,140186,222,6073,825,48330,2941,111629,1044,159959,"California",273999,0.407406596374439,114246,0.789,26937,0.186
"6167","santa cruz",6167,"2021-05-07",2764,268760,1293,121030,1394,141580,77,6150,514,46675,2247,113876,592,160551,"California",273999,0.415607356231227,114246,0.789,26937,0.186
"6168","santa cruz",6168,"2021-05-08",1354,270114,685,121715,639,142219,30,6180,366,46087,986,114862,398,160949,"California",273999,0.419205909510619,114246,0.789,26937,0.186
"6169","shasta",6169,"2020-12-16",131,131,131,131,0,0,0,0,131,131,0,0,131,131,"California",177925,0,30000,0.323,60789,0.654
"6170","shasta",6170,"2020-12-17",418,549,418,549,0,0,0,0,418,549,0,0,418,549,"California",177925,0,30000,0.323,60789,0.654
"6171","shasta",6171,"2020-12-18",166,715,166,715,0,0,0,0,166,715,0,0,166,715,"California",177925,0,30000,0.323,60789,0.654
"6172","shasta",6172,"2020-12-19",1,716,1,716,0,0,0,0,1,716,0,0,1,716,"California",177925,0,30000,0.323,60789,0.654
"6173","shasta",6173,"2020-12-21",79,795,79,795,0,0,0,0,79,795,0,0,79,795,"California",177925,0,30000,0.323,60789,0.654
"6174","shasta",6174,"2020-12-22",191,986,186,981,5,5,0,0,191,986,0,0,191,986,"California",177925,0,30000,0.323,60789,0.654
"6175","shasta",6175,"2020-12-23",173,1159,169,1150,4,9,0,0,173,1159,0,0,173,1159,"California",177925,0,30000,0.323,60789,0.654
"6176","shasta",6176,"2020-12-24",18,1177,18,1168,0,9,0,0,18,1177,0,0,18,1177,"California",177925,0,30000,0.323,60789,0.654
"6177","shasta",6177,"2020-12-26",4,1181,1,1169,3,12,0,0,4,1181,0,0,4,1181,"California",177925,0,30000,0.323,60789,0.654
"6178","shasta",6178,"2020-12-27",1,1182,0,1169,1,13,0,0,1,1182,0,0,1,1182,"California",177925,0,30000,0.323,60789,0.654
"6179","shasta",6179,"2020-12-28",40,1222,31,1200,9,22,0,0,40,1222,0,0,40,1222,"California",177925,0,30000,0.323,60789,0.654
"6180","shasta",6180,"2020-12-29",186,1408,185,1385,1,23,0,0,186,1408,0,0,186,1408,"California",177925,0,30000,0.323,60789,0.654
"6181","shasta",6181,"2020-12-30",178,1586,168,1553,10,33,0,0,178,1586,0,0,178,1586,"California",177925,0,30000,0.323,60789,0.654
"6182","shasta",6182,"2020-12-31",83,1669,2,1555,81,114,0,0,83,1669,0,0,83,1669,"California",177925,0,30000,0.323,60789,0.654
"6183","shasta",6183,"2021-01-02",2,1671,0,1555,2,116,0,0,2,1671,0,0,2,1671,"California",177925,0,30000,0.323,60789,0.654
"6184","shasta",6184,"2021-01-03",1,1672,1,1556,0,116,0,0,1,1672,0,0,1,1672,"California",177925,0,30000,0.323,60789,0.654
"6185","shasta",6185,"2021-01-04",372,2044,306,1862,66,182,0,0,373,2045,0,0,373,2045,"California",177925,0,30000,0.323,60789,0.654
"6186","shasta",6186,"2021-01-05",335,2379,314,2176,21,203,0,0,254,2218,81,81,254,2299,"California",177925,0.000455247997751862,30000,0.323,60789,0.654
"6187","shasta",6187,"2021-01-06",466,2845,395,2571,71,274,0,0,204,2161,261,342,204,2503,"California",177925,0.00192215821273008,30000,0.323,60789,0.654
"6188","shasta",6188,"2021-01-07",125,2970,36,2607,89,363,0,0,104,2244,21,363,104,2607,"California",177925,0.00204018547140649,30000,0.323,60789,0.654
"6189","shasta",6189,"2021-01-08",525,3495,448,3055,77,440,0,0,317,2353,208,571,317,2924,"California",177925,0.00320921736686806,30000,0.323,60789,0.654
"6190","shasta",6190,"2021-01-09",72,3567,63,3118,9,449,0,0,70,2421,2,573,70,2994,"California",177925,0.00322045805817058,30000,0.323,60789,0.654
"6191","shasta",6191,"2021-01-10",5,3572,0,3118,5,454,0,0,4,2425,1,574,5,2999,"California",177925,0.00322607840382184,30000,0.323,60789,0.654
"6192","shasta",6192,"2021-01-11",406,3978,184,3302,222,676,0,0,371,2761,35,609,371,3370,"California",177925,0.00342279050161585,30000,0.323,60789,0.654
"6193","shasta",6193,"2021-01-12",484,4462,327,3629,157,833,0,0,310,2897,174,783,310,3680,"California",177925,0.00440073064493466,30000,0.323,60789,0.654
"6194","shasta",6194,"2021-01-13",599,5061,267,3896,332,1165,0,0,430,3158,169,952,430,4110,"California",177925,0.00535056905999719,30000,0.323,60789,0.654
"6195","shasta",6195,"2021-01-14",499,5560,51,3947,448,1613,0,0,481,3621,18,970,481,4591,"California",177925,0.00545173528171983,30000,0.323,60789,0.654
"6196","shasta",6196,"2021-01-15",692,6252,136,4083,556,2169,0,0,690,4309,2,972,690,5281,"California",177925,0.00546297597302234,30000,0.323,60789,0.654
"6197","shasta",6197,"2021-01-16",897,7149,54,4137,843,3012,0,0,894,5200,3,975,894,6175,"California",177925,0.00547983700997611,30000,0.323,60789,0.654
"6198","shasta",6198,"2021-01-17",27,7176,6,4143,21,3033,0,0,23,5219,4,979,23,6198,"California",177925,0.00550231839258114,30000,0.323,60789,0.654
"6199","shasta",6199,"2021-01-18",599,7775,129,4272,470,3503,0,0,591,5802,8,987,591,6789,"California",177925,0.0055472811577912,30000,0.323,60789,0.654
"6200","shasta",6200,"2021-01-19",1058,8833,398,4670,660,4163,0,0,910,6564,148,1135,910,7699,"California",177925,0.00637909231417732,30000,0.323,60789,0.654
"6201","shasta",6201,"2021-01-20",679,9512,411,5081,268,4431,0,0,494,6878,180,1315,494,8193,"California",177925,0.00739075453140368,30000,0.323,60789,0.654
"6202","shasta",6202,"2021-01-21",632,10144,279,5360,353,4784,0,0,609,7464,23,1338,609,8802,"California",177925,0.00752002248138261,30000,0.323,60789,0.654
"6203","shasta",6203,"2021-01-22",445,10589,171,5531,274,5058,0,0,439,7897,6,1344,439,9241,"California",177925,0.00755374455529015,30000,0.323,60789,0.654
"6204","shasta",6204,"2021-01-23",68,10657,5,5536,63,5121,0,0,67,7963,1,1345,67,9308,"California",177925,0.00755936490094141,30000,0.323,60789,0.654
"6205","shasta",6205,"2021-01-24",25,10682,2,5538,23,5144,0,0,24,7986,1,1346,24,9332,"California",177925,0.00756498524659267,30000,0.323,60789,0.654
"6206","shasta",6206,"2021-01-25",750,11432,491,6029,259,5403,0,0,464,8165,285,1631,464,9796,"California",177925,0.00916678375720107,30000,0.323,60789,0.654
"6207","shasta",6207,"2021-01-26",710,12142,333,6362,377,5780,0,0,476,8409,232,1863,476,10272,"California",177925,0.0104707039482928,30000,0.323,60789,0.654
"6208","shasta",6208,"2021-01-27",459,12601,179,6541,280,6060,0,0,410,8770,49,1912,410,10682,"California",177925,0.0107461008852044,30000,0.323,60789,0.654
"6209","shasta",6209,"2021-01-28",886,13487,576,7117,310,6370,0,0,664,9212,222,2134,664,11346,"California",177925,0.0119938176197836,30000,0.323,60789,0.654
"6210","shasta",6210,"2021-01-29",831,14318,330,7447,501,6871,0,0,641,9664,190,2324,642,11988,"California",177925,0.0130616832935226,30000,0.323,60789,0.654
"6211","shasta",6211,"2021-01-30",615,14933,14,7461,601,7472,0,0,606,10261,9,2333,606,12594,"California",177925,0.0131122664043839,30000,0.323,60789,0.654
"6212","shasta",6212,"2021-01-31",28,14961,4,7465,24,7496,0,0,26,10285,2,2335,26,12620,"California",177925,0.0131235070956864,30000,0.323,60789,0.654
"6213","shasta",6213,"2021-02-01",530,15491,148,7613,382,7878,0,0,386,10527,144,2479,386,13006,"California",177925,0.0139328368694675,30000,0.323,60789,0.654
"6214","shasta",6214,"2021-02-02",990,16481,501,8114,489,8367,0,0,898,11335,90,2569,898,13904,"California",177925,0.0144386679780807,30000,0.323,60789,0.654
"6215","shasta",6215,"2021-02-03",719,17200,210,8324,509,8876,0,0,485,11586,234,2803,485,14389,"California",177925,0.0157538288604749,30000,0.323,60789,0.654
"6216","shasta",6216,"2021-02-04",1094,18294,674,8998,420,9296,0,0,901,12295,192,2995,901,15290,"California",177925,0.0168329352255164,30000,0.323,60789,0.654
"6217","shasta",6217,"2021-02-05",1240,19534,164,9162,1076,10372,0,0,1033,13122,206,3201,1033,16323,"California",177925,0.0179907264296754,30000,0.323,60789,0.654
"6218","shasta",6218,"2021-02-06",1744,21278,41,9203,1703,12075,0,0,1721,14820,23,3224,1721,18044,"California",177925,0.0181199943796544,30000,0.323,60789,0.654
"6219","shasta",6219,"2021-02-07",26,21304,3,9206,23,12098,0,0,24,14842,2,3226,24,18068,"California",177925,0.0181312350709569,30000,0.323,60789,0.654
"6220","shasta",6220,"2021-02-08",596,21900,167,9373,429,12527,0,0,306,14858,290,3516,306,18374,"California",177925,0.0197611353098216,30000,0.323,60789,0.654
"6221","shasta",6221,"2021-02-09",1124,23024,654,10027,470,12997,0,0,732,15198,392,3908,732,19106,"California",177925,0.0219643108051145,30000,0.323,60789,0.654
"6222","shasta",6222,"2021-02-10",1124,24148,788,10815,336,13333,0,0,599,15272,526,4434,600,19706,"California",177925,0.024920612617676,30000,0.323,60789,0.654
"6223","shasta",6223,"2021-02-11",886,25034,186,11001,700,14033,0,0,364,15119,517,4951,364,20070,"California",177925,0.0278263313193761,30000,0.323,60789,0.654
"6224","shasta",6224,"2021-02-12",1727,26761,1146,12147,581,14614,0,0,1176,15744,551,5502,1176,21246,"California",177925,0.0309231417732191,30000,0.323,60789,0.654
"6225","shasta",6225,"2021-02-13",1382,28143,368,12515,1014,15628,0,0,570,15502,813,6315,571,21817,"California",177925,0.0354924827876914,30000,0.323,60789,0.654
"6226","shasta",6226,"2021-02-14",150,28293,4,12519,146,15774,0,0,126,15604,24,6339,126,21943,"California",177925,0.0356273710833216,30000,0.323,60789,0.654
"6227","shasta",6227,"2021-02-15",380,28673,90,12609,290,16064,0,0,211,15646,169,6508,211,22154,"California",177925,0.0365772094983842,30000,0.323,60789,0.654
"6228","shasta",6228,"2021-02-16",1194,29867,520,13129,674,16738,0,0,421,15295,772,7280,421,22575,"California",177925,0.040916116341155,30000,0.323,60789,0.654
"6229","shasta",6229,"2021-02-17",1034,30901,438,13567,596,17334,0,0,414,15089,620,7900,414,22989,"California",177925,0.0444007306449347,30000,0.323,60789,0.654
"6230","shasta",6230,"2021-02-18",947,31848,466,14033,481,17815,0,0,460,15062,487,8387,460,23449,"California",177925,0.0471378389770971,30000,0.323,60789,0.654
"6231","shasta",6231,"2021-02-19",1328,33176,935,14968,393,18208,0,0,861,15456,467,8854,861,24310,"California",177925,0.0497625403962344,30000,0.323,60789,0.654
"6232","shasta",6232,"2021-02-20",802,33978,89,15057,713,18921,0,0,303,15260,499,9353,303,24613,"California",177925,0.0525670928762119,30000,0.323,60789,0.654
"6233","shasta",6233,"2021-02-21",31,34009,2,15059,29,18950,0,0,9,15247,22,9375,9,24622,"California",177925,0.0526907404805396,30000,0.323,60789,0.654
"6234","shasta",6234,"2021-02-22",427,34436,74,15133,353,19303,0,0,178,15177,248,9623,178,24800,"California",177925,0.0540845862020514,30000,0.323,60789,0.654
"6235","shasta",6235,"2021-02-23",911,35347,471,15604,440,19743,0,0,325,14916,586,10209,325,25125,"California",177925,0.0573781087536884,30000,0.323,60789,0.654
"6236","shasta",6236,"2021-02-24",890,36237,508,16112,382,20125,0,0,273,14573,616,10825,273,25398,"California",177925,0.060840241674863,30000,0.323,60789,0.654
"6237","shasta",6237,"2021-02-25",517,36754,161,16273,356,20481,0,0,163,14383,353,11178,163,25561,"California",177925,0.0628242236897569,30000,0.323,60789,0.654
"6238","shasta",6238,"2021-02-26",790,37544,94,16367,696,21177,0,0,330,14255,458,11636,330,25891,"California",177925,0.0653983419980329,30000,0.323,60789,0.654
"6239","shasta",6239,"2021-02-27",828,38372,27,16394,801,21978,0,0,188,13805,638,12274,188,26079,"California",177925,0.0689841225235352,30000,0.323,60789,0.654
"6240","shasta",6240,"2021-02-28",176,38548,4,16398,172,22150,0,0,126,13881,50,12324,126,26205,"California",177925,0.0692651398060981,30000,0.323,60789,0.654
"6241","shasta",6241,"2021-03-01",584,39132,59,16457,525,22675,0,0,295,13888,288,12612,295,26500,"California",177925,0.0708837993536603,30000,0.323,60789,0.654
"6242","shasta",6242,"2021-03-02",1025,40157,473,16930,552,23227,0,0,336,13537,687,13299,336,26836,"California",177925,0.0747449768160742,30000,0.323,60789,0.654
"6243","shasta",6243,"2021-03-03",666,40823,167,17097,499,23726,0,0,243,13357,423,13722,243,27079,"California",177925,0.0771223830265561,30000,0.323,60789,0.654
"6244","shasta",6244,"2021-03-04",3022,43845,2412,19509,610,24336,0,0,1792,13921,1229,14951,1793,28872,"California",177925,0.0840297878319517,30000,0.323,60789,0.654
"6245","shasta",6245,"2021-03-05",1542,45387,162,19671,1351,25687,29,29,794,13995,749,15700,823,29695,"California",177925,0.0882394267247436,30000,0.323,60789,0.654
"6246","shasta",6246,"2021-03-06",2744,48131,387,20058,2310,27997,47,76,857,13014,1885,17585,904,30599,"California",177925,0.0988337782773641,30000,0.323,60789,0.654
"6247","shasta",6247,"2021-03-07",91,48222,3,20061,56,28053,32,108,37,13029,54,17639,69,30668,"California",177925,0.099137276942532,30000,0.323,60789,0.654
"6248","shasta",6248,"2021-03-08",568,48790,46,20107,383,28436,139,247,155,12912,411,18050,294,30962,"California",177925,0.101447239005199,30000,0.323,60789,0.654
"6249","shasta",6249,"2021-03-09",1254,50044,594,20701,482,28918,178,425,698,13231,556,18606,875,31837,"California",177925,0.104572151187298,30000,0.323,60789,0.654
"6250","shasta",6250,"2021-03-10",801,50845,258,20959,341,29259,202,627,136,12904,664,19270,337,32174,"California",177925,0.108304060699733,30000,0.323,60789,0.654
"6251","shasta",6251,"2021-03-11",1475,52320,471,21430,732,29991,272,899,940,13584,532,19802,1212,33386,"California",177925,0.111294084586202,30000,0.323,60789,0.654
"6252","shasta",6252,"2021-03-12",1530,53850,833,22263,448,30439,249,1148,398,13098,1131,20933,645,34031,"California",177925,0.117650695517774,30000,0.323,60789,0.654
"6253","shasta",6253,"2021-03-13",758,54608,425,22688,232,30671,101,1249,475,13390,282,21215,574,34605,"California",177925,0.119235632991429,30000,0.323,60789,0.654
"6254","shasta",6254,"2021-03-14",1019,55627,8,22696,989,31660,22,1271,881,14156,138,21353,904,35509,"California",177925,0.120011240691303,30000,0.323,60789,0.654
"6255","shasta",6255,"2021-03-15",498,56125,35,22731,363,32023,100,1371,210,14177,288,21641,309,35818,"California",177925,0.121629900238865,30000,0.323,60789,0.654
"6256","shasta",6256,"2021-03-16",1132,57257,147,22878,918,32941,67,1438,849,14810,283,21924,916,36734,"California",177925,0.123220458058171,30000,0.323,60789,0.654
"6257","shasta",6257,"2021-03-17",734,57991,191,23069,485,33426,58,1496,395,14930,333,22257,453,37187,"California",177925,0.125092033160039,30000,0.323,60789,0.654
"6258","shasta",6258,"2021-03-18",1542,59533,586,23655,852,34278,104,1600,1116,15728,422,22679,1220,38407,"California",177925,0.12746381902487,30000,0.323,60789,0.654
"6259","shasta",6259,"2021-03-19",648,60181,196,23851,396,34674,56,1656,415,15967,232,22911,471,38878,"California",177925,0.128767739215962,30000,0.323,60789,0.654
"6260","shasta",6260,"2021-03-20",748,60929,490,24341,244,34918,14,1670,600,16433,148,23059,614,39492,"California",177925,0.129599550372348,30000,0.323,60789,0.654
"6261","shasta",6261,"2021-03-21",312,61241,297,24638,4,34922,11,1681,286,16705,25,23084,297,39789,"California",177925,0.129740059013629,30000,0.323,60789,0.654
"6262","shasta",6262,"2021-03-22",347,61588,37,24675,274,35196,36,1717,199,16793,147,23231,235,40024,"California",177925,0.130566249824364,30000,0.323,60789,0.654
"6263","shasta",6263,"2021-03-23",1310,62898,651,25326,600,35796,59,1776,758,17063,547,23778,817,40841,"California",177925,0.133640578895602,30000,0.323,60789,0.654
"6264","shasta",6264,"2021-03-24",607,63505,156,25482,414,36210,37,1813,365,17224,241,24019,402,41243,"California",177925,0.134995082197555,30000,0.323,60789,0.654
"6265","shasta",6265,"2021-03-25",1137,64642,452,25934,664,36874,21,1834,822,17756,312,24331,844,42087,"California",177925,0.136748630040747,30000,0.323,60789,0.654
"6266","shasta",6266,"2021-03-26",1837,66479,1405,27339,402,37276,30,1864,1478,18906,359,24690,1509,43596,"California",177925,0.138766334129549,30000,0.323,60789,0.654
"6267","shasta",6267,"2021-03-27",1595,68074,407,27746,317,37593,871,2735,576,19333,1017,25707,1444,45040,"California",177925,0.144482225656878,30000,0.323,60789,0.654
"6268","shasta",6268,"2021-03-28",405,68479,299,28045,96,37689,10,2745,302,19544,101,25808,312,45352,"California",177925,0.145049880567655,30000,0.323,60789,0.654
"6269","shasta",6269,"2021-03-29",418,68897,40,28085,366,38055,12,2757,164,19467,253,26061,176,45528,"California",177925,0.146471828017423,30000,0.323,60789,0.654
"6270","shasta",6270,"2021-03-30",1245,70142,766,28851,462,38517,17,2774,626,19494,616,26677,643,46171,"California",177925,0.149933960938598,30000,0.323,60789,0.654
"6271","shasta",6271,"2021-03-31",619,70761,207,29058,407,38924,5,2779,383,19651,231,26908,388,46559,"California",177925,0.151232260784038,30000,0.323,60789,0.654
"6272","shasta",6272,"2021-04-01",890,71651,246,29304,632,39556,12,2791,572,19918,317,27225,584,47143,"California",177925,0.153013910355487,30000,0.323,60789,0.654
"6273","shasta",6273,"2021-04-02",753,72404,201,29505,500,40056,52,2843,414,20047,337,27562,466,47609,"California",177925,0.154907966839961,30000,0.323,60789,0.654
"6274","shasta",6274,"2021-04-03",514,72918,361,29866,134,40190,19,2862,389,20330,125,27687,408,48017,"California",177925,0.155610510046368,30000,0.323,60789,0.654
"6275","shasta",6275,"2021-04-04",288,73206,174,30040,94,40284,20,2882,214,20490,74,27761,234,48251,"California",177925,0.156026415624561,30000,0.323,60789,0.654
"6276","shasta",6276,"2021-04-05",442,73648,68,30108,311,40595,63,2945,255,20621,187,27948,318,48569,"California",177925,0.157077420261346,30000,0.323,60789,0.654
"6277","shasta",6277,"2021-04-06",1165,74813,486,30594,504,41099,175,3120,542,20718,619,28567,716,49285,"California",177925,0.160556414219475,30000,0.323,60789,0.654
"6278","shasta",6278,"2021-04-07",653,75466,213,30807,277,41376,163,3283,256,20743,393,28960,418,49703,"California",177925,0.162765210060419,30000,0.323,60789,0.654
"6279","shasta",6279,"2021-04-08",1139,76605,259,31066,726,42102,154,3437,230,20220,906,29866,383,50086,"California",177925,0.167857243220458,30000,0.323,60789,0.654
"6280","shasta",6280,"2021-04-09",2581,79186,2062,33128,310,42412,209,3646,2004,21863,568,30434,2211,52297,"California",177925,0.171049599550372,30000,0.323,60789,0.654
"6281","shasta",6281,"2021-04-10",878,80064,592,33720,157,42569,129,3775,265,21643,613,31047,393,52690,"California",177925,0.174494871434593,30000,0.323,60789,0.654
"6282","shasta",6282,"2021-04-11",1250,81314,395,34115,835,43404,20,3795,143,20703,1103,32150,163,52853,"California",177925,0.18069411268793,30000,0.323,60789,0.654
"6283","shasta",6283,"2021-04-12",338,81652,8,34123,268,43672,62,3857,97,20621,240,32390,158,53011,"California",177925,0.182042995644232,30000,0.323,60789,0.654
"6284","shasta",6284,"2021-04-13",1257,82909,366,34489,889,44561,2,3859,340,20049,913,33303,341,53352,"California",177925,0.18717437122383,30000,0.323,60789,0.654
"6285","shasta",6285,"2021-04-14",601,83510,142,34631,457,45018,2,3861,222,19895,378,33681,224,53576,"California",177925,0.189298861880006,30000,0.323,60789,0.654
"6286","shasta",6286,"2021-04-15",1070,84580,259,34890,811,45829,0,3861,303,19434,764,34445,303,53879,"California",177925,0.193592805957566,30000,0.323,60789,0.654
"6287","shasta",6287,"2021-04-16",2344,86924,1849,36739,495,46324,0,3861,938,18968,1404,35849,938,54817,"California",177925,0.201483771251932,30000,0.323,60789,0.654
"6288","shasta",6288,"2021-04-17",643,87567,411,37150,232,46556,0,3861,192,18709,451,36300,192,55009,"California",177925,0.204018547140649,30000,0.323,60789,0.654
"6289","shasta",6289,"2021-04-18",266,87833,241,37391,25,46581,0,3861,33,18511,231,36531,33,55042,"California",177925,0.20531684698609,30000,0.323,60789,0.654
"6290","shasta",6290,"2021-04-19",381,88214,29,37420,352,46933,0,3861,162,18454,219,36750,162,55204,"California",177925,0.206547702683715,30000,0.323,60789,0.654
"6291","shasta",6291,"2021-04-20",1014,89228,257,37677,757,47690,0,3861,379,18199,634,37384,379,55583,"California",177925,0.210111001826612,30000,0.323,60789,0.654
"6292","shasta",6292,"2021-04-21",609,89837,223,37900,386,48076,0,3861,307,18205,301,37685,307,55890,"California",177925,0.211802725867641,30000,0.323,60789,0.654
"6293","shasta",6293,"2021-04-22",961,90798,284,38184,677,48753,0,3861,301,17848,658,38343,301,56191,"California",177925,0.215500913306168,30000,0.323,60789,0.654
"6294","shasta",6294,"2021-04-23",661,91459,266,38450,395,49148,0,3861,329,17846,331,38674,329,56520,"California",177925,0.217361247716735,30000,0.323,60789,0.654
"6295","shasta",6295,"2021-04-24",596,92055,360,38810,236,49384,0,3861,106,17462,490,39164,106,56626,"California",177925,0.220115217085851,30000,0.323,60789,0.654
"6296","shasta",6296,"2021-04-25",212,92267,182,38992,29,49413,1,3862,38,17327,174,39338,39,56665,"California",177925,0.22109315722917,30000,0.323,60789,0.654
"6297","shasta",6297,"2021-04-26",465,92732,50,39042,410,49823,5,3867,330,17528,133,39471,334,56999,"California",177925,0.221840663200787,30000,0.323,60789,0.654
"6298","shasta",6298,"2021-04-27",512,93244,171,39213,305,50128,36,3903,288,17629,221,39692,322,57321,"California",177925,0.223082759589715,30000,0.323,60789,0.654
"6299","shasta",6299,"2021-04-28",574,93818,155,39368,386,50514,33,3936,250,17587,324,40016,282,57603,"California",177925,0.224903751580722,30000,0.323,60789,0.654
"6300","shasta",6300,"2021-04-29",782,94600,120,39488,639,51153,23,3959,185,17199,596,40612,208,57811,"California",177925,0.228253477588872,30000,0.323,60789,0.654
"6301","shasta",6301,"2021-04-30",2266,96866,1839,41327,396,51549,31,3990,270,15504,1996,42608,301,58112,"California",177925,0.239471687508782,30000,0.323,60789,0.654
"6302","shasta",6302,"2021-05-01",223,97089,20,41347,127,51676,76,4066,95,15547,128,42736,171,58283,"California",177925,0.240191091752143,30000,0.323,60789,0.654
"6303","shasta",6303,"2021-05-02",46,97135,16,41363,17,51693,13,4079,19,15552,27,42763,32,58315,"California",177925,0.240342841084727,30000,0.323,60789,0.654
"6304","shasta",6304,"2021-05-03",349,97484,93,41456,230,51923,26,4105,111,15452,237,43000,137,58452,"California",177925,0.241674863004075,30000,0.323,60789,0.654
"6305","shasta",6305,"2021-05-04",500,97984,175,41631,290,52213,35,4140,240,15470,257,43257,275,58727,"California",177925,0.243119291836448,30000,0.323,60789,0.654
"6306","shasta",6306,"2021-05-05",426,98410,137,41768,270,52483,19,4159,194,15452,231,43488,213,58940,"California",177925,0.244417591681888,30000,0.323,60789,0.654
"6307","shasta",6307,"2021-05-06",682,99092,263,42031,383,52866,36,4195,294,15402,380,43868,330,59270,"California",177925,0.246553323029366,30000,0.323,60789,0.654
"6308","shasta",6308,"2021-05-07",1094,100186,732,42763,322,53188,40,4235,294,14936,800,44668,334,59604,"California",177925,0.251049599550372,30000,0.323,60789,0.654
"6309","shasta",6309,"2021-05-08",168,100354,81,42844,77,53265,10,4245,98,14976,68,44736,108,59712,"California",177925,0.251431783054658,30000,0.323,60789,0.654
"6310","sierra",6310,"2020-12-18",1,1,1,1,0,0,0,0,1,1,0,0,1,1,"California",3115,0,730,0.378,1142,0.592
"6311","sierra",6311,"2020-12-21",2,3,2,3,0,0,0,0,2,3,0,0,2,3,"California",3115,0,730,0.378,1142,0.592
"6312","sierra",6312,"2020-12-22",12,15,12,15,0,0,0,0,12,15,0,0,12,15,"California",3115,0,730,0.378,1142,0.592
"6313","sierra",6313,"2020-12-23",4,19,4,19,0,0,0,0,4,19,0,0,4,19,"California",3115,0,730,0.378,1142,0.592
"6314","sierra",6314,"2020-12-28",1,20,0,19,1,1,0,0,1,20,0,0,1,20,"California",3115,0,730,0.378,1142,0.592
"6315","sierra",6315,"2020-12-29",49,69,7,26,42,43,0,0,49,69,0,0,49,69,"California",3115,0,730,0.378,1142,0.592
"6316","sierra",6316,"2020-12-30",2,71,0,26,2,45,0,0,2,71,0,0,2,71,"California",3115,0,730,0.378,1142,0.592
"6317","sierra",6317,"2020-12-31",13,84,0,26,13,58,0,0,13,84,0,0,13,84,"California",3115,0,730,0.378,1142,0.592
"6318","sierra",6318,"2021-01-01",1,85,1,27,0,58,0,0,1,85,0,0,1,85,"California",3115,0,730,0.378,1142,0.592
"6319","sierra",6319,"2021-01-05",64,149,2,29,62,120,0,0,64,149,0,0,64,149,"California",3115,0,730,0.378,1142,0.592
"6320","sierra",6320,"2021-01-06",1,150,1,30,0,120,0,0,1,150,0,0,1,150,"California",3115,0,730,0.378,1142,0.592
"6321","sierra",6321,"2021-01-07",21,171,1,31,20,140,0,0,20,169,1,1,20,170,"California",3115,0.000321027287319422,730,0.378,1142,0.592
"6322","sierra",6322,"2021-01-08",1,172,1,32,0,140,0,0,1,170,0,1,1,171,"California",3115,0.000321027287319422,730,0.378,1142,0.592
"6323","sierra",6323,"2021-01-11",3,175,3,35,0,140,0,0,0,167,3,4,0,171,"California",3115,0.00128410914927769,730,0.378,1142,0.592
"6324","sierra",6324,"2021-01-12",40,215,12,47,28,168,0,0,28,183,12,16,28,199,"California",3115,0.00513643659711075,730,0.378,1142,0.592
"6325","sierra",6325,"2021-01-13",4,219,3,50,1,169,0,0,1,181,3,19,1,200,"California",3115,0.00609951845906902,730,0.378,1142,0.592
"6326","sierra",6326,"2021-01-14",35,254,2,52,33,202,0,0,35,216,0,19,35,235,"California",3115,0.00609951845906902,730,0.378,1142,0.592
"6327","sierra",6327,"2021-01-15",3,257,1,53,2,204,0,0,3,219,0,19,3,238,"California",3115,0.00609951845906902,730,0.378,1142,0.592
"6328","sierra",6328,"2021-01-18",2,259,0,53,2,206,0,0,2,221,0,19,2,240,"California",3115,0.00609951845906902,730,0.378,1142,0.592
"6329","sierra",6329,"2021-01-19",32,291,0,53,32,238,0,0,32,253,0,19,32,272,"California",3115,0.00609951845906902,730,0.378,1142,0.592
"6330","sierra",6330,"2021-01-20",1,292,1,54,0,238,0,0,1,254,0,19,1,273,"California",3115,0.00609951845906902,730,0.378,1142,0.592
"6331","sierra",6331,"2021-01-21",53,345,0,54,53,291,0,0,53,307,0,19,53,326,"California",3115,0.00609951845906902,730,0.378,1142,0.592
"6332","sierra",6332,"2021-01-22",2,347,0,54,2,293,0,0,2,309,0,19,2,328,"California",3115,0.00609951845906902,730,0.378,1142,0.592
"6333","sierra",6333,"2021-01-23",2,349,0,54,2,295,0,0,2,311,0,19,2,330,"California",3115,0.00609951845906902,730,0.378,1142,0.592
"6334","sierra",6334,"2021-01-26",62,411,0,54,62,357,0,0,24,297,38,57,24,354,"California",3115,0.0182985553772071,730,0.378,1142,0.592
"6335","sierra",6335,"2021-01-27",4,415,4,58,0,357,0,0,0,293,4,61,0,354,"California",3115,0.0195826645264848,730,0.378,1142,0.592
"6336","sierra",6336,"2021-01-28",53,468,0,58,53,410,0,0,43,326,10,71,43,397,"California",3115,0.022792937399679,730,0.378,1142,0.592
"6337","sierra",6337,"2021-01-29",2,470,0,58,2,412,0,0,2,328,0,71,2,399,"California",3115,0.022792937399679,730,0.378,1142,0.592
"6338","sierra",6338,"2021-01-30",3,473,3,61,0,412,0,0,2,329,1,72,2,401,"California",3115,0.0231139646869984,730,0.378,1142,0.592
"6339","sierra",6339,"2021-02-01",1,474,0,61,1,413,0,0,0,328,1,73,0,401,"California",3115,0.0234349919743178,730,0.378,1142,0.592
"6340","sierra",6340,"2021-02-02",58,532,1,62,57,470,0,0,19,308,39,112,19,420,"California",3115,0.0359550561797753,730,0.378,1142,0.592
"6341","sierra",6341,"2021-02-03",6,538,5,67,1,471,0,0,5,312,1,113,5,425,"California",3115,0.0362760834670947,730,0.378,1142,0.592
"6342","sierra",6342,"2021-02-04",104,642,6,73,98,569,0,0,55,318,49,162,55,480,"California",3115,0.0520064205457464,730,0.378,1142,0.592
"6343","sierra",6343,"2021-02-05",6,648,4,77,2,571,0,0,5,322,1,163,5,485,"California",3115,0.0523274478330658,730,0.378,1142,0.592
"6344","sierra",6344,"2021-02-09",51,699,0,77,51,622,0,0,48,367,3,166,48,533,"California",3115,0.0532905296950241,730,0.378,1142,0.592
"6345","sierra",6345,"2021-02-10",5,704,2,79,3,625,0,0,4,370,1,167,4,537,"California",3115,0.0536115569823435,730,0.378,1142,0.592
"6346","sierra",6346,"2021-02-11",196,900,1,80,195,820,0,0,134,442,62,229,134,671,"California",3115,0.0735152487961477,730,0.378,1142,0.592
"6347","sierra",6347,"2021-02-12",21,921,0,80,21,841,0,0,20,461,1,230,20,691,"California",3115,0.0738362760834671,730,0.378,1142,0.592
"6348","sierra",6348,"2021-02-13",1,922,1,81,0,841,0,0,1,462,0,230,1,692,"California",3115,0.0738362760834671,730,0.378,1142,0.592
"6349","sierra",6349,"2021-02-15",2,924,2,83,0,841,0,0,0,460,2,232,0,692,"California",3115,0.0744783306581059,730,0.378,1142,0.592
"6350","sierra",6350,"2021-02-16",43,967,0,83,43,884,0,0,10,437,33,265,10,702,"California",3115,0.0850722311396469,730,0.378,1142,0.592
"6351","sierra",6351,"2021-02-17",4,971,0,83,4,888,0,0,1,435,3,268,1,703,"California",3115,0.0860353130016051,730,0.378,1142,0.592
"6352","sierra",6352,"2021-02-18",141,1112,0,83,141,1029,0,0,91,476,50,318,91,794,"California",3115,0.102086677367576,730,0.378,1142,0.592
"6353","sierra",6353,"2021-02-19",2,1114,1,84,1,1030,0,0,1,476,1,319,1,795,"California",3115,0.102407704654896,730,0.378,1142,0.592
"6354","sierra",6354,"2021-02-20",2,1116,2,86,0,1030,0,0,0,474,2,321,0,795,"California",3115,0.103049759229535,730,0.378,1142,0.592
"6355","sierra",6355,"2021-02-22",1,1117,1,87,0,1030,0,0,1,475,0,321,1,796,"California",3115,0.103049759229535,730,0.378,1142,0.592
"6356","sierra",6356,"2021-02-23",4,1121,0,87,4,1034,0,0,4,479,0,321,4,800,"California",3115,0.103049759229535,730,0.378,1142,0.592
"6357","sierra",6357,"2021-02-24",4,1125,3,90,1,1035,0,0,3,481,1,322,3,803,"California",3115,0.103370786516854,730,0.378,1142,0.592
"6358","sierra",6358,"2021-02-25",125,1250,2,92,123,1158,0,0,58,473,66,388,58,861,"California",3115,0.124558587479936,730,0.378,1142,0.592
"6359","sierra",6359,"2021-02-26",11,1261,6,98,5,1163,0,0,4,470,7,395,4,865,"California",3115,0.126805778491172,730,0.378,1142,0.592
"6360","sierra",6360,"2021-02-27",2,1263,2,100,0,1163,0,0,0,468,2,397,0,865,"California",3115,0.127447833065811,730,0.378,1142,0.592
"6361","sierra",6361,"2021-03-01",2,1265,2,102,0,1163,0,0,0,466,2,399,0,865,"California",3115,0.128089887640449,730,0.378,1142,0.592
"6362","sierra",6362,"2021-03-02",56,1321,0,102,56,1219,0,0,38,486,18,417,38,903,"California",3115,0.133868378812199,730,0.378,1142,0.592
"6363","sierra",6363,"2021-03-03",2,1323,2,104,0,1219,0,0,1,486,1,418,1,904,"California",3115,0.134189406099518,730,0.378,1142,0.592
"6364","sierra",6364,"2021-03-04",109,1432,0,104,109,1328,0,0,60,497,49,467,60,964,"California",3115,0.14991974317817,730,0.378,1142,0.592
"6365","sierra",6365,"2021-03-05",13,1445,1,105,12,1340,0,0,11,506,2,469,11,975,"California",3115,0.150561797752809,730,0.378,1142,0.592
"6366","sierra",6366,"2021-03-07",1,1446,1,106,0,1340,0,0,0,505,1,470,0,975,"California",3115,0.150882825040128,730,0.378,1142,0.592
"6367","sierra",6367,"2021-03-08",2,1448,2,108,0,1340,0,0,2,507,0,470,2,977,"California",3115,0.150882825040128,730,0.378,1142,0.592
"6368","sierra",6368,"2021-03-09",56,1504,0,108,56,1396,0,0,12,475,44,514,12,989,"California",3115,0.165008025682183,730,0.378,1142,0.592
"6369","sierra",6369,"2021-03-10",6,1510,0,108,6,1402,0,0,4,477,2,516,4,993,"California",3115,0.165650080256822,730,0.378,1142,0.592
"6370","sierra",6370,"2021-03-11",175,1685,0,108,175,1577,0,0,43,389,131,647,43,1036,"California",3115,0.207704654895666,730,0.378,1142,0.592
"6371","sierra",6371,"2021-03-12",20,1705,1,109,19,1596,0,0,0,369,20,667,0,1036,"California",3115,0.214125200642055,730,0.378,1142,0.592
"6372","sierra",6372,"2021-03-13",28,1733,0,109,28,1624,0,0,28,397,0,667,28,1064,"California",3115,0.214125200642055,730,0.378,1142,0.592
"6373","sierra",6373,"2021-03-14",1,1734,0,109,0,1624,1,1,0,397,1,668,1,1065,"California",3115,0.214446227929374,730,0.378,1142,0.592
"6374","sierra",6374,"2021-03-15",1,1735,1,110,0,1624,0,1,0,396,1,669,0,1065,"California",3115,0.214767255216693,730,0.378,1142,0.592
"6375","sierra",6375,"2021-03-16",36,1771,0,110,35,1659,1,2,23,407,13,682,24,1089,"California",3115,0.218940609951846,730,0.378,1142,0.592
"6376","sierra",6376,"2021-03-17",4,1775,3,113,1,1660,0,2,1,405,3,685,1,1090,"California",3115,0.219903691813804,730,0.378,1142,0.592
"6377","sierra",6377,"2021-03-18",158,1933,0,113,158,1818,0,2,65,377,93,778,65,1155,"California",3115,0.24975922953451,730,0.378,1142,0.592
"6378","sierra",6378,"2021-03-19",4,1937,2,115,2,1820,0,2,1,375,3,781,1,1156,"California",3115,0.250722311396469,730,0.378,1142,0.592
"6379","sierra",6379,"2021-03-20",1,1938,0,115,1,1821,0,2,1,376,0,781,1,1157,"California",3115,0.250722311396469,730,0.378,1142,0.592
"6380","sierra",6380,"2021-03-23",22,1960,0,115,22,1843,0,2,13,380,9,790,13,1170,"California",3115,0.253611556982344,730,0.378,1142,0.592
"6381","sierra",6381,"2021-03-24",3,1963,1,116,2,1845,0,2,1,379,2,792,1,1171,"California",3115,0.254253611556982,730,0.378,1142,0.592
"6382","sierra",6382,"2021-03-25",99,2062,1,117,98,1943,0,2,50,380,49,841,50,1221,"California",3115,0.269983948635634,730,0.378,1142,0.592
"6383","sierra",6383,"2021-03-26",12,2074,1,118,11,1954,0,2,9,386,3,844,9,1230,"California",3115,0.270947030497592,730,0.378,1142,0.592
"6384","sierra",6384,"2021-03-27",2,2076,1,119,1,1955,0,2,0,384,2,846,0,1230,"California",3115,0.271589085072231,730,0.378,1142,0.592
"6385","sierra",6385,"2021-03-29",1,2077,1,120,0,1955,0,2,0,383,1,847,0,1230,"California",3115,0.271910112359551,730,0.378,1142,0.592
"6386","sierra",6386,"2021-03-30",55,2132,1,121,54,2009,0,2,22,372,33,880,22,1252,"California",3115,0.282504012841092,730,0.378,1142,0.592
"6387","sierra",6387,"2021-03-31",8,2140,0,121,8,2017,0,2,8,380,0,880,8,1260,"California",3115,0.282504012841092,730,0.378,1142,0.592
"6388","sierra",6388,"2021-04-01",64,2204,2,123,62,2079,0,2,6,330,56,936,6,1266,"California",3115,0.300481540930979,730,0.378,1142,0.592
"6389","sierra",6389,"2021-04-02",3,2207,2,125,1,2080,0,2,2,331,1,937,2,1268,"California",3115,0.300802568218299,730,0.378,1142,0.592
"6390","sierra",6390,"2021-04-04",1,2208,0,125,1,2081,0,2,0,331,0,937,0,1268,"California",3115,0.300802568218299,730,0.378,1142,0.592
"6391","sierra",6391,"2021-04-05",1,2209,1,126,0,2081,0,2,1,332,0,937,1,1269,"California",3115,0.300802568218299,730,0.378,1142,0.592
"6392","sierra",6392,"2021-04-06",10,2219,0,126,10,2091,0,2,0,322,10,947,0,1269,"California",3115,0.304012841091493,730,0.378,1142,0.592
"6393","sierra",6393,"2021-04-07",15,2234,3,129,6,2097,6,8,3,320,11,958,9,1278,"California",3115,0.307544141252006,730,0.378,1142,0.592
"6394","sierra",6394,"2021-04-08",53,2287,2,131,51,2148,0,8,16,299,37,995,16,1294,"California",3115,0.319422150882825,730,0.378,1142,0.592
"6395","sierra",6395,"2021-04-09",2,2289,2,133,0,2148,0,8,1,299,1,996,1,1295,"California",3115,0.319743178170144,730,0.378,1142,0.592
"6396","sierra",6396,"2021-04-10",27,2316,0,133,27,2175,0,8,0,272,27,1023,0,1295,"California",3115,0.328410914927769,730,0.378,1142,0.592
"6397","sierra",6397,"2021-04-13",46,2362,0,133,46,2221,0,8,5,236,41,1064,5,1300,"California",3115,0.341573033707865,730,0.378,1142,0.592
"6398","sierra",6398,"2021-04-14",2,2364,1,134,1,2222,0,8,2,238,0,1064,2,1302,"California",3115,0.341573033707865,730,0.378,1142,0.592
"6399","sierra",6399,"2021-04-15",49,2413,1,135,48,2270,0,8,2,193,47,1111,2,1304,"California",3115,0.356661316211878,730,0.378,1142,0.592
"6400","sierra",6400,"2021-04-16",1,2414,0,135,1,2271,0,8,1,194,0,1111,1,1305,"California",3115,0.356661316211878,730,0.378,1142,0.592
"6401","sierra",6401,"2021-04-17",2,2416,1,136,1,2272,0,8,1,194,1,1112,1,1306,"California",3115,0.356982343499197,730,0.378,1142,0.592
"6402","sierra",6402,"2021-04-19",1,2417,1,137,0,2272,0,8,0,193,1,1113,0,1306,"California",3115,0.357303370786517,730,0.378,1142,0.592
"6403","sierra",6403,"2021-04-20",34,2451,1,138,33,2305,0,8,7,173,27,1140,7,1313,"California",3115,0.365971107544141,730,0.378,1142,0.592
"6404","sierra",6404,"2021-04-21",2,2453,1,139,1,2306,0,8,1,173,1,1141,1,1314,"California",3115,0.366292134831461,730,0.378,1142,0.592
"6405","sierra",6405,"2021-04-22",65,2518,2,141,63,2369,0,8,5,119,59,1200,5,1319,"California",3115,0.385232744783307,730,0.378,1142,0.592
"6406","sierra",6406,"2021-04-23",13,2531,0,141,13,2382,0,8,5,116,8,1208,5,1324,"California",3115,0.387800963081862,730,0.378,1142,0.592
"6407","sierra",6407,"2021-04-24",4,2535,0,141,4,2386,0,8,4,120,0,1208,4,1328,"California",3115,0.387800963081862,730,0.378,1142,0.592
"6408","sierra",6408,"2021-04-27",28,2563,1,142,27,2413,0,8,5,102,23,1231,5,1333,"California",3115,0.395184590690209,730,0.378,1142,0.592
"6409","sierra",6409,"2021-04-28",10,2573,2,144,8,2421,0,8,1,94,9,1240,1,1334,"California",3115,0.398073836276083,730,0.378,1142,0.592
"6410","sierra",6410,"2021-04-29",20,2593,2,146,18,2439,0,8,14,102,6,1246,14,1348,"California",3115,0.4,730,0.378,1142,0.592
"6411","sierra",6411,"2021-04-30",4,2597,2,148,2,2441,0,8,2,102,2,1248,2,1350,"California",3115,0.400642054574639,730,0.378,1142,0.592
"6412","sierra",6412,"2021-05-03",2,2599,2,150,0,2441,0,8,1,102,1,1249,1,1351,"California",3115,0.400963081861958,730,0.378,1142,0.592
"6413","sierra",6413,"2021-05-04",1,2600,0,150,0,2441,1,9,0,102,1,1250,1,1352,"California",3115,0.401284109149278,730,0.378,1142,0.592
"6414","sierra",6414,"2021-05-05",25,2625,1,151,24,2465,0,9,8,94,16,1266,8,1360,"California",3115,0.406420545746388,730,0.378,1142,0.592
"6415","sierra",6415,"2021-05-06",1,2626,1,152,0,2465,0,9,0,93,1,1267,0,1360,"California",3115,0.406741573033708,730,0.378,1142,0.592
"6416","sierra",6416,"2021-05-07",1,2627,1,153,0,2465,0,9,1,94,0,1267,1,1361,"California",3115,0.406741573033708,730,0.378,1142,0.592
"6417","sierra",6417,"2021-05-08",2,2629,0,153,1,2466,1,10,1,95,1,1268,2,1363,"California",3115,0.407062600321027,730,0.378,1142,0.592
"6418","siskiyou",6418,"2020-12-16",2,2,2,2,0,0,0,0,2,2,0,0,2,2,"California",43956,0,9593,0.409,13290,0.567
"6419","siskiyou",6419,"2020-12-17",4,6,4,6,0,0,0,0,4,6,0,0,4,6,"California",43956,0,9593,0.409,13290,0.567
"6420","siskiyou",6420,"2020-12-18",2,8,2,8,0,0,0,0,2,8,0,0,2,8,"California",43956,0,9593,0.409,13290,0.567
"6421","siskiyou",6421,"2020-12-19",4,12,4,12,0,0,0,0,4,12,0,0,4,12,"California",43956,0,9593,0.409,13290,0.567
"6422","siskiyou",6422,"2020-12-20",1,13,1,13,0,0,0,0,1,13,0,0,1,13,"California",43956,0,9593,0.409,13290,0.567
"6423","siskiyou",6423,"2020-12-21",132,145,132,145,0,0,0,0,132,145,0,0,132,145,"California",43956,0,9593,0.409,13290,0.567
"6424","siskiyou",6424,"2020-12-22",159,304,159,304,0,0,0,0,159,304,0,0,159,304,"California",43956,0,9593,0.409,13290,0.567
"6425","siskiyou",6425,"2020-12-23",142,446,142,446,0,0,0,0,142,446,0,0,142,446,"California",43956,0,9593,0.409,13290,0.567
"6426","siskiyou",6426,"2020-12-24",5,451,5,451,0,0,0,0,5,451,0,0,5,451,"California",43956,0,9593,0.409,13290,0.567
"6427","siskiyou",6427,"2020-12-26",2,453,0,451,2,2,0,0,2,453,0,0,2,453,"California",43956,0,9593,0.409,13290,0.567
"6428","siskiyou",6428,"2020-12-27",2,455,0,451,2,4,0,0,2,455,0,0,2,455,"California",43956,0,9593,0.409,13290,0.567
"6429","siskiyou",6429,"2020-12-28",3,458,1,452,2,6,0,0,3,458,0,0,3,458,"California",43956,0,9593,0.409,13290,0.567
"6430","siskiyou",6430,"2020-12-29",6,464,2,454,4,10,0,0,6,464,0,0,6,464,"California",43956,0,9593,0.409,13290,0.567
"6431","siskiyou",6431,"2020-12-30",98,562,3,457,95,105,0,0,98,562,0,0,98,562,"California",43956,0,9593,0.409,13290,0.567
"6432","siskiyou",6432,"2020-12-31",12,574,0,457,12,117,0,0,12,574,0,0,12,574,"California",43956,0,9593,0.409,13290,0.567
"6433","siskiyou",6433,"2021-01-02",1,575,1,458,0,117,0,0,1,575,0,0,1,575,"California",43956,0,9593,0.409,13290,0.567
"6434","siskiyou",6434,"2021-01-03",1,576,0,458,1,118,0,0,1,576,0,0,1,576,"California",43956,0,9593,0.409,13290,0.567
"6435","siskiyou",6435,"2021-01-04",130,706,3,461,127,245,0,0,130,706,0,0,130,706,"California",43956,0,9593,0.409,13290,0.567
"6436","siskiyou",6436,"2021-01-05",117,823,4,465,113,358,0,0,116,821,1,1,116,822,"California",43956,2.27500227500227e-05,9593,0.409,13290,0.567
"6437","siskiyou",6437,"2021-01-06",59,882,6,471,53,411,0,0,55,872,4,5,55,877,"California",43956,0.000113750113750114,9593,0.409,13290,0.567
"6438","siskiyou",6438,"2021-01-07",178,1060,4,475,174,585,0,0,177,1048,1,6,177,1054,"California",43956,0.000136500136500137,9593,0.409,13290,0.567
"6439","siskiyou",6439,"2021-01-08",41,1101,3,478,38,623,0,0,39,1085,2,8,39,1093,"California",43956,0.000182000182000182,9593,0.409,13290,0.567
"6440","siskiyou",6440,"2021-01-09",2,1103,2,480,0,623,0,0,0,1083,2,10,0,1093,"California",43956,0.000227500227500228,9593,0.409,13290,0.567
"6441","siskiyou",6441,"2021-01-11",226,1329,65,545,161,784,0,0,163,1183,63,73,163,1256,"California",43956,0.00166075166075166,9593,0.409,13290,0.567
"6442","siskiyou",6442,"2021-01-12",322,1651,274,819,48,832,0,0,88,1038,234,307,89,1345,"California",43956,0.00698425698425698,9593,0.409,13290,0.567
"6443","siskiyou",6443,"2021-01-13",157,1808,137,956,20,852,0,0,23,927,134,441,23,1368,"California",43956,0.01003276003276,9593,0.409,13290,0.567
"6444","siskiyou",6444,"2021-01-14",26,1834,1,957,25,877,0,0,25,951,1,442,25,1393,"California",43956,0.0100555100555101,9593,0.409,13290,0.567
"6445","siskiyou",6445,"2021-01-15",35,1869,3,960,32,909,0,0,35,986,0,442,35,1428,"California",43956,0.0100555100555101,9593,0.409,13290,0.567
"6446","siskiyou",6446,"2021-01-16",7,1876,2,962,5,914,0,0,7,993,0,442,7,1435,"California",43956,0.0100555100555101,9593,0.409,13290,0.567
"6447","siskiyou",6447,"2021-01-17",1,1877,1,963,0,914,0,0,0,992,1,443,0,1435,"California",43956,0.0100782600782601,9593,0.409,13290,0.567
"6448","siskiyou",6448,"2021-01-18",77,1954,4,967,73,987,0,0,75,1065,2,445,75,1510,"California",43956,0.0101237601237601,9593,0.409,13290,0.567
"6449","siskiyou",6449,"2021-01-19",21,1975,1,968,20,1007,0,0,20,1084,1,446,20,1530,"California",43956,0.0101465101465101,9593,0.409,13290,0.567
"6450","siskiyou",6450,"2021-01-20",48,2023,35,1003,13,1020,0,0,43,1123,4,450,43,1573,"California",43956,0.0102375102375102,9593,0.409,13290,0.567
"6451","siskiyou",6451,"2021-01-21",42,2065,1,1004,41,1061,0,0,42,1165,0,450,42,1615,"California",43956,0.0102375102375102,9593,0.409,13290,0.567
"6452","siskiyou",6452,"2021-01-22",1328,3393,1176,2180,152,1213,0,0,1328,2493,0,450,1328,2943,"California",43956,0.0102375102375102,9593,0.409,13290,0.567
"6453","siskiyou",6453,"2021-01-23",5,3398,1,2181,4,1217,0,0,2,2492,3,453,2,2945,"California",43956,0.0103057603057603,9593,0.409,13290,0.567
"6454","siskiyou",6454,"2021-01-25",182,3580,8,2189,174,1391,0,0,178,2666,4,457,178,3123,"California",43956,0.0103967603967604,9593,0.409,13290,0.567
"6455","siskiyou",6455,"2021-01-26",148,3728,3,2192,145,1536,0,0,140,2798,8,465,140,3263,"California",43956,0.0105787605787606,9593,0.409,13290,0.567
"6456","siskiyou",6456,"2021-01-27",181,3909,1,2193,180,1716,0,0,126,2869,55,520,126,3389,"California",43956,0.0118300118300118,9593,0.409,13290,0.567
"6457","siskiyou",6457,"2021-01-28",232,4141,118,2311,114,1830,0,0,226,3089,6,526,226,3615,"California",43956,0.011966511966512,9593,0.409,13290,0.567
"6458","siskiyou",6458,"2021-01-29",249,4390,3,2314,246,2076,0,0,247,3334,2,528,247,3862,"California",43956,0.012012012012012,9593,0.409,13290,0.567
"6459","siskiyou",6459,"2021-01-30",3,4393,2,2316,1,2077,0,0,3,3337,0,528,3,3865,"California",43956,0.012012012012012,9593,0.409,13290,0.567
"6460","siskiyou",6460,"2021-02-01",195,4588,3,2319,192,2269,0,0,105,3352,90,618,105,3970,"California",43956,0.0140595140595141,9593,0.409,13290,0.567
"6461","siskiyou",6461,"2021-02-02",289,4877,45,2364,244,2513,0,0,147,3357,142,760,147,4117,"California",43956,0.0172900172900173,9593,0.409,13290,0.567
"6462","siskiyou",6462,"2021-02-03",314,5191,1,2365,313,2826,0,0,264,3571,50,810,264,4381,"California",43956,0.0184275184275184,9593,0.409,13290,0.567
"6463","siskiyou",6463,"2021-02-04",322,5513,7,2372,315,3141,0,0,200,3649,122,932,200,4581,"California",43956,0.0212030212030212,9593,0.409,13290,0.567
"6464","siskiyou",6464,"2021-02-05",513,6026,4,2376,509,3650,0,0,348,3832,165,1097,348,4929,"California",43956,0.024956774956775,9593,0.409,13290,0.567
"6465","siskiyou",6465,"2021-02-06",15,6041,0,2376,15,3665,0,0,15,3847,0,1097,15,4944,"California",43956,0.024956774956775,9593,0.409,13290,0.567
"6466","siskiyou",6466,"2021-02-07",3,6044,2,2378,1,3666,0,0,3,3850,0,1097,3,4947,"California",43956,0.024956774956775,9593,0.409,13290,0.567
"6467","siskiyou",6467,"2021-02-08",221,6265,5,2383,216,3882,0,0,216,4061,5,1102,216,5163,"California",43956,0.0250705250705251,9593,0.409,13290,0.567
"6468","siskiyou",6468,"2021-02-09",196,6461,4,2387,192,4074,0,0,163,4191,33,1135,163,5326,"California",43956,0.0258212758212758,9593,0.409,13290,0.567
"6469","siskiyou",6469,"2021-02-10",370,6831,40,2427,330,4404,0,0,317,4456,52,1187,317,5643,"California",43956,0.027004277004277,9593,0.409,13290,0.567
"6470","siskiyou",6470,"2021-02-11",190,7021,1,2428,189,4593,0,0,174,4614,16,1203,174,5817,"California",43956,0.0273682773682774,9593,0.409,13290,0.567
"6471","siskiyou",6471,"2021-02-12",1691,8712,1199,3627,492,5085,0,0,501,3925,1190,2393,501,6318,"California",43956,0.0544408044408044,9593,0.409,13290,0.567
"6472","siskiyou",6472,"2021-02-13",36,8748,2,3629,34,5119,0,0,32,3953,4,2397,32,6350,"California",43956,0.0545318045318045,9593,0.409,13290,0.567
"6473","siskiyou",6473,"2021-02-14",5,8753,1,3630,4,5123,0,0,5,3958,0,2397,5,6355,"California",43956,0.0545318045318045,9593,0.409,13290,0.567
"6474","siskiyou",6474,"2021-02-15",107,8860,10,3640,97,5220,0,0,105,4061,2,2399,105,6460,"California",43956,0.0545773045773046,9593,0.409,13290,0.567
"6475","siskiyou",6475,"2021-02-16",114,8974,2,3642,112,5332,0,0,99,4145,15,2414,99,6559,"California",43956,0.0549185549185549,9593,0.409,13290,0.567
"6476","siskiyou",6476,"2021-02-17",185,9159,15,3657,170,5502,0,0,171,4302,14,2428,171,6730,"California",43956,0.0552370552370552,9593,0.409,13290,0.567
"6477","siskiyou",6477,"2021-02-18",222,9381,89,3746,133,5635,0,0,98,4276,124,2552,98,6828,"California",43956,0.0580580580580581,9593,0.409,13290,0.567
"6478","siskiyou",6478,"2021-02-19",71,9452,34,3780,37,5672,0,0,34,4273,37,2589,34,6862,"California",43956,0.0588998088998089,9593,0.409,13290,0.567
"6479","siskiyou",6479,"2021-02-20",21,9473,3,3783,18,5690,0,0,17,4286,4,2593,17,6879,"California",43956,0.058990808990809,9593,0.409,13290,0.567
"6480","siskiyou",6480,"2021-02-21",1,9474,1,3784,0,5690,0,0,1,4287,0,2593,1,6880,"California",43956,0.058990808990809,9593,0.409,13290,0.567
"6481","siskiyou",6481,"2021-02-22",124,9598,1,3785,123,5813,0,0,18,4199,106,2699,18,6898,"California",43956,0.0614023114023114,9593,0.409,13290,0.567
"6482","siskiyou",6482,"2021-02-23",197,9795,15,3800,182,5995,0,0,53,4108,144,2843,53,6951,"California",43956,0.0646783146783147,9593,0.409,13290,0.567
"6483","siskiyou",6483,"2021-02-24",147,9942,4,3804,143,6138,0,0,35,4031,112,2955,35,6986,"California",43956,0.0672263172263172,9593,0.409,13290,0.567
"6484","siskiyou",6484,"2021-02-25",300,10242,24,3828,276,6414,0,0,154,4039,146,3101,154,7140,"California",43956,0.0705478205478206,9593,0.409,13290,0.567
"6485","siskiyou",6485,"2021-02-26",669,10911,10,3838,659,7073,0,0,367,4104,302,3403,367,7507,"California",43956,0.0774183274183274,9593,0.409,13290,0.567
"6486","siskiyou",6486,"2021-02-27",33,10944,5,3843,28,7101,0,0,28,4127,5,3408,28,7535,"California",43956,0.0775320775320775,9593,0.409,13290,0.567
"6487","siskiyou",6487,"2021-02-28",5,10949,4,3847,1,7102,0,0,4,4130,1,3409,4,7539,"California",43956,0.0775548275548276,9593,0.409,13290,0.567
"6488","siskiyou",6488,"2021-03-01",280,11229,6,3853,274,7376,0,0,50,3950,230,3639,50,7589,"California",43956,0.0827873327873328,9593,0.409,13290,0.567
"6489","siskiyou",6489,"2021-03-02",190,11419,1,3854,189,7565,0,0,70,3900,120,3759,70,7659,"California",43956,0.0855173355173355,9593,0.409,13290,0.567
"6490","siskiyou",6490,"2021-03-03",343,11762,7,3861,336,7901,0,0,153,3863,190,3949,153,7812,"California",43956,0.0898398398398398,9593,0.409,13290,0.567
"6491","siskiyou",6491,"2021-03-04",794,12556,621,4482,173,8074,0,0,637,4343,157,4106,637,8449,"California",43956,0.0934115934115934,9593,0.409,13290,0.567
"6492","siskiyou",6492,"2021-03-05",326,12882,6,4488,309,8383,11,11,105,4241,218,4324,116,8565,"California",43956,0.0983710983710984,9593,0.409,13290,0.567
"6493","siskiyou",6493,"2021-03-06",43,12925,3,4491,33,8416,7,18,28,4261,15,4339,35,8600,"California",43956,0.0987123487123487,9593,0.409,13290,0.567
"6494","siskiyou",6494,"2021-03-07",12,12937,4,4495,0,8416,8,26,3,4263,9,4348,11,8611,"California",43956,0.0989170989170989,9593,0.409,13290,0.567
"6495","siskiyou",6495,"2021-03-08",361,13298,31,4526,295,8711,35,61,59,4055,302,4650,94,8705,"California",43956,0.105787605787606,9593,0.409,13290,0.567
"6496","siskiyou",6496,"2021-03-09",163,13461,2,4528,108,8819,53,114,57,4059,106,4756,110,8815,"California",43956,0.108199108199108,9593,0.409,13290,0.567
"6497","siskiyou",6497,"2021-03-10",221,13682,7,4535,184,9003,30,144,31,3930,190,4946,61,8876,"California",43956,0.112521612521613,9593,0.409,13290,0.567
"6498","siskiyou",6498,"2021-03-11",474,14156,206,4741,221,9224,47,191,274,4052,199,5145,321,9197,"California",43956,0.117048867048867,9593,0.409,13290,0.567
"6499","siskiyou",6499,"2021-03-12",647,14803,141,4882,467,9691,39,230,184,3814,461,5606,223,9420,"California",43956,0.127536627536628,9593,0.409,13290,0.567
"6500","siskiyou",6500,"2021-03-13",428,15231,381,5263,24,9715,23,253,382,4173,46,5652,405,9825,"California",43956,0.128583128583129,9593,0.409,13290,0.567
"6501","siskiyou",6501,"2021-03-14",20,15251,1,5264,3,9718,16,269,2,4173,18,5670,18,9843,"California",43956,0.128992628992629,9593,0.409,13290,0.567
"6502","siskiyou",6502,"2021-03-15",453,15704,257,5521,176,9894,20,289,321,4382,132,5802,341,10184,"California",43956,0.131995631995632,9593,0.409,13290,0.567
"6503","siskiyou",6503,"2021-03-16",255,15959,32,5553,206,10100,17,306,140,4425,114,5916,157,10341,"California",43956,0.134589134589135,9593,0.409,13290,0.567
"6504","siskiyou",6504,"2021-03-17",202,16161,9,5562,185,10285,8,314,34,4299,168,6084,42,10383,"California",43956,0.138411138411138,9593,0.409,13290,0.567
"6505","siskiyou",6505,"2021-03-18",926,17087,788,6350,126,10411,12,326,810,5005,116,6200,822,11205,"California",43956,0.141050141050141,9593,0.409,13290,0.567
"6506","siskiyou",6506,"2021-03-19",67,17154,9,6359,45,10456,13,339,20,4991,47,6247,33,11238,"California",43956,0.142119392119392,9593,0.409,13290,0.567
"6507","siskiyou",6507,"2021-03-20",30,17184,7,6366,18,10474,5,344,6,4978,24,6271,11,11249,"California",43956,0.142665392665393,9593,0.409,13290,0.567
"6508","siskiyou",6508,"2021-03-21",10,17194,4,6370,1,10475,5,349,4,4981,6,6277,9,11258,"California",43956,0.142801892801893,9593,0.409,13290,0.567
"6509","siskiyou",6509,"2021-03-22",207,17401,21,6391,164,10639,22,371,144,5087,60,6337,166,11424,"California",43956,0.144166894166894,9593,0.409,13290,0.567
"6510","siskiyou",6510,"2021-03-23",195,17596,19,6410,166,10805,10,381,141,5184,54,6391,151,11575,"California",43956,0.145395395395395,9593,0.409,13290,0.567
"6511","siskiyou",6511,"2021-03-24",140,17736,47,6457,93,10898,0,381,115,5274,25,6416,115,11690,"California",43956,0.145964145964146,9593,0.409,13290,0.567
"6512","siskiyou",6512,"2021-03-25",572,18308,320,6777,249,11147,3,384,400,5505,172,6588,403,12093,"California",43956,0.14987714987715,9593,0.409,13290,0.567
"6513","siskiyou",6513,"2021-03-26",304,18612,35,6812,269,11416,0,384,104,5411,198,6786,104,12197,"California",43956,0.154381654381654,9593,0.409,13290,0.567
"6514","siskiyou",6514,"2021-03-27",37,18649,4,6816,28,11444,5,389,9,5397,28,6814,14,12211,"California",43956,0.155018655018655,9593,0.409,13290,0.567
"6515","siskiyou",6515,"2021-03-28",8,18657,7,6823,1,11445,0,389,5,5399,3,6817,5,12216,"California",43956,0.155086905086905,9593,0.409,13290,0.567
"6516","siskiyou",6516,"2021-03-29",98,18755,11,6834,85,11530,2,391,47,5398,50,6867,49,12265,"California",43956,0.156224406224406,9593,0.409,13290,0.567
"6517","siskiyou",6517,"2021-03-30",102,18857,7,6841,94,11624,1,392,41,5379,61,6928,42,12307,"California",43956,0.157612157612158,9593,0.409,13290,0.567
"6518","siskiyou",6518,"2021-03-31",190,19047,21,6862,166,11790,3,395,50,5294,139,7067,54,12361,"California",43956,0.160774410774411,9593,0.409,13290,0.567
"6519","siskiyou",6519,"2021-04-01",824,19871,667,7529,157,11947,0,395,208,4886,616,7683,208,12569,"California",43956,0.174788424788425,9593,0.409,13290,0.567
"6520","siskiyou",6520,"2021-04-02",346,20217,197,7726,145,12092,4,399,65,4676,279,7962,69,12638,"California",43956,0.181135681135681,9593,0.409,13290,0.567
"6521","siskiyou",6521,"2021-04-03",26,20243,5,7731,14,12106,7,406,5,4667,21,7983,12,12650,"California",43956,0.181613431613432,9593,0.409,13290,0.567
"6522","siskiyou",6522,"2021-04-04",2,20245,2,7733,0,12106,0,406,1,4667,1,7984,1,12651,"California",43956,0.181636181636182,9593,0.409,13290,0.567
"6523","siskiyou",6523,"2021-04-05",437,20682,330,8063,80,12186,27,433,26,4309,410,8394,52,12703,"California",43956,0.190963690963691,9593,0.409,13290,0.567
"6524","siskiyou",6524,"2021-04-06",220,20902,36,8099,131,12317,53,486,126,4394,93,8487,178,12881,"California",43956,0.193079443079443,9593,0.409,13290,0.567
"6525","siskiyou",6525,"2021-04-07",116,21018,11,8110,63,12380,42,528,66,4452,50,8537,108,12989,"California",43956,0.194216944216944,9593,0.409,13290,0.567
"6526","siskiyou",6526,"2021-04-08",347,21365,183,8293,123,12503,41,569,60,4266,287,8824,101,13090,"California",43956,0.200746200746201,9593,0.409,13290,0.567
"6527","siskiyou",6527,"2021-04-09",548,21913,381,8674,130,12633,37,606,84,3926,462,9286,122,13212,"California",43956,0.211256711256711,9593,0.409,13290,0.567
"6528","siskiyou",6528,"2021-04-10",46,21959,6,8680,3,12636,37,643,7,3931,39,9325,44,13256,"California",43956,0.212143962143962,9593,0.409,13290,0.567
"6529","siskiyou",6529,"2021-04-11",8,21967,5,8685,1,12637,2,645,2,3929,6,9331,4,13260,"California",43956,0.212280462280462,9593,0.409,13290,0.567
"6530","siskiyou",6530,"2021-04-12",129,22096,25,8710,103,12740,1,646,49,3899,80,9411,50,13310,"California",43956,0.214100464100464,9593,0.409,13290,0.567
"6531","siskiyou",6531,"2021-04-13",204,22300,36,8746,167,12907,1,647,78,3852,126,9537,79,13389,"California",43956,0.216966966966967,9593,0.409,13290,0.567
"6532","siskiyou",6532,"2021-04-14",157,22457,65,8811,92,12999,0,647,86,3869,69,9606,86,13475,"California",43956,0.218536718536719,9593,0.409,13290,0.567
"6533","siskiyou",6533,"2021-04-15",1116,23573,956,9767,160,13159,0,647,436,3625,680,10286,436,13911,"California",43956,0.234006734006734,9593,0.409,13290,0.567
"6534","siskiyou",6534,"2021-04-16",297,23870,206,9973,91,13250,0,647,266,3861,30,10316,266,14177,"California",43956,0.234689234689235,9593,0.409,13290,0.567
"6535","siskiyou",6535,"2021-04-17",12,23882,9,9982,3,13253,0,647,8,3865,4,10320,8,14185,"California",43956,0.234780234780235,9593,0.409,13290,0.567
"6536","siskiyou",6536,"2021-04-18",5,23887,3,9985,2,13255,0,647,2,3864,3,10323,2,14187,"California",43956,0.234848484848485,9593,0.409,13290,0.567
"6537","siskiyou",6537,"2021-04-19",126,24013,22,10007,104,13359,0,647,43,3824,83,10406,43,14230,"California",43956,0.236736736736737,9593,0.409,13290,0.567
"6538","siskiyou",6538,"2021-04-20",236,24249,4,10011,232,13591,0,647,93,3774,143,10549,93,14323,"California",43956,0.23998998998999,9593,0.409,13290,0.567
"6539","siskiyou",6539,"2021-04-21",96,24345,12,10023,84,13675,0,647,26,3730,70,10619,26,14349,"California",43956,0.241582491582492,9593,0.409,13290,0.567
"6540","siskiyou",6540,"2021-04-22",415,24760,302,10325,113,13788,0,647,50,3415,365,10984,50,14399,"California",43956,0.24988624988625,9593,0.409,13290,0.567
"6541","siskiyou",6541,"2021-04-23",171,24931,13,10338,158,13946,0,647,149,3543,21,11005,149,14548,"California",43956,0.250364000364,9593,0.409,13290,0.567
"6542","siskiyou",6542,"2021-04-24",27,24958,4,10342,23,13969,0,647,19,3554,8,11013,19,14567,"California",43956,0.250546000546001,9593,0.409,13290,0.567
"6543","siskiyou",6543,"2021-04-25",3,24961,0,10342,3,13972,0,647,2,3555,1,11014,2,14569,"California",43956,0.250568750568751,9593,0.409,13290,0.567
"6544","siskiyou",6544,"2021-04-26",101,25062,7,10349,89,14061,5,652,25,3509,76,11090,30,14599,"California",43956,0.252297752297752,9593,0.409,13290,0.567
"6545","siskiyou",6545,"2021-04-27",102,25164,3,10352,97,14158,2,654,83,3578,16,11106,85,14684,"California",43956,0.252661752661753,9593,0.409,13290,0.567
"6546","siskiyou",6546,"2021-04-28",111,25275,9,10361,94,14252,8,662,53,3581,58,11164,61,14745,"California",43956,0.253981253981254,9593,0.409,13290,0.567
"6547","siskiyou",6547,"2021-04-29",105,25380,14,10375,91,14343,0,662,25,3526,80,11244,25,14770,"California",43956,0.255801255801256,9593,0.409,13290,0.567
"6548","siskiyou",6548,"2021-04-30",101,25481,20,10395,80,14423,1,663,44,3516,54,11298,44,14814,"California",43956,0.257029757029757,9593,0.409,13290,0.567
"6549","siskiyou",6549,"2021-05-01",11,25492,7,10402,1,14424,3,666,7,3522,4,11302,10,14824,"California",43956,0.257120757120757,9593,0.409,13290,0.567
"6550","siskiyou",6550,"2021-05-02",11,25503,5,10407,6,14430,0,666,9,3529,2,11304,9,14833,"California",43956,0.257166257166257,9593,0.409,13290,0.567
"6551","siskiyou",6551,"2021-05-03",112,25615,24,10431,85,14515,3,669,47,3514,65,11369,50,14883,"California",43956,0.258645008645009,9593,0.409,13290,0.567
"6552","siskiyou",6552,"2021-05-04",112,25727,6,10437,103,14618,3,672,58,3522,53,11422,61,14944,"California",43956,0.25985075985076,9593,0.409,13290,0.567
"6553","siskiyou",6553,"2021-05-05",116,25843,24,10461,83,14701,9,681,38,3492,77,11499,47,14991,"California",43956,0.261602511602512,9593,0.409,13290,0.567
"6554","siskiyou",6554,"2021-05-06",346,26189,274,10735,67,14768,5,686,179,3509,167,11666,184,15175,"California",43956,0.265401765401765,9593,0.409,13290,0.567
"6555","siskiyou",6555,"2021-05-07",309,26498,221,10956,84,14852,4,690,33,3271,275,11941,37,15212,"California",43956,0.271658021658022,9593,0.409,13290,0.567
"6556","siskiyou",6556,"2021-05-08",23,26521,6,10962,16,14868,1,691,17,3283,6,11947,18,15230,"California",43956,0.271794521794522,9593,0.409,13290,0.567
"6557","solano",6557,"2020-12-15",4,4,4,4,0,0,0,0,4,4,0,0,4,4,"California",444255,0,131639,0.64,69306,0.337
"6558","solano",6558,"2020-12-16",71,75,71,75,0,0,0,0,71,75,0,0,71,75,"California",444255,0,131639,0.64,69306,0.337
"6559","solano",6559,"2020-12-17",153,228,153,228,0,0,0,0,153,228,0,0,153,228,"California",444255,0,131639,0.64,69306,0.337
"6560","solano",6560,"2020-12-18",445,673,444,672,1,1,0,0,445,673,0,0,445,673,"California",444255,0,131639,0.64,69306,0.337
"6561","solano",6561,"2020-12-19",518,1191,518,1190,0,1,0,0,518,1191,0,0,518,1191,"California",444255,0,131639,0.64,69306,0.337
"6562","solano",6562,"2020-12-20",355,1546,353,1543,2,3,0,0,355,1546,0,0,355,1546,"California",444255,0,131639,0.64,69306,0.337
"6563","solano",6563,"2020-12-21",572,2118,570,2113,2,5,0,0,572,2118,0,0,572,2118,"California",444255,0,131639,0.64,69306,0.337
"6564","solano",6564,"2020-12-22",663,2781,630,2743,33,38,0,0,663,2781,0,0,663,2781,"California",444255,0,131639,0.64,69306,0.337
"6565","solano",6565,"2020-12-23",859,3640,772,3515,87,125,0,0,858,3639,0,0,858,3639,"California",444255,0,131639,0.64,69306,0.337
"6566","solano",6566,"2020-12-24",422,4062,171,3686,251,376,0,0,422,4061,0,0,422,4061,"California",444255,0,131639,0.64,69306,0.337
"6567","solano",6567,"2020-12-25",10,4072,2,3688,8,384,0,0,10,4071,0,0,10,4071,"California",444255,0,131639,0.64,69306,0.337
"6568","solano",6568,"2020-12-26",175,4247,48,3736,127,511,0,0,175,4246,0,0,175,4246,"California",444255,0,131639,0.64,69306,0.337
"6569","solano",6569,"2020-12-27",104,4351,29,3765,75,586,0,0,104,4350,0,0,104,4350,"California",444255,0,131639,0.64,69306,0.337
"6570","solano",6570,"2020-12-28",863,5214,421,4186,442,1028,0,0,863,5213,0,0,863,5213,"California",444255,0,131639,0.64,69306,0.337
"6571","solano",6571,"2020-12-29",896,6110,376,4562,520,1548,0,0,896,6109,0,0,896,6109,"California",444255,0,131639,0.64,69306,0.337
"6572","solano",6572,"2020-12-30",1236,7346,601,5163,635,2183,0,0,1236,7345,0,0,1236,7345,"California",444255,0,131639,0.64,69306,0.337
"6573","solano",6573,"2020-12-31",538,7884,137,5300,401,2584,0,0,538,7883,0,0,538,7883,"California",444255,0,131639,0.64,69306,0.337
"6574","solano",6574,"2021-01-01",14,7898,13,5313,1,2585,0,0,14,7897,0,0,14,7897,"California",444255,0,131639,0.64,69306,0.337
"6575","solano",6575,"2021-01-02",213,8111,165,5478,48,2633,0,0,213,8110,0,0,213,8110,"California",444255,0,131639,0.64,69306,0.337
"6576","solano",6576,"2021-01-03",57,8168,40,5518,17,2650,0,0,52,8162,0,0,52,8162,"California",444255,0,131639,0.64,69306,0.337
"6577","solano",6577,"2021-01-04",451,8619,246,5764,205,2855,0,0,441,8600,3,3,441,8603,"California",444255,6.75287841442415e-06,131639,0.64,69306,0.337
"6578","solano",6578,"2021-01-05",729,9348,377,6141,352,3207,0,0,575,9026,149,152,575,9178,"California",444255,0.000342145839664157,131639,0.64,69306,0.337
"6579","solano",6579,"2021-01-06",844,10192,436,6577,408,3615,0,0,582,9348,260,412,582,9760,"California",444255,0.000927395302247583,131639,0.64,69306,0.337
"6580","solano",6580,"2021-01-07",1067,11259,683,7260,384,3999,0,0,610,9504,455,867,611,10371,"California",444255,0.00195158186176858,131639,0.64,69306,0.337
"6581","solano",6581,"2021-01-08",1138,12397,777,8037,361,4360,0,0,545,9476,575,1442,547,10918,"California",444255,0.00324588355786654,131639,0.64,69306,0.337
"6582","solano",6582,"2021-01-09",885,13282,763,8800,122,4482,0,0,428,9450,454,1896,428,11346,"California",444255,0.00426781915791606,131639,0.64,69306,0.337
"6583","solano",6583,"2021-01-10",254,13536,194,8994,60,4542,0,0,153,9502,101,1997,153,11499,"California",444255,0.00449516606453501,131639,0.64,69306,0.337
"6584","solano",6584,"2021-01-11",1329,14865,1118,10112,211,4753,0,0,813,9799,516,2513,813,12312,"California",444255,0.00565666115181596,131639,0.64,69306,0.337
"6585","solano",6585,"2021-01-12",1566,16431,1168,11280,398,5151,0,0,1015,10265,550,3063,1016,13328,"California",444255,0.00689468886112706,131639,0.64,69306,0.337
"6586","solano",6586,"2021-01-13",1465,17896,1005,12285,460,5611,0,0,1206,11214,257,3320,1206,14534,"California",444255,0.00747318544529606,131639,0.64,69306,0.337
"6587","solano",6587,"2021-01-14",1887,19783,815,13100,1072,6683,0,0,1573,12473,314,3634,1573,16107,"California",444255,0.00817998671933912,131639,0.64,69306,0.337
"6588","solano",6588,"2021-01-15",1695,21478,1060,14160,635,7318,0,0,1397,13572,298,3932,1397,17504,"California",444255,0.00885077264183858,131639,0.64,69306,0.337
"6589","solano",6589,"2021-01-16",1290,22768,903,15063,387,7705,0,0,1115,14512,175,4107,1115,18619,"California",444255,0.00924469054934666,131639,0.64,69306,0.337
"6590","solano",6590,"2021-01-17",1045,23813,761,15824,284,7989,0,0,1027,15521,18,4125,1027,19646,"California",444255,0.0092852078198332,131639,0.64,69306,0.337
"6591","solano",6591,"2021-01-18",1415,25228,857,16681,558,8547,0,0,1297,16702,118,4243,1299,20945,"California",444255,0.00955082103746722,131639,0.64,69306,0.337
"6592","solano",6592,"2021-01-19",1651,26879,1339,18020,312,8859,0,0,1378,17808,272,4515,1378,22323,"California",444255,0.0101630820137083,131639,0.64,69306,0.337
"6593","solano",6593,"2021-01-20",2033,28912,1423,19443,610,9469,0,0,1547,18872,483,4998,1547,23870,"California",444255,0.0112502954384306,131639,0.64,69306,0.337
"6594","solano",6594,"2021-01-21",3172,32084,1007,20450,2165,11634,0,0,2824,21349,348,5346,2825,26695,"California",444255,0.0120336293345038,131639,0.64,69306,0.337
"6595","solano",6595,"2021-01-22",1774,33858,845,21295,929,12563,0,0,1584,22743,190,5536,1584,28279,"California",444255,0.012461311634084,131639,0.64,69306,0.337
"6596","solano",6596,"2021-01-23",736,34594,242,21537,494,13057,0,0,531,23069,206,5742,532,28811,"California",444255,0.0129250092852078,131639,0.64,69306,0.337
"6597","solano",6597,"2021-01-24",404,34998,61,21598,343,13400,0,0,337,23339,67,5809,337,29148,"California",444255,0.0130758235697966,131639,0.64,69306,0.337
"6598","solano",6598,"2021-01-25",1661,36659,625,22223,1036,14436,0,0,1109,23898,551,6360,1110,30258,"California",444255,0.0143161022385792,131639,0.64,69306,0.337
"6599","solano",6599,"2021-01-26",1773,38432,737,22960,1036,15472,0,0,1142,24411,630,6990,1143,31401,"California",444255,0.0157342067056083,131639,0.64,69306,0.337
"6600","solano",6600,"2021-01-27",1796,40228,726,23686,1070,16542,0,0,1183,24994,600,7590,1183,32584,"California",444255,0.0170847823884931,131639,0.64,69306,0.337
"6601","solano",6601,"2021-01-28",1954,42182,705,24391,1249,17791,0,0,1363,25768,590,8180,1364,33948,"California",444255,0.0184128484766632,131639,0.64,69306,0.337
"6602","solano",6602,"2021-01-29",1700,43882,783,25174,917,18708,0,0,1345,26760,353,8533,1345,35293,"California",444255,0.0192074371700938,131639,0.64,69306,0.337
"6603","solano",6603,"2021-01-30",712,44594,220,25394,492,19200,0,0,551,27150,161,8694,551,35844,"California",444255,0.0195698416450012,131639,0.64,69306,0.337
"6604","solano",6604,"2021-01-31",485,45079,394,25788,91,19291,0,0,230,27126,255,8949,231,36075,"California",444255,0.0201438363102272,131639,0.64,69306,0.337
"6605","solano",6605,"2021-02-01",1509,46588,988,26776,521,19812,0,0,767,27154,739,9688,767,36842,"California",444255,0.021807295359647,131639,0.64,69306,0.337
"6606","solano",6606,"2021-02-02",3356,49944,1112,27888,2244,22056,0,0,2530,28862,822,10510,2530,39372,"California",444255,0.0236575840451993,131639,0.64,69306,0.337
"6607","solano",6607,"2021-02-03",2263,52207,1305,29193,958,23014,0,0,1164,28931,1095,11605,1164,40536,"California",444255,0.0261223846664641,131639,0.64,69306,0.337
"6608","solano",6608,"2021-02-04",1801,54008,911,30104,890,23904,0,0,1076,29287,720,12325,1076,41612,"California",444255,0.0277430754859259,131639,0.64,69306,0.337
"6609","solano",6609,"2021-02-05",3089,57097,1413,31517,1676,25580,0,0,2087,30380,994,13319,2087,43699,"California",444255,0.0299805292005717,131639,0.64,69306,0.337
"6610","solano",6610,"2021-02-06",3052,60149,1170,32687,1882,27462,0,0,2237,31806,811,14130,2237,45936,"California",444255,0.0318060573319377,131639,0.64,69306,0.337
"6611","solano",6611,"2021-02-07",848,60997,784,33471,64,27526,0,0,231,31420,617,14747,231,46167,"California",444255,0.0331948993258376,131639,0.64,69306,0.337
"6612","solano",6612,"2021-02-08",1750,62747,1234,34705,516,28042,0,0,709,31091,1038,15785,709,46876,"California",444255,0.0355313952572284,131639,0.64,69306,0.337
"6613","solano",6613,"2021-02-09",1947,64694,1485,36190,462,28504,0,0,699,30543,1247,17032,699,47575,"California",444255,0.0383383417181574,131639,0.64,69306,0.337
"6614","solano",6614,"2021-02-10",2266,66960,1498,37688,768,29272,0,0,820,29917,1446,18478,820,48395,"California",444255,0.0415932291139098,131639,0.64,69306,0.337
"6615","solano",6615,"2021-02-11",2503,69463,1489,39177,1014,30286,0,0,1198,29821,1295,19773,1199,49594,"California",444255,0.0445082216294696,131639,0.64,69306,0.337
"6616","solano",6616,"2021-02-12",4206,73669,1617,40794,2589,32875,0,0,2864,31350,1335,21108,2864,52458,"California",444255,0.0475132525238883,131639,0.64,69306,0.337
"6617","solano",6617,"2021-02-13",2863,76532,247,41041,2616,35491,0,0,2451,33392,409,21517,2451,54909,"California",444255,0.0484338949477215,131639,0.64,69306,0.337
"6618","solano",6618,"2021-02-14",704,77236,202,41243,502,35993,0,0,412,33515,290,21807,413,55322,"California",444255,0.0490866731944491,131639,0.64,69306,0.337
"6619","solano",6619,"2021-02-15",1314,78550,324,41567,990,36983,0,0,677,33556,636,22443,677,55999,"California",444255,0.0505182834183071,131639,0.64,69306,0.337
"6620","solano",6620,"2021-02-16",2568,81118,1396,42963,1172,38155,0,0,1677,34344,890,23333,1678,57677,"California",444255,0.0525216373479196,131639,0.64,69306,0.337
"6621","solano",6621,"2021-02-17",3108,84226,1452,44415,1656,39811,0,0,2070,35380,1035,24368,2071,59748,"California",444255,0.0548513804008959,131639,0.64,69306,0.337
"6622","solano",6622,"2021-02-18",2847,87073,845,45260,2002,41813,0,0,853,34246,1988,26356,854,60602,"California",444255,0.0593262878301876,131639,0.64,69306,0.337
"6623","solano",6623,"2021-02-19",2398,89471,1447,46707,951,42764,0,0,1174,34202,1220,27576,1176,61778,"California",444255,0.0620724583853868,131639,0.64,69306,0.337
"6624","solano",6624,"2021-02-20",2567,92038,382,47089,2185,44949,0,0,2095,35824,473,28049,2095,63873,"California",444255,0.0631371622153943,131639,0.64,69306,0.337
"6625","solano",6625,"2021-02-21",2175,94213,1861,48950,314,45263,0,0,1864,37381,307,28356,1864,65737,"California",444255,0.0638282067731371,131639,0.64,69306,0.337
"6626","solano",6626,"2021-02-22",1719,95932,1046,49996,673,45936,0,0,906,37477,811,29167,907,66644,"California",444255,0.065653734904503,131639,0.64,69306,0.337
"6627","solano",6627,"2021-02-23",2844,98776,1089,51085,1755,47691,0,0,1942,38520,899,30066,1942,68586,"California",444255,0.0676773474693588,131639,0.64,69306,0.337
"6628","solano",6628,"2021-02-24",2473,101249,1242,52327,1231,48922,0,0,1386,38821,1085,31151,1386,69972,"California",444255,0.0701196384959089,131639,0.64,69306,0.337
"6629","solano",6629,"2021-02-25",2398,103647,1442,53769,956,49878,0,0,1310,39048,1083,32234,1310,71282,"California",444255,0.072557427603516,131639,0.64,69306,0.337
"6630","solano",6630,"2021-02-26",3175,106822,2021,55790,1154,51032,0,0,1844,39574,1318,33552,1844,73126,"California",444255,0.0755241921869197,131639,0.64,69306,0.337
"6631","solano",6631,"2021-02-27",3651,110473,1374,57164,2276,53308,1,1,2956,41844,687,34239,2957,76083,"California",444255,0.0770706013438228,131639,0.64,69306,0.337
"6632","solano",6632,"2021-02-28",1370,111843,1039,58203,331,53639,0,1,1092,42662,275,34514,1093,77176,"California",444255,0.0776896151984783,131639,0.64,69306,0.337
"6633","solano",6633,"2021-03-01",2434,114277,1053,59256,1380,55019,1,2,1832,43897,598,35112,1833,79009,"California",444255,0.0790356889624202,131639,0.64,69306,0.337
"6634","solano",6634,"2021-03-02",2179,116456,1366,60622,813,55832,0,2,1270,44258,909,36021,1270,80279,"California",444255,0.0810818111219908,131639,0.64,69306,0.337
"6635","solano",6635,"2021-03-03",2212,118668,1254,61876,958,56790,0,2,1375,44805,829,36850,1376,81655,"California",444255,0.0829478565238433,131639,0.64,69306,0.337
"6636","solano",6636,"2021-03-04",4348,123016,3406,65282,940,57730,2,4,3132,46733,1209,38059,3137,84792,"California",444255,0.0856692665248562,131639,0.64,69306,0.337
"6637","solano",6637,"2021-03-05",4901,127917,1665,66947,3231,60961,5,9,3940,49727,951,39010,3945,88737,"California",444255,0.0878099289822287,131639,0.64,69306,0.337
"6638","solano",6638,"2021-03-06",3833,131750,825,67772,2969,63930,39,48,2638,51219,1185,40195,2677,91414,"California",444255,0.0904773159559262,131639,0.64,69306,0.337
"6639","solano",6639,"2021-03-07",3542,135292,737,68509,2795,66725,10,58,1950,51599,1581,41776,1961,93375,"California",444255,0.0940360828803277,131639,0.64,69306,0.337
"6640","solano",6640,"2021-03-08",2112,137404,1316,69825,525,67250,271,329,1596,52952,512,42288,1865,95240,"California",444255,0.0951885741297228,131639,0.64,69306,0.337
"6641","solano",6641,"2021-03-09",3138,140542,1511,71336,1573,68823,54,383,2246,54357,892,43180,2297,97537,"California",444255,0.0971964299782782,131639,0.64,69306,0.337
"6642","solano",6642,"2021-03-10",2394,142936,1739,73075,569,69392,86,469,1250,54551,1140,44320,1334,98871,"California",444255,0.0997625237757594,131639,0.64,69306,0.337
"6643","solano",6643,"2021-03-11",6005,148941,1748,74823,4003,73395,254,723,4955,58714,1046,45366,5209,104080,"California",444255,0.102117027382922,131639,0.64,69306,0.337
"6644","solano",6644,"2021-03-12",5981,154922,1563,76386,4242,77637,176,899,3159,59231,2818,48184,3335,107415,"California",444255,0.108460231173538,131639,0.64,69306,0.337
"6645","solano",6645,"2021-03-13",4575,159497,804,77190,3687,81324,84,983,2239,59227,2329,50513,2325,109740,"California",444255,0.113702715782602,131639,0.64,69306,0.337
"6646","solano",6646,"2021-03-14",3991,163488,3115,80305,423,81747,453,1436,1653,58997,2333,52846,2103,111843,"California",444255,0.118954204229553,131639,0.64,69306,0.337
"6647","solano",6647,"2021-03-15",4004,167492,2446,82751,1241,82988,317,1753,2512,60342,1484,54330,2829,114672,"California",444255,0.122294628085221,131639,0.64,69306,0.337
"6648","solano",6648,"2021-03-16",3089,170581,1325,84076,1528,84516,236,1989,1574,60641,1510,55840,1809,116481,"California",444255,0.125693576887148,131639,0.64,69306,0.337
"6649","solano",6649,"2021-03-17",6344,176925,1665,85741,4588,89104,91,2080,4887,64165,1454,57294,4978,121459,"California",444255,0.128966471958672,131639,0.64,69306,0.337
"6650","solano",6650,"2021-03-18",5183,182108,1838,87579,3309,92413,36,2116,3819,66663,1356,58650,3854,125313,"California",444255,0.132018773001992,131639,0.64,69306,0.337
"6651","solano",6651,"2021-03-19",3442,185550,2522,90101,847,93260,73,2189,1747,66800,1684,60334,1821,127134,"California",444255,0.135809388751956,131639,0.64,69306,0.337
"6652","solano",6652,"2021-03-20",5516,191066,1666,91767,3796,97056,54,2243,2837,67021,2670,63004,2891,130025,"California",444255,0.141819450540793,131639,0.64,69306,0.337
"6653","solano",6653,"2021-03-21",1667,192733,1564,93331,79,97135,24,2267,854,67086,811,63815,876,130901,"California",444255,0.143644978672159,131639,0.64,69306,0.337
"6654","solano",6654,"2021-03-22",2667,195400,2038,95369,579,97714,50,2317,1676,67822,986,64801,1722,132623,"California",444255,0.145864424711033,131639,0.64,69306,0.337
"6655","solano",6655,"2021-03-23",3495,198895,1657,97026,1796,99510,42,2359,1437,67246,2054,66855,1478,134101,"California",444255,0.150487895465442,131639,0.64,69306,0.337
"6656","solano",6656,"2021-03-24",2819,201714,1766,98792,1018,100528,35,2394,1373,67213,1440,68295,1407,135508,"California",444255,0.153729277104366,131639,0.64,69306,0.337
"6657","solano",6657,"2021-03-25",4847,206561,3975,102767,837,101365,35,2429,2289,66984,2554,70849,2325,137833,"California",444255,0.159478227594512,131639,0.64,69306,0.337
"6658","solano",6658,"2021-03-26",3210,209771,2085,104852,1089,102454,36,2465,1741,67301,1460,72309,1777,139610,"California",444255,0.162764628422865,131639,0.64,69306,0.337
"6659","solano",6659,"2021-03-27",4185,213956,1147,105999,3002,105456,36,2501,1799,66756,2380,74689,1835,141445,"California",444255,0.168121911964975,131639,0.64,69306,0.337
"6660","solano",6660,"2021-03-28",1415,215371,1105,107104,292,105748,18,2519,564,66491,847,75536,582,142027,"California",444255,0.170028474637314,131639,0.64,69306,0.337
"6661","solano",6661,"2021-03-29",3483,218854,2035,109139,1431,107179,17,2536,1602,66240,1870,77406,1619,143646,"California",444255,0.174237768848972,131639,0.64,69306,0.337
"6662","solano",6662,"2021-03-30",3006,221860,2014,111153,902,108081,90,2626,1910,67150,1091,78497,2001,145647,"California",444255,0.176693565632351,131639,0.64,69306,0.337
"6663","solano",6663,"2021-03-31",3118,224978,2123,113276,836,108917,159,2785,1845,67880,1270,79767,2000,147647,"California",444255,0.179552284161124,131639,0.64,69306,0.337
"6664","solano",6664,"2021-04-01",5517,230495,2096,115372,3276,112193,145,2930,3493,69506,2013,81780,3639,151286,"California",444255,0.184083465577202,131639,0.64,69306,0.337
"6665","solano",6665,"2021-04-02",6547,237042,2213,117585,4168,116361,166,3096,2535,68209,3997,85777,2700,153986,"California",444255,0.193080550584687,131639,0.64,69306,0.337
"6666","solano",6666,"2021-04-03",1526,238568,960,118545,412,116773,154,3250,560,67959,964,86741,714,154700,"California",444255,0.195250475515188,131639,0.64,69306,0.337
"6667","solano",6667,"2021-04-04",775,239343,286,118831,188,116961,301,3551,237,67963,534,87275,538,155238,"California",444255,0.196452487872956,131639,0.64,69306,0.337
"6668","solano",6668,"2021-04-05",2966,242309,2023,120854,737,117698,206,3757,1507,68217,1457,88732,1711,156949,"California",444255,0.199732135822895,131639,0.64,69306,0.337
"6669","solano",6669,"2021-04-06",5933,248242,1623,122477,3819,121517,491,4248,1624,66026,4303,93035,2112,159061,"California",444255,0.20941801442865,131639,0.64,69306,0.337
"6670","solano",6670,"2021-04-07",5874,254116,4547,127024,934,122451,393,4641,3347,67254,2511,95546,3739,162800,"California",444255,0.215070173661523,131639,0.64,69306,0.337
"6671","solano",6671,"2021-04-08",6401,260517,1781,128805,3765,126216,855,5496,1804,65335,4570,100116,2651,165451,"California",444255,0.225357058446163,131639,0.64,69306,0.337
"6672","solano",6672,"2021-04-09",6226,266743,1651,130456,3735,129951,840,6336,1512,62991,4692,104808,2348,167799,"California",444255,0.235918560286322,131639,0.64,69306,0.337
"6673","solano",6673,"2021-04-10",1713,268456,948,131404,448,130399,317,6653,793,63181,919,105727,1109,168908,"California",444255,0.237987192040607,131639,0.64,69306,0.337
"6674","solano",6674,"2021-04-11",1222,269678,759,132163,336,130735,127,6780,635,63359,584,106311,762,169670,"California",444255,0.239301752371949,131639,0.64,69306,0.337
"6675","solano",6675,"2021-04-12",3253,272931,1672,133835,1223,131958,358,7138,1341,63149,1907,108218,1697,171367,"California",444255,0.243594332084051,131639,0.64,69306,0.337
"6676","solano",6676,"2021-04-13",2524,275455,1090,134925,1433,133391,1,7139,1318,63266,1202,109420,1319,172686,"California",444255,0.246299985368763,131639,0.64,69306,0.337
"6677","solano",6677,"2021-04-14",6396,281851,1947,136872,4449,137840,0,7139,1848,60579,4536,113956,1849,174535,"California",444255,0.256510337531373,131639,0.64,69306,0.337
"6678","solano",6678,"2021-04-15",5657,287508,2135,139007,3522,141362,0,7139,1716,58366,3929,117885,1716,176251,"California",444255,0.265354357294797,131639,0.64,69306,0.337
"6679","solano",6679,"2021-04-16",3666,291174,2575,141582,1089,142451,2,7141,2281,59273,1376,119261,2283,178534,"California",444255,0.268451677527546,131639,0.64,69306,0.337
"6680","solano",6680,"2021-04-17",3249,294423,1058,142640,2191,144642,0,7141,1129,58290,2113,121374,1130,179664,"California",444255,0.273207954890772,131639,0.64,69306,0.337
"6681","solano",6681,"2021-04-18",1003,295426,609,143249,394,145036,0,7141,528,58344,474,121848,528,180192,"California",444255,0.274274909680251,131639,0.64,69306,0.337
"6682","solano",6682,"2021-04-19",2056,297482,1156,144405,900,145936,0,7141,1144,58583,907,122755,1146,181338,"California",444255,0.276316529920879,131639,0.64,69306,0.337
"6683","solano",6683,"2021-04-20",2996,300478,1823,146228,1173,147109,0,7141,1667,58925,1325,124080,1667,183005,"California",444255,0.279299051220583,131639,0.64,69306,0.337
"6684","solano",6684,"2021-04-21",3546,304024,2317,148545,1229,148338,0,7141,1778,58941,1762,125842,1778,184783,"California",444255,0.283265241809321,131639,0.64,69306,0.337
"6685","solano",6685,"2021-04-22",2913,306937,1467,150012,1446,149784,0,7141,1769,59569,1141,126983,1769,186552,"California",444255,0.285833586566274,131639,0.64,69306,0.337
"6686","solano",6686,"2021-04-23",4113,311050,2059,152071,2054,151838,0,7141,2460,60385,1645,128628,2461,189013,"California",444255,0.28953641489685,131639,0.64,69306,0.337
"6687","solano",6687,"2021-04-24",3461,314511,2276,154347,1183,153021,2,7143,2421,61846,962,129590,2423,191436,"California",444255,0.291701837908408,131639,0.64,69306,0.337
"6688","solano",6688,"2021-04-25",1429,315940,1114,155461,315,153336,0,7143,1129,62682,293,129883,1129,192565,"California",444255,0.292361369033551,131639,0.64,69306,0.337
"6689","solano",6689,"2021-04-26",2382,318322,1550,157011,828,154164,4,7147,1262,62840,1108,130991,1266,193831,"California",444255,0.294855432127945,131639,0.64,69306,0.337
"6690","solano",6690,"2021-04-27",2283,320605,1204,158215,1055,155219,24,7171,1263,63115,1013,132004,1288,195119,"California",444255,0.297135654072548,131639,0.64,69306,0.337
"6691","solano",6691,"2021-04-28",5079,325684,4102,162317,931,156150,46,7217,3140,64372,1929,133933,3186,198305,"California",444255,0.301477754893023,131639,0.64,69306,0.337
"6692","solano",6692,"2021-04-29",3872,329556,1253,163570,2588,158738,31,7248,1576,63692,2287,136220,1607,199912,"California",444255,0.306625699204286,131639,0.64,69306,0.337
"6693","solano",6693,"2021-04-30",3781,333337,2020,165590,1631,160369,130,7378,1836,63724,1934,138154,1966,201878,"California",444255,0.310979054822118,131639,0.64,69306,0.337
"6694","solano",6694,"2021-05-01",2111,335448,1625,167215,295,160664,191,7569,1245,64299,861,139015,1436,203314,"California",444255,0.312917130927058,131639,0.64,69306,0.337
"6695","solano",6695,"2021-05-02",1095,336543,934,168149,137,160801,24,7593,572,64377,518,139533,596,203910,"California",444255,0.314083127933282,131639,0.64,69306,0.337
"6696","solano",6696,"2021-05-03",1447,337990,1000,169149,358,161159,89,7682,593,64208,852,140385,683,204593,"California",444255,0.316000945402978,131639,0.64,69306,0.337
"6697","solano",6697,"2021-05-04",1781,339771,1041,170190,679,161838,61,7743,798,64085,982,141367,859,205452,"California",444255,0.318211387603966,131639,0.64,69306,0.337
"6698","solano",6698,"2021-05-05",2252,342023,1407,171597,730,162568,115,7858,1079,64110,1167,142534,1192,206644,"California",444255,0.320838257307177,131639,0.64,69306,0.337
"6699","solano",6699,"2021-05-06",1919,343942,1190,172787,582,163150,147,8005,714,63773,1198,143732,861,207505,"California",444255,0.323534906754004,131639,0.64,69306,0.337
"6700","solano",6700,"2021-05-07",2652,346594,1862,174649,679,163829,111,8116,916,63068,1730,145462,1025,208530,"California",444255,0.327429066639655,131639,0.64,69306,0.337
"6701","solano",6701,"2021-05-08",1284,347878,818,175467,355,164184,111,8227,445,62788,836,146298,556,209086,"California",444255,0.329310868757808,131639,0.64,69306,0.337
"6702","sonoma",6702,"2020-12-15",4,4,4,4,0,0,0,0,4,4,0,0,4,4,"California",496668,0,199938,0.745,61825,0.23
"6703","sonoma",6703,"2020-12-16",27,31,27,31,0,0,0,0,27,31,0,0,27,31,"California",496668,0,199938,0.745,61825,0.23
"6704","sonoma",6704,"2020-12-17",104,135,104,135,0,0,0,0,104,135,0,0,104,135,"California",496668,0,199938,0.745,61825,0.23
"6705","sonoma",6705,"2020-12-18",420,555,420,555,0,0,0,0,420,555,0,0,420,555,"California",496668,0,199938,0.745,61825,0.23
"6706","sonoma",6706,"2020-12-19",111,666,110,665,1,1,0,0,111,666,0,0,111,666,"California",496668,0,199938,0.745,61825,0.23
"6707","sonoma",6707,"2020-12-20",174,840,174,839,0,1,0,0,174,840,0,0,174,840,"California",496668,0,199938,0.745,61825,0.23
"6708","sonoma",6708,"2020-12-21",911,1751,909,1748,2,3,0,0,910,1750,0,0,910,1750,"California",496668,0,199938,0.745,61825,0.23
"6709","sonoma",6709,"2020-12-22",1355,3106,1264,3012,91,94,0,0,1355,3105,0,0,1355,3105,"California",496668,0,199938,0.745,61825,0.23
"6710","sonoma",6710,"2020-12-23",1607,4713,1231,4243,376,470,0,0,1608,4713,0,0,1608,4713,"California",496668,0,199938,0.745,61825,0.23
"6711","sonoma",6711,"2020-12-24",305,5018,101,4344,204,674,0,0,305,5018,0,0,305,5018,"California",496668,0,199938,0.745,61825,0.23
"6712","sonoma",6712,"2020-12-25",8,5026,2,4346,6,680,0,0,8,5026,0,0,8,5026,"California",496668,0,199938,0.745,61825,0.23
"6713","sonoma",6713,"2020-12-26",267,5293,256,4602,11,691,0,0,267,5293,0,0,267,5293,"California",496668,0,199938,0.745,61825,0.23
"6714","sonoma",6714,"2020-12-27",93,5386,80,4682,13,704,0,0,93,5386,0,0,93,5386,"California",496668,0,199938,0.745,61825,0.23
"6715","sonoma",6715,"2020-12-28",987,6373,553,5235,434,1138,0,0,958,6344,0,0,958,6344,"California",496668,0,199938,0.745,61825,0.23
"6716","sonoma",6716,"2020-12-29",1129,7502,776,6011,353,1491,0,0,1095,7439,0,0,1095,7439,"California",496668,0,199938,0.745,61825,0.23
"6717","sonoma",6717,"2020-12-30",1093,8595,479,6490,614,2105,0,0,1085,8524,0,0,1085,8524,"California",496668,0,199938,0.745,61825,0.23
"6718","sonoma",6718,"2020-12-31",517,9112,71,6561,446,2551,0,0,518,9042,0,0,518,9042,"California",496668,0,199938,0.745,61825,0.23
"6719","sonoma",6719,"2021-01-01",11,9123,6,6567,5,2556,0,0,11,9053,0,0,11,9053,"California",496668,0,199938,0.745,61825,0.23
"6720","sonoma",6720,"2021-01-02",131,9254,125,6692,6,2562,0,0,131,9184,0,0,131,9184,"California",496668,0,199938,0.745,61825,0.23
"6721","sonoma",6721,"2021-01-03",25,9279,11,6703,14,2576,0,0,25,9209,0,0,25,9209,"California",496668,0,199938,0.745,61825,0.23
"6722","sonoma",6722,"2021-01-04",341,9620,105,6808,236,2812,0,0,340,9549,0,0,340,9549,"California",496668,0,199938,0.745,61825,0.23
"6723","sonoma",6723,"2021-01-05",438,10058,102,6910,336,3148,0,0,414,9948,15,15,414,9963,"California",496668,3.02012612046679e-05,199938,0.745,61825,0.23
"6724","sonoma",6724,"2021-01-06",947,11005,432,7342,515,3663,0,0,836,10679,105,120,836,10799,"California",496668,0.000241610089637343,199938,0.745,61825,0.23
"6725","sonoma",6725,"2021-01-07",1031,12036,535,7877,496,4159,0,0,861,11371,169,289,861,11660,"California",496668,0.000581877632543268,199938,0.745,61825,0.23
"6726","sonoma",6726,"2021-01-08",1790,13826,1233,9110,557,4716,0,0,1318,12219,470,759,1318,12978,"California",496668,0.0015281838169562,199938,0.745,61825,0.23
"6727","sonoma",6727,"2021-01-09",639,14465,402,9512,237,4953,0,0,591,12762,48,807,591,13569,"California",496668,0.00162482785281113,199938,0.745,61825,0.23
"6728","sonoma",6728,"2021-01-10",472,14937,461,9973,11,4964,0,0,278,12846,194,1001,278,13847,"California",496668,0.00201543083105817,199938,0.745,61825,0.23
"6729","sonoma",6729,"2021-01-11",1384,16321,1238,11211,146,5110,0,0,414,12294,966,1967,414,14261,"California",496668,0.00396039205263878,199938,0.745,61825,0.23
"6730","sonoma",6730,"2021-01-12",1546,17867,1293,12504,253,5363,0,0,395,11540,1149,3116,395,14656,"California",496668,0.00627380866091635,199938,0.745,61825,0.23
"6731","sonoma",6731,"2021-01-13",2074,19941,1399,13903,675,6038,0,0,1211,11892,860,3976,1212,15868,"California",496668,0.00800534763665064,199938,0.745,61825,0.23
"6732","sonoma",6732,"2021-01-14",1531,21472,806,14709,725,6763,0,0,1300,12961,231,4207,1300,17168,"California",496668,0.00847044705920253,199938,0.745,61825,0.23
"6733","sonoma",6733,"2021-01-15",1568,23040,637,15346,931,7694,0,0,1347,14098,211,4418,1348,18516,"California",496668,0.00889527813348152,199938,0.745,61825,0.23
"6734","sonoma",6734,"2021-01-16",1144,24184,617,15963,527,8221,0,0,898,14754,242,4660,898,19414,"California",496668,0.0093825251475835,199938,0.745,61825,0.23
"6735","sonoma",6735,"2021-01-17",670,24854,549,16512,121,8342,0,0,590,15264,80,4740,590,20004,"California",496668,0.00954359854067506,199938,0.745,61825,0.23
"6736","sonoma",6736,"2021-01-18",1105,25959,931,17443,174,8516,0,0,615,15390,490,5230,616,20620,"California",496668,0.0105301730733609,199938,0.745,61825,0.23
"6737","sonoma",6737,"2021-01-19",2096,28055,1006,18449,1090,9606,0,0,1386,16069,708,5938,1387,22007,"California",496668,0.0119556726022212,199938,0.745,61825,0.23
"6738","sonoma",6738,"2021-01-20",2078,30133,626,19075,1452,11058,0,0,1417,16836,651,6589,1418,23425,"California",496668,0.0132664073385038,199938,0.745,61825,0.23
"6739","sonoma",6739,"2021-01-21",2262,32395,647,19722,1615,12673,0,0,2043,18663,217,6806,2044,25469,"California",496668,0.0137033189172647,199938,0.745,61825,0.23
"6740","sonoma",6740,"2021-01-22",2738,35133,1043,20765,1695,14368,0,0,2590,21106,147,6953,2590,28059,"California",496668,0.0139992912770704,199938,0.745,61825,0.23
"6741","sonoma",6741,"2021-01-23",768,35901,593,21358,175,14543,0,0,661,21661,106,7059,661,28720,"California",496668,0.0142127135229167,199938,0.745,61825,0.23
"6742","sonoma",6742,"2021-01-24",852,36753,716,22074,136,14679,0,0,836,22481,16,7075,836,29556,"California",496668,0.014244928201535,199938,0.745,61825,0.23
"6743","sonoma",6743,"2021-01-25",2173,38926,520,22594,1653,16332,0,0,1686,23680,487,7562,1686,31242,"California",496668,0.0152254624819799,199938,0.745,61825,0.23
"6744","sonoma",6744,"2021-01-26",2014,40940,302,22896,1712,18044,0,0,1559,24785,454,8016,1559,32801,"California",496668,0.0161395539877745,199938,0.745,61825,0.23
"6745","sonoma",6745,"2021-01-27",3699,44639,1279,24175,2420,20464,0,0,3126,27343,571,8587,3129,35930,"California",496668,0.0172892153309656,199938,0.745,61825,0.23
"6746","sonoma",6746,"2021-01-28",4119,48758,1848,26023,2271,22735,0,0,3448,30124,668,9255,3449,39379,"California",496668,0.0186341781632801,199938,0.745,61825,0.23
"6747","sonoma",6747,"2021-01-29",2967,51725,1411,27434,1556,24291,0,0,2133,31426,832,10087,2134,41513,"California",496668,0.0203093414514323,199938,0.745,61825,0.23
"6748","sonoma",6748,"2021-01-30",2583,54308,2394,29828,189,24480,0,0,2244,33332,339,10426,2245,43758,"California",496668,0.0209918899546578,199938,0.745,61825,0.23
"6749","sonoma",6749,"2021-01-31",777,55085,665,30493,112,24592,0,0,579,33714,197,10623,579,44337,"California",496668,0.0213885331851458,199938,0.745,61825,0.23
"6750","sonoma",6750,"2021-02-01",2505,57590,883,31376,1622,26214,0,0,2100,35412,402,11025,2100,46437,"California",496668,0.0221979269854309,199938,0.745,61825,0.23
"6751","sonoma",6751,"2021-02-02",3525,61115,1373,32749,2152,28366,0,0,2954,37797,569,11594,2954,49391,"California",496668,0.0233435614937946,199938,0.745,61825,0.23
"6752","sonoma",6752,"2021-02-03",4037,65152,1323,34072,2714,31080,0,0,3106,39975,928,12522,3106,52497,"California",496668,0.0252120128536568,199938,0.745,61825,0.23
"6753","sonoma",6753,"2021-02-04",4204,69356,1713,35785,2491,33571,0,0,3421,42616,781,13303,3422,55919,"California",496668,0.0267844918537131,199938,0.745,61825,0.23
"6754","sonoma",6754,"2021-02-05",4816,74172,1740,37525,3076,36647,0,0,3796,45397,1016,14319,3797,59716,"California",496668,0.028830123945976,199938,0.745,61825,0.23
"6755","sonoma",6755,"2021-02-06",2659,76831,2298,39823,361,37008,0,0,2099,46937,559,14878,2099,61815,"California",496668,0.0299556242802033,199938,0.745,61825,0.23
"6756","sonoma",6756,"2021-02-07",1536,78367,1401,41224,135,37143,0,0,1284,47969,252,15130,1284,63099,"California",496668,0.0304630054684417,199938,0.745,61825,0.23
"6757","sonoma",6757,"2021-02-08",3259,81626,1035,42259,2224,39367,0,0,2679,50069,579,15709,2679,65778,"California",496668,0.0316287741509419,199938,0.745,61825,0.23
"6758","sonoma",6758,"2021-02-09",3568,85194,1697,43956,1871,41238,0,0,3088,52680,478,16187,3089,68867,"California",496668,0.032591187674664,199938,0.745,61825,0.23
"6759","sonoma",6759,"2021-02-10",4538,89732,2480,46436,2058,43296,0,0,3500,55149,1032,17219,3501,72368,"California",496668,0.0346690344455451,199938,0.745,61825,0.23
"6760","sonoma",6760,"2021-02-11",5570,95302,3017,49453,2553,45849,0,0,4387,58356,1180,18399,4387,76755,"California",496668,0.0370448669936457,199938,0.745,61825,0.23
"6761","sonoma",6761,"2021-02-12",5902,101204,3243,52696,2659,48508,0,0,4479,61419,1419,19818,4482,81237,"California",496668,0.0399019063036072,199938,0.745,61825,0.23
"6762","sonoma",6762,"2021-02-13",1984,103188,1152,53848,832,49340,0,0,1200,61838,781,20599,1200,82437,"California",496668,0.0414743853036636,199938,0.745,61825,0.23
"6763","sonoma",6763,"2021-02-14",2318,105506,1824,55672,494,49834,0,0,1570,62661,747,21346,1570,84007,"California",496668,0.0429784081116561,199938,0.745,61825,0.23
"6764","sonoma",6764,"2021-02-15",2139,107645,791,56463,1348,51182,0,0,1604,63731,534,21880,1604,85611,"California",496668,0.0440535730105423,199938,0.745,61825,0.23
"6765","sonoma",6765,"2021-02-16",4897,112542,2052,58515,2845,54027,0,0,3643,66124,1250,23130,3643,89254,"California",496668,0.0465703447775979,199938,0.745,61825,0.23
"6766","sonoma",6766,"2021-02-17",5596,118138,2898,61413,2698,56725,0,0,3572,67682,2016,25146,3574,92828,"California",496668,0.0506293942835053,199938,0.745,61825,0.23
"6767","sonoma",6767,"2021-02-18",6924,125062,3133,64546,3791,60516,0,0,4002,68771,2914,28060,4003,96831,"California",496668,0.0564964926268654,199938,0.745,61825,0.23
"6768","sonoma",6768,"2021-02-19",5517,130579,1666,66212,3851,64367,0,0,3421,70102,2091,30151,3422,100253,"California",496668,0.0607065484387961,199938,0.745,61825,0.23
"6769","sonoma",6769,"2021-02-20",3120,133699,2840,69052,280,64647,0,0,1217,69422,1897,32048,1217,101470,"California",496668,0.0645260012724798,199938,0.745,61825,0.23
"6770","sonoma",6770,"2021-02-21",524,134223,417,69469,107,64754,0,0,131,69163,390,32438,131,101601,"California",496668,0.0653112340638012,199938,0.745,61825,0.23
"6771","sonoma",6771,"2021-02-22",2877,137100,1356,70825,1521,66275,0,0,1198,68687,1674,34112,1198,102799,"California",496668,0.0686816948142421,199938,0.745,61825,0.23
"6772","sonoma",6772,"2021-02-23",3364,140464,2071,72896,1293,67568,0,0,1617,68561,1743,35855,1617,104416,"California",496668,0.0721910813662245,199938,0.745,61825,0.23
"6773","sonoma",6773,"2021-02-24",5634,146098,2540,75436,3094,70662,0,0,2912,68757,2717,38572,2913,107329,"California",496668,0.0776615364790967,199938,0.745,61825,0.23
"6774","sonoma",6774,"2021-02-25",5792,151890,2239,77675,3553,74215,0,0,3109,69203,2663,41235,3109,110438,"California",496668,0.0830232670516321,199938,0.745,61825,0.23
"6775","sonoma",6775,"2021-02-26",6260,158150,2758,80433,3502,77717,0,0,3971,70890,2284,43519,3971,114409,"California",496668,0.0876219124243962,199938,0.745,61825,0.23
"6776","sonoma",6776,"2021-02-27",4029,162179,1908,82341,2121,79838,0,0,2686,72235,1341,44860,2686,117095,"California",496668,0.0903219051760935,199938,0.745,61825,0.23
"6777","sonoma",6777,"2021-02-28",2334,164513,1851,84192,483,80321,0,0,609,71130,1714,46574,609,117704,"California",496668,0.0937729026230802,199938,0.745,61825,0.23
"6778","sonoma",6778,"2021-03-01",3742,168255,1134,85326,2608,82929,0,0,1880,71159,1852,48426,1881,119585,"California",496668,0.0975017516731499,199938,0.745,61825,0.23
"6779","sonoma",6779,"2021-03-02",4348,172603,1482,86808,2866,85795,0,0,2533,71885,1807,50233,2533,122118,"California",496668,0.101139996939606,199938,0.745,61825,0.23
"6780","sonoma",6780,"2021-03-03",5033,177636,2634,89442,2399,88194,0,0,2311,71481,2715,52948,2311,124429,"California",496668,0.10660642521765,199938,0.745,61825,0.23
"6781","sonoma",6781,"2021-03-04",5921,183557,2665,92107,3256,91450,0,0,2568,70710,3339,56287,2568,126997,"California",496668,0.113329225961809,199938,0.745,61825,0.23
"6782","sonoma",6782,"2021-03-05",6443,190000,2823,94930,3605,95055,15,15,2715,69728,3713,60000,2731,129728,"California",496668,0.120805044818672,199938,0.745,61825,0.23
"6783","sonoma",6783,"2021-03-06",2778,192778,1212,96142,1432,96487,134,149,1910,70910,861,60861,2043,131771,"California",496668,0.12253859721182,199938,0.745,61825,0.23
"6784","sonoma",6784,"2021-03-07",1684,194462,1394,97536,255,96742,35,184,358,69979,1324,62185,393,132164,"California",496668,0.125204361867485,199938,0.745,61825,0.23
"6785","sonoma",6785,"2021-03-08",4053,198515,654,98190,3224,99966,175,359,2381,70871,1662,63847,2554,134718,"California",496668,0.128550661608962,199938,0.745,61825,0.23
"6786","sonoma",6786,"2021-03-09",5494,204009,3009,101199,2243,102209,242,601,2679,70984,2808,66655,2921,137639,"California",496668,0.134204337706476,199938,0.745,61825,0.23
"6787","sonoma",6787,"2021-03-10",5971,209980,3186,104385,2457,104666,328,929,2412,70178,3545,70200,2739,140378,"California",496668,0.141341902437846,199938,0.745,61825,0.23
"6788","sonoma",6788,"2021-03-11",7530,217510,3001,107386,3709,108375,820,1749,2568,68614,4953,75153,3389,143767,"California",496668,0.151314358887627,199938,0.745,61825,0.23
"6789","sonoma",6789,"2021-03-12",7397,224907,2267,109653,3770,112145,1360,3109,2106,66804,5272,80425,3462,147229,"California",496668,0.161929095492361,199938,0.745,61825,0.23
"6790","sonoma",6790,"2021-03-13",3395,228302,1688,111341,1472,113617,235,3344,1995,67632,1399,81824,2227,149456,"California",496668,0.16474586645405,199938,0.745,61825,0.23
"6791","sonoma",6791,"2021-03-14",1380,229682,383,111724,856,114473,141,3485,851,68097,526,82350,991,150447,"California",496668,0.165804924013627,199938,0.745,61825,0.23
"6792","sonoma",6792,"2021-03-15",5228,234910,1504,113228,3339,117812,385,3870,2194,67648,3026,85376,2577,153024,"California",496668,0.171897525107315,199938,0.745,61825,0.23
"6793","sonoma",6793,"2021-03-16",6281,241191,2242,115470,3807,121619,232,4102,2908,67419,3367,88743,3138,156162,"California",496668,0.178676701539056,199938,0.745,61825,0.23
"6794","sonoma",6794,"2021-03-17",6745,247936,3525,118995,3040,124659,180,4282,3286,67437,3447,92190,3465,159627,"California",496668,0.185616951363889,199938,0.745,61825,0.23
"6795","sonoma",6795,"2021-03-18",7123,255059,2938,121933,3571,128230,614,4896,3179,67291,3936,96126,3790,163417,"California",496668,0.193541762303994,199938,0.745,61825,0.23
"6796","sonoma",6796,"2021-03-19",7488,262547,3238,125171,4019,132249,231,5127,3194,66445,4275,100401,3429,166846,"California",496668,0.202149121747324,199938,0.745,61825,0.23
"6797","sonoma",6797,"2021-03-20",3699,266246,1747,126918,1123,133372,829,5956,2024,67626,1668,102069,2849,169695,"California",496668,0.205507501993283,199938,0.745,61825,0.23
"6798","sonoma",6798,"2021-03-21",1383,267629,601,127519,749,134121,33,5989,1215,68710,164,102233,1248,170943,"California",496668,0.205837702449121,199938,0.745,61825,0.23
"6799","sonoma",6799,"2021-03-22",4528,272157,3100,130619,1327,135448,101,6090,3423,71134,1100,103333,3524,174467,"California",496668,0.20805246160413,199938,0.745,61825,0.23
"6800","sonoma",6800,"2021-03-23",5814,277971,3620,134239,2118,137566,76,6166,4425,74256,1379,104712,4501,178968,"California",496668,0.210828964217546,199938,0.745,61825,0.23
"6801","sonoma",6801,"2021-03-24",6700,284671,4268,138507,2366,139932,66,6232,4081,75801,2601,107313,4146,183114,"California",496668,0.216065862910435,199938,0.745,61825,0.23
"6802","sonoma",6802,"2021-03-25",6988,291659,4192,142699,2689,142621,107,6339,4232,77407,2734,110047,4340,187454,"California",496668,0.221570546119339,199938,0.745,61825,0.23
"6803","sonoma",6803,"2021-03-26",7291,298950,3450,146149,3751,146372,90,6429,3814,77851,3460,113507,3904,191358,"California",496668,0.228536970370549,199938,0.745,61825,0.23
"6804","sonoma",6804,"2021-03-27",3820,302770,1502,147651,1956,148328,362,6791,1124,76653,2689,116196,1491,192849,"California",496668,0.233951049795839,199938,0.745,61825,0.23
"6805","sonoma",6805,"2021-03-28",1508,304278,949,148600,532,148860,27,6818,944,77063,561,116757,971,193820,"California",496668,0.235080576964894,199938,0.745,61825,0.23
"6806","sonoma",6806,"2021-03-29",2885,307163,1095,149695,1757,150617,33,6851,1605,77427,1274,118031,1638,195458,"California",496668,0.237645670749877,199938,0.745,61825,0.23
"6807","sonoma",6807,"2021-03-30",5761,312924,3168,152863,2530,153147,63,6914,3043,77820,2712,120743,3105,198563,"California",496668,0.243106058775681,199938,0.745,61825,0.23
"6808","sonoma",6808,"2021-03-31",5559,318483,3376,156239,1968,155115,215,7129,3227,78942,2320,123063,3442,202005,"California",496668,0.247777187175336,199938,0.745,61825,0.23
"6809","sonoma",6809,"2021-04-01",6700,325183,3989,160228,2375,157490,336,7465,3583,79754,3099,126162,3911,205916,"California",496668,0.254016767740221,199938,0.745,61825,0.23
"6810","sonoma",6810,"2021-04-02",5910,331093,3537,163765,2264,159754,109,7574,3548,81055,2356,128518,3657,209573,"California",496668,0.258760379166767,199938,0.745,61825,0.23
"6811","sonoma",6811,"2021-04-03",3580,334673,1769,165534,1588,161342,223,7797,1560,80828,2008,130526,1781,211354,"California",496668,0.262803321333366,199938,0.745,61825,0.23
"6812","sonoma",6812,"2021-04-04",1057,335730,688,166222,279,161621,90,7887,667,81199,386,130912,757,212111,"California",496668,0.263580500455032,199938,0.745,61825,0.23
"6813","sonoma",6813,"2021-04-05",4361,340091,591,166813,3431,165052,339,8226,1637,80456,2718,133630,1975,214086,"California",496668,0.269052968985318,199938,0.745,61825,0.23
"6814","sonoma",6814,"2021-04-06",6854,346945,3471,170284,2980,168032,403,8629,3977,81971,2863,136493,4378,218464,"California",496668,0.274817383040582,199938,0.745,61825,0.23
"6815","sonoma",6815,"2021-04-07",6756,353701,3813,174097,2109,170141,834,9463,3276,82605,3471,139964,4105,222569,"California",496668,0.281805954883343,199938,0.745,61825,0.23
"6816","sonoma",6816,"2021-04-08",7500,361201,4096,178193,2633,172774,771,10234,4085,84053,3404,143368,4852,227421,"California",496668,0.288659627759389,199938,0.745,61825,0.23
"6817","sonoma",6817,"2021-04-09",6772,367973,3770,181963,2118,174892,884,11118,3477,85127,3283,146651,4357,231778,"California",496668,0.295269677128384,199938,0.745,61825,0.23
"6818","sonoma",6818,"2021-04-10",3866,371839,1686,183649,1627,176519,553,11671,1125,84069,2731,149382,1673,233451,"California",496668,0.300768320085047,199938,0.745,61825,0.23
"6819","sonoma",6819,"2021-04-11",1281,373120,607,184256,592,177111,82,11753,435,83741,845,150227,517,233968,"California",496668,0.302469657799576,199938,0.745,61825,0.23
"6820","sonoma",6820,"2021-04-12",4929,378049,2050,186306,2398,179509,481,12234,1843,82980,3078,153305,2317,236285,"California",496668,0.308666956598774,199938,0.745,61825,0.23
"6821","sonoma",6821,"2021-04-13",7795,385844,4616,190922,3177,182686,2,12236,2961,81118,4825,158130,2963,239248,"California",496668,0.318381695619609,199938,0.745,61825,0.23
"6822","sonoma",6822,"2021-04-14",6538,392382,3726,194648,2792,185478,20,12256,2524,79660,4001,162131,2543,241791,"California",496668,0.326437378691601,199938,0.745,61825,0.23
"6823","sonoma",6823,"2021-04-15",7204,399586,4082,198730,3122,188600,0,12256,3552,79571,3641,165772,3552,245343,"California",496668,0.333768231494681,199938,0.745,61825,0.23
"6824","sonoma",6824,"2021-04-16",6790,406376,3414,202144,3375,191975,1,12257,3851,80491,2932,168704,3852,249195,"California",496668,0.339671571351486,199938,0.745,61825,0.23
"6825","sonoma",6825,"2021-04-17",3102,409478,1500,203644,1602,193577,0,12257,1498,80397,1593,170297,1499,250694,"California",496668,0.342878945291422,199938,0.745,61825,0.23
"6826","sonoma",6826,"2021-04-18",1239,410717,847,204491,392,193969,0,12257,403,79966,834,171131,403,251097,"California",496668,0.344558135414402,199938,0.745,61825,0.23
"6827","sonoma",6827,"2021-04-19",3307,414024,1873,206364,1433,195402,1,12258,1451,79566,1852,172983,1452,252549,"California",496668,0.348286984464471,199938,0.745,61825,0.23
"6828","sonoma",6828,"2021-04-20",6262,420286,3454,209818,2808,198210,0,12258,2374,78066,3875,176858,2375,254924,"California",496668,0.356088976942344,199938,0.745,61825,0.23
"6829","sonoma",6829,"2021-04-21",6367,426653,4194,214012,2171,200381,2,12260,2932,77578,3421,180279,2933,257857,"California",496668,0.362976877914422,199938,0.745,61825,0.23
"6830","sonoma",6830,"2021-04-22",6122,432775,4450,218462,1672,202053,0,12260,2484,76437,3625,183904,2484,260341,"California",496668,0.370275516038883,199938,0.745,61825,0.23
"6831","sonoma",6831,"2021-04-23",7377,440152,4617,223079,2753,204806,7,12267,3701,76481,3665,187569,3709,264050,"California",496668,0.37765469085989,199938,0.745,61825,0.23
"6832","sonoma",6832,"2021-04-24",2741,442893,1494,224573,1233,206039,14,12281,1554,76865,1184,188753,1568,265618,"California",496668,0.380038577077645,199938,0.745,61825,0.23
"6833","sonoma",6833,"2021-04-25",1077,443970,785,225358,292,206331,0,12281,428,76647,646,189399,428,266046,"California",496668,0.38133924472686,199938,0.745,61825,0.23
"6834","sonoma",6834,"2021-04-26",2707,446677,1268,226626,1413,207744,26,12307,1536,77046,1163,190562,1562,267608,"California",496668,0.383680849178928,199938,0.745,61825,0.23
"6835","sonoma",6835,"2021-04-27",5268,451945,3623,230249,1548,209292,97,12404,2160,76209,3094,193656,2257,269865,"California",496668,0.389910362656745,199938,0.745,61825,0.23
"6836","sonoma",6836,"2021-04-28",4858,456803,3199,233448,1464,210756,195,12599,2109,75776,2732,196388,2299,272164,"California",496668,0.395411019030821,199938,0.745,61825,0.23
"6837","sonoma",6837,"2021-04-29",4804,461607,3425,236873,1234,211990,145,12744,1758,74640,3039,199427,1903,274067,"California",496668,0.401529794550887,199938,0.745,61825,0.23
"6838","sonoma",6838,"2021-04-30",5431,467038,3620,240493,1518,213508,293,13037,1814,73140,3606,203033,2106,276173,"California",496668,0.408790177744489,199938,0.745,61825,0.23
"6839","sonoma",6839,"2021-05-01",2464,469502,1772,242265,586,214094,106,13143,1237,73259,1221,204254,1340,277513,"California",496668,0.411248560406549,199938,0.745,61825,0.23
"6840","sonoma",6840,"2021-05-02",862,470364,645,242910,166,214260,51,13194,551,73551,311,204565,603,278116,"California",496668,0.411874733222193,199938,0.745,61825,0.23
"6841","sonoma",6841,"2021-05-03",3172,473536,1677,244587,1352,215612,143,13337,1050,72629,2114,206679,1192,279308,"California",496668,0.416131097634637,199938,0.745,61825,0.23
"6842","sonoma",6842,"2021-05-04",4552,478088,2403,246990,1974,217586,175,13512,1456,71180,3076,209755,1627,280935,"California",496668,0.422324369599008,199938,0.745,61825,0.23
"6843","sonoma",6843,"2021-05-05",3636,481724,2162,249152,1287,218873,187,13699,1296,70333,2329,212084,1482,282417,"California",496668,0.427013618755386,199938,0.745,61825,0.23
"6844","sonoma",6844,"2021-05-06",4451,486175,2374,251526,1955,220828,122,13821,1345,68705,3093,215177,1465,283882,"California",496668,0.433241118815788,199938,0.745,61825,0.23
"6845","sonoma",6845,"2021-05-07",3574,489749,2305,253831,1149,221977,120,13941,1069,67400,2493,217670,1188,285070,"California",496668,0.438260568428004,199938,0.745,61825,0.23
"6846","sonoma",6846,"2021-05-08",1808,491557,1232,255063,488,222465,88,14029,764,67212,1040,218710,852,285922,"California",496668,0.440354522538195,199938,0.745,61825,0.23
"6847","stanislaus",6847,"2020-12-15",3,3,3,3,0,0,0,0,3,3,0,0,3,3,"California",562303,0,105841,0.493,104145,0.485
"6848","stanislaus",6848,"2020-12-16",37,40,37,40,0,0,0,0,37,40,0,0,37,40,"California",562303,0,105841,0.493,104145,0.485
"6849","stanislaus",6849,"2020-12-17",74,114,74,114,0,0,0,0,74,114,0,0,74,114,"California",562303,0,105841,0.493,104145,0.485
"6850","stanislaus",6850,"2020-12-18",337,451,331,445,6,6,0,0,337,451,0,0,337,451,"California",562303,0,105841,0.493,104145,0.485
"6851","stanislaus",6851,"2020-12-19",133,584,133,578,0,6,0,0,133,584,0,0,133,584,"California",562303,0,105841,0.493,104145,0.485
"6852","stanislaus",6852,"2020-12-20",85,669,85,663,0,6,0,0,85,669,0,0,85,669,"California",562303,0,105841,0.493,104145,0.485
"6853","stanislaus",6853,"2020-12-21",1000,1669,999,1662,1,7,0,0,999,1668,0,0,999,1668,"California",562303,0,105841,0.493,104145,0.485
"6854","stanislaus",6854,"2020-12-22",795,2464,783,2445,12,19,0,0,795,2463,0,0,795,2463,"California",562303,0,105841,0.493,104145,0.485
"6855","stanislaus",6855,"2020-12-23",447,2911,430,2875,17,36,0,0,446,2909,0,0,446,2909,"California",562303,0,105841,0.493,104145,0.485
"6856","stanislaus",6856,"2020-12-24",97,3008,88,2963,9,45,0,0,97,3006,0,0,97,3006,"California",562303,0,105841,0.493,104145,0.485
"6857","stanislaus",6857,"2020-12-26",51,3059,8,2971,43,88,0,0,51,3057,0,0,51,3057,"California",562303,0,105841,0.493,104145,0.485
"6858","stanislaus",6858,"2020-12-27",11,3070,6,2977,5,93,0,0,11,3068,0,0,11,3068,"California",562303,0,105841,0.493,104145,0.485
"6859","stanislaus",6859,"2020-12-28",490,3560,395,3372,95,188,0,0,490,3558,0,0,490,3558,"California",562303,0,105841,0.493,104145,0.485
"6860","stanislaus",6860,"2020-12-29",494,4054,416,3788,78,266,0,0,494,4052,0,0,494,4052,"California",562303,0,105841,0.493,104145,0.485
"6861","stanislaus",6861,"2020-12-30",534,4588,279,4067,255,521,0,0,533,4584,1,1,533,4585,"California",562303,1.77840061319253e-06,105841,0.493,104145,0.485
"6862","stanislaus",6862,"2020-12-31",275,4863,156,4223,119,640,0,0,275,4859,0,1,275,4860,"California",562303,1.77840061319253e-06,105841,0.493,104145,0.485
"6863","stanislaus",6863,"2021-01-01",12,4875,4,4227,8,648,0,0,12,4871,0,1,12,4872,"California",562303,1.77840061319253e-06,105841,0.493,104145,0.485
"6864","stanislaus",6864,"2021-01-02",32,4907,25,4252,7,655,0,0,32,4903,0,1,32,4904,"California",562303,1.77840061319253e-06,105841,0.493,104145,0.485
"6865","stanislaus",6865,"2021-01-03",90,4997,87,4339,3,658,0,0,90,4993,0,1,90,4994,"California",562303,1.77840061319253e-06,105841,0.493,104145,0.485
"6866","stanislaus",6866,"2021-01-04",229,5226,150,4489,79,737,0,0,229,5222,0,1,229,5223,"California",562303,1.77840061319253e-06,105841,0.493,104145,0.485
"6867","stanislaus",6867,"2021-01-05",832,6058,342,4831,490,1227,0,0,808,6014,23,24,815,6038,"California",562303,4.26816147166208e-05,105841,0.493,104145,0.485
"6868","stanislaus",6868,"2021-01-06",1002,7060,599,5430,403,1630,0,0,931,6878,68,92,932,6970,"California",562303,0.000163612856413713,105841,0.493,104145,0.485
"6869","stanislaus",6869,"2021-01-07",1079,8139,703,6133,376,2006,0,0,889,7585,184,276,891,7861,"California",562303,0.000490838569241139,105841,0.493,104145,0.485
"6870","stanislaus",6870,"2021-01-08",1280,9419,724,6857,556,2562,0,0,938,8189,339,615,943,8804,"California",562303,0.00109371637711341,105841,0.493,104145,0.485
"6871","stanislaus",6871,"2021-01-09",285,9704,141,6998,144,2706,0,0,195,8294,90,705,195,8999,"California",562303,0.00125377243230073,105841,0.493,104145,0.485
"6872","stanislaus",6872,"2021-01-10",48,9752,21,7019,27,2733,0,0,29,8304,19,724,29,9028,"California",562303,0.00128756204395139,105841,0.493,104145,0.485
"6873","stanislaus",6873,"2021-01-11",1523,11275,1246,8265,277,3010,0,0,596,7995,922,1646,613,9641,"California",562303,0.00292724740931491,105841,0.493,104145,0.485
"6874","stanislaus",6874,"2021-01-12",1467,12742,863,9128,604,3614,0,0,829,8197,634,2280,836,10477,"California",562303,0.00405475339807897,105841,0.493,104145,0.485
"6875","stanislaus",6875,"2021-01-13",1439,14181,685,9813,754,4368,0,0,1117,9001,322,2602,1126,11603,"California",562303,0.00462739839552697,105841,0.493,104145,0.485
"6876","stanislaus",6876,"2021-01-14",2229,16410,281,10094,1948,6316,0,0,2065,10968,162,2764,2129,13732,"California",562303,0.00491549929486416,105841,0.493,104145,0.485
"6877","stanislaus",6877,"2021-01-15",2820,19230,1156,11250,1664,7980,0,0,2671,13571,145,2909,2748,16480,"California",562303,0.00517336738377707,105841,0.493,104145,0.485
"6878","stanislaus",6878,"2021-01-16",472,19702,51,11301,421,8401,0,0,455,14012,16,2925,457,16937,"California",562303,0.00520182179358815,105841,0.493,104145,0.485
"6879","stanislaus",6879,"2021-01-17",244,19946,202,11503,42,8443,0,0,238,14245,5,2930,238,17175,"California",562303,0.00521071379665412,105841,0.493,104145,0.485
"6880","stanislaus",6880,"2021-01-18",2185,22131,1024,12527,1161,9604,0,0,1803,15739,377,3307,1871,19046,"California",562303,0.0058811708278277,105841,0.493,104145,0.485
"6881","stanislaus",6881,"2021-01-19",1250,23381,722,13249,528,10132,0,0,806,16105,441,3748,807,19853,"California",562303,0.00666544549824561,105841,0.493,104145,0.485
"6882","stanislaus",6882,"2021-01-20",1001,24382,486,13735,515,10647,0,0,711,16527,289,4037,711,20564,"California",562303,0.00717940327545825,105841,0.493,104145,0.485
"6883","stanislaus",6883,"2021-01-21",3648,28030,2951,16686,697,11344,0,0,3331,19642,315,4352,3430,23994,"California",562303,0.0077395994686139,105841,0.493,104145,0.485
"6884","stanislaus",6884,"2021-01-22",1066,29096,307,16993,759,12103,0,0,1021,20626,41,4393,1025,25019,"California",562303,0.00781251389375479,105841,0.493,104145,0.485
"6885","stanislaus",6885,"2021-01-23",341,29437,41,17034,300,12403,0,0,284,20858,56,4449,288,25307,"California",562303,0.00791210432809357,105841,0.493,104145,0.485
"6886","stanislaus",6886,"2021-01-24",293,29730,101,17135,192,12595,0,0,227,21021,66,4515,229,25536,"California",562303,0.00802947876856428,105841,0.493,104145,0.485
"6887","stanislaus",6887,"2021-01-25",3139,32869,226,17361,2913,15508,0,0,2826,23707,278,4793,2964,28500,"California",562303,0.0085238741390318,105841,0.493,104145,0.485
"6888","stanislaus",6888,"2021-01-26",1722,34591,744,18105,978,16486,0,0,1298,24603,418,5211,1314,29814,"California",562303,0.00926724559534628,105841,0.493,104145,0.485
"6889","stanislaus",6889,"2021-01-27",1867,36458,1030,19135,837,17323,0,0,1163,25107,660,5871,1164,30978,"California",562303,0.0104409900000534,105841,0.493,104145,0.485
"6890","stanislaus",6890,"2021-01-28",2200,38658,1504,20639,696,18019,0,0,1716,26401,476,6347,1770,32748,"California",562303,0.011287508691933,105841,0.493,104145,0.485
"6891","stanislaus",6891,"2021-01-29",2432,41090,1191,21830,1241,19260,0,0,1911,27880,476,6823,1955,34703,"California",562303,0.0121340273838126,105841,0.493,104145,0.485
"6892","stanislaus",6892,"2021-01-30",292,41382,131,21961,161,19421,0,0,229,28057,52,6875,229,34932,"California",562303,0.0122265042156987,105841,0.493,104145,0.485
"6893","stanislaus",6893,"2021-01-31",368,41750,314,22275,54,19475,0,0,352,28396,13,6888,352,35284,"California",562303,0.0122496234236702,105841,0.493,104145,0.485
"6894","stanislaus",6894,"2021-02-01",1263,43013,557,22832,706,20181,0,0,916,28976,336,7224,916,36200,"California",562303,0.0128471660297028,105841,0.493,104145,0.485
"6895","stanislaus",6895,"2021-02-02",1234,44247,375,23207,859,21040,0,0,779,29314,445,7669,783,36983,"California",562303,0.0136385543025735,105841,0.493,104145,0.485
"6896","stanislaus",6896,"2021-02-03",2468,46715,1089,24296,1379,22419,0,0,1797,30450,667,8336,1803,38786,"California",562303,0.0148247475115729,105841,0.493,104145,0.485
"6897","stanislaus",6897,"2021-02-04",2095,48810,725,25021,1370,23789,0,0,1578,31529,504,8840,1583,40369,"California",562303,0.015721061420622,105841,0.493,104145,0.485
"6898","stanislaus",6898,"2021-02-05",2835,51645,1457,26478,1378,25167,0,0,1583,31924,1197,10037,1592,41961,"California",562303,0.0178498069546134,105841,0.493,104145,0.485
"6899","stanislaus",6899,"2021-02-06",884,52529,301,26779,583,25750,0,0,693,32429,189,10226,694,42655,"California",562303,0.0181859246705068,105841,0.493,104145,0.485
"6900","stanislaus",6900,"2021-02-07",213,52742,189,26968,24,25774,0,0,42,32302,170,10396,43,42698,"California",562303,0.0184882527747496,105841,0.493,104145,0.485
"6901","stanislaus",6901,"2021-02-08",2017,54759,1319,28287,698,26472,0,0,1095,32521,887,11283,1106,43804,"California",562303,0.0200656941186513,105841,0.493,104145,0.485
"6902","stanislaus",6902,"2021-02-09",1832,56591,779,29066,1053,27525,0,0,1043,32801,769,12052,1049,44853,"California",562303,0.0214332841901964,105841,0.493,104145,0.485
"6903","stanislaus",6903,"2021-02-10",1931,58522,531,29597,1400,28925,0,0,1011,32914,900,12952,1013,45866,"California",562303,0.0230338447420697,105841,0.493,104145,0.485
"6904","stanislaus",6904,"2021-02-11",5374,63896,3261,32858,2113,31038,0,0,1226,30187,3957,16909,1230,47096,"California",562303,0.0300709759684725,105841,0.493,104145,0.485
"6905","stanislaus",6905,"2021-02-12",3284,67180,912,33770,2372,33410,0,0,1446,29872,1766,18675,1451,48547,"California",562303,0.0332116314513705,105841,0.493,104145,0.485
"6906","stanislaus",6906,"2021-02-13",1347,68527,649,34419,698,34108,0,0,979,30491,364,19039,983,49530,"California",562303,0.0338589692745726,105841,0.493,104145,0.485
"6907","stanislaus",6907,"2021-02-14",421,68948,168,34587,253,34361,0,0,352,30776,67,19106,352,49882,"California",562303,0.0339781221156565,105841,0.493,104145,0.485
"6908","stanislaus",6908,"2021-02-15",1809,70757,230,34817,1579,35940,0,0,579,30237,1122,20228,583,50465,"California",562303,0.0359734876036585,105841,0.493,104145,0.485
"6909","stanislaus",6909,"2021-02-16",1358,72115,420,35237,938,36878,0,0,581,30052,768,20996,583,51048,"California",562303,0.0373392992745904,105841,0.493,104145,0.485
"6910","stanislaus",6910,"2021-02-17",2732,74847,1670,36907,1062,37940,0,0,1935,31200,794,21790,1942,52990,"California",562303,0.0387513493614653,105841,0.493,104145,0.485
"6911","stanislaus",6911,"2021-02-18",3347,78194,1890,38797,1457,39397,0,0,1790,31528,1477,23267,1805,54795,"California",562303,0.0413780470671506,105841,0.493,104145,0.485
"6912","stanislaus",6912,"2021-02-19",2722,80916,1056,39853,1666,41063,0,0,1525,31906,1159,24426,1537,56332,"California",562303,0.0434392133778408,105841,0.493,104145,0.485
"6913","stanislaus",6913,"2021-02-20",745,81661,378,40231,367,41430,0,0,482,32145,245,24671,484,56816,"California",562303,0.0438749215280729,105841,0.493,104145,0.485
"6914","stanislaus",6914,"2021-02-21",904,82565,689,40920,215,41645,0,0,550,32376,330,25001,561,57377,"California",562303,0.0444617937304265,105841,0.493,104145,0.485
"6915","stanislaus",6915,"2021-02-22",2338,84903,1690,42610,648,42293,0,0,1634,33331,679,25680,1634,59011,"California",562303,0.0456693277467842,105841,0.493,104145,0.485
"6916","stanislaus",6916,"2021-02-23",3693,88596,679,43289,3014,45307,0,0,1731,33254,1815,27495,1738,60749,"California",562303,0.0488971248597286,105841,0.493,104145,0.485
"6917","stanislaus",6917,"2021-02-24",4153,92749,2837,46126,1316,46623,0,0,3130,35381,1006,28501,3133,63882,"California",562303,0.0506861958766003,105841,0.493,104145,0.485
"6918","stanislaus",6918,"2021-02-25",3873,96622,2639,48765,1234,47857,0,0,3074,37676,782,29283,3077,66959,"California",562303,0.0520769051561169,105841,0.493,104145,0.485
"6919","stanislaus",6919,"2021-02-26",4180,100802,1213,49978,2967,50824,0,0,2828,39210,1304,30587,2838,69797,"California",562303,0.05439593955572,105841,0.493,104145,0.485
"6920","stanislaus",6920,"2021-02-27",2089,102891,705,50683,1383,52207,1,1,1862,40874,199,30786,1863,71660,"California",562303,0.0547498412777453,105841,0.493,104145,0.485
"6921","stanislaus",6921,"2021-02-28",817,103708,262,50945,555,52762,0,1,769,41605,39,30825,770,72430,"California",562303,0.0548191989016598,105841,0.493,104145,0.485
"6922","stanislaus",6922,"2021-03-01",2755,106463,1620,52565,1134,53896,1,2,1626,42137,1104,31929,1636,74066,"California",562303,0.0567825531786243,105841,0.493,104145,0.485
"6923","stanislaus",6923,"2021-03-02",2375,108838,1411,53976,963,54859,1,3,1654,43080,712,32641,1655,75721,"California",562303,0.0580487744152174,105841,0.493,104145,0.485
"6924","stanislaus",6924,"2021-03-03",3707,112545,2227,56203,1478,56337,2,5,2905,45200,785,33426,2905,78626,"California",562303,0.0594448188965736,105841,0.493,104145,0.485
"6925","stanislaus",6925,"2021-03-04",5429,117974,3102,59305,2311,58648,16,21,4192,48194,1210,34636,4204,82830,"California",562303,0.0615966836385365,105841,0.493,104145,0.485
"6926","stanislaus",6926,"2021-03-05",4007,121981,1109,60414,2882,61530,16,37,3044,50313,940,35576,3059,85889,"California",562303,0.0632683802149375,105841,0.493,104145,0.485
"6927","stanislaus",6927,"2021-03-06",3573,125554,2225,62639,1255,62785,93,130,2722,52283,847,36423,2817,88706,"California",562303,0.0647746855343116,105841,0.493,104145,0.485
"6928","stanislaus",6928,"2021-03-07",845,126399,385,63024,424,63209,36,166,657,52794,182,36605,693,89399,"California",562303,0.0650983544459126,105841,0.493,104145,0.485
"6929","stanislaus",6929,"2021-03-08",1982,128381,854,63878,1039,64248,89,255,1322,53558,646,37251,1410,90809,"California",562303,0.066247201242035,105841,0.493,104145,0.485
"6930","stanislaus",6930,"2021-03-09",2169,130550,893,64771,1184,65432,92,347,1627,54751,530,37781,1723,92532,"California",562303,0.067189753567027,105841,0.493,104145,0.485
"6931","stanislaus",6931,"2021-03-10",5050,135600,2492,67263,2337,67769,221,568,3733,57418,1300,39081,3967,96499,"California",562303,0.0695016743641773,105841,0.493,104145,0.485
"6932","stanislaus",6932,"2021-03-11",5702,141302,3129,70392,2097,69866,476,1044,4126,60606,1416,40497,4604,101103,"California",562303,0.072019889632458,105841,0.493,104145,0.485
"6933","stanislaus",6933,"2021-03-12",5756,147058,1226,71618,2609,72475,1921,2965,2918,62619,2820,43317,4833,105936,"California",562303,0.0770349793616609,105841,0.493,104145,0.485
"6934","stanislaus",6934,"2021-03-13",3372,150430,2177,73795,1127,73602,68,3033,2684,64695,681,43998,2757,108693,"California",562303,0.078246070179245,105841,0.493,104145,0.485
"6935","stanislaus",6935,"2021-03-14",993,151423,595,74390,347,73949,51,3084,490,64739,500,44498,544,109237,"California",562303,0.0791352704858413,105841,0.493,104145,0.485
"6936","stanislaus",6936,"2021-03-15",3683,155106,1971,76361,1354,75303,358,3442,1602,64719,1986,46484,1966,111203,"California",562303,0.0826671741036416,105841,0.493,104145,0.485
"6937","stanislaus",6937,"2021-03-16",4900,160006,2441,78802,2048,77351,411,3853,3533,67313,1349,47833,3943,115146,"California",562303,0.0850662365308383,105841,0.493,104145,0.485
"6938","stanislaus",6938,"2021-03-17",4706,164712,2849,81651,1681,79032,176,4029,2883,68577,1801,49634,3065,118211,"California",562303,0.0882691360351981,105841,0.493,104145,0.485
"6939","stanislaus",6939,"2021-03-18",5408,170120,3410,85061,1930,80962,68,4097,2977,69341,2285,51919,3049,121260,"California",562303,0.092332781436343,105841,0.493,104145,0.485
"6940","stanislaus",6940,"2021-03-19",5911,176031,1527,86588,2859,83821,1525,5622,3098,71178,2784,54703,4621,125881,"California",562303,0.097283848743471,105841,0.493,104145,0.485
"6941","stanislaus",6941,"2021-03-20",3833,179864,2999,89587,766,84587,68,5690,3362,74145,464,55167,3431,129312,"California",562303,0.0981090266279924,105841,0.493,104145,0.485
"6942","stanislaus",6942,"2021-03-21",982,180846,882,90469,35,84622,65,5755,746,74722,234,55401,811,130123,"California",562303,0.0985251723714794,105841,0.493,104145,0.485
"6943","stanislaus",6943,"2021-03-22",2806,183652,1319,91788,763,85385,724,6479,1241,75138,1549,56950,1965,132088,"California",562303,0.101279914921315,105841,0.493,104145,0.485
"6944","stanislaus",6944,"2021-03-23",3937,187589,2013,93801,1664,87049,260,6739,2812,77121,1108,58058,3091,135179,"California",562303,0.103250382800732,105841,0.493,104145,0.485
"6945","stanislaus",6945,"2021-03-24",4536,192125,3212,97013,1255,88304,69,6808,2636,77972,1857,59915,2708,137887,"California",562303,0.106552872739431,105841,0.493,104145,0.485
"6946","stanislaus",6946,"2021-03-25",4229,196354,2904,99917,1309,89613,16,6824,1811,77458,2341,62256,1827,139714,"California",562303,0.110716108574914,105841,0.493,104145,0.485
"6947","stanislaus",6947,"2021-03-26",4714,201068,1332,101249,3307,92920,75,6899,2372,77611,2308,64564,2461,142175,"California",562303,0.114820657190163,105841,0.493,104145,0.485
"6948","stanislaus",6948,"2021-03-27",4336,205404,2712,103961,1581,94501,43,6942,1377,76095,2943,67507,1427,143602,"California",562303,0.120054490194788,105841,0.493,104145,0.485
"6949","stanislaus",6949,"2021-03-28",1101,206505,437,104398,557,95058,107,7049,320,75758,769,68276,432,144034,"California",562303,0.121422080266333,105841,0.493,104145,0.485
"6950","stanislaus",6950,"2021-03-29",2971,209476,1821,106219,1111,96169,39,7088,1983,76808,978,69254,2028,146062,"California",562303,0.123161356066036,105841,0.493,104145,0.485
"6951","stanislaus",6951,"2021-03-30",3662,213138,2051,108270,1584,97753,27,7115,2232,77651,1422,70676,2265,148327,"California",562303,0.125690241737995,105841,0.493,104145,0.485
"6952","stanislaus",6952,"2021-03-31",5396,218534,3827,112097,1450,99203,119,7234,2767,77928,2612,73288,2889,151216,"California",562303,0.130335424139654,105841,0.493,104145,0.485
"6953","stanislaus",6953,"2021-04-01",5718,224252,3825,115922,1804,101007,89,7323,2625,77574,3078,76366,2724,153940,"California",562303,0.135809341227061,105841,0.493,104145,0.485
"6954","stanislaus",6954,"2021-04-02",4983,229235,1210,117132,3621,104628,152,7475,2236,77309,2664,79030,2399,156339,"California",562303,0.140547000460606,105841,0.493,104145,0.485
"6955","stanislaus",6955,"2021-04-03",4541,233776,3300,120432,1204,105832,37,7512,2240,77305,2292,81322,2288,158627,"California",562303,0.144623094666043,105841,0.493,104145,0.485
"6956","stanislaus",6956,"2021-04-04",1317,235093,472,120904,815,106647,30,7542,653,77333,659,81981,687,159314,"California",562303,0.145795060670137,105841,0.493,104145,0.485
"6957","stanislaus",6957,"2021-04-05",3616,238709,2525,123429,841,107488,250,7792,2350,78679,1257,83238,2603,161917,"California",562303,0.14803051024092,105841,0.493,104145,0.485
"6958","stanislaus",6958,"2021-04-06",5731,244440,4156,127585,1302,108790,273,8065,3078,79397,2640,85878,3358,165275,"California",562303,0.152725487859748,105841,0.493,104145,0.485
"6959","stanislaus",6959,"2021-04-07",6335,250775,3594,131179,2322,111112,419,8484,2830,79162,3490,89368,3255,168530,"California",562303,0.15893210599979,105841,0.493,104145,0.485
"6960","stanislaus",6960,"2021-04-08",5664,256439,3316,134495,1917,113029,431,8915,2761,79474,2885,92253,3197,171727,"California",562303,0.164062791768851,105841,0.493,104145,0.485
"6961","stanislaus",6961,"2021-04-09",4806,261245,2102,136597,2336,115365,368,9283,2182,79434,2602,94855,2562,174289,"California",562303,0.168690190164378,105841,0.493,104145,0.485
"6962","stanislaus",6962,"2021-04-10",6471,267716,3980,140577,856,116221,1635,10918,1997,78606,4454,99309,3626,177915,"California",562303,0.176611186495537,105841,0.493,104145,0.485
"6963","stanislaus",6963,"2021-04-11",1518,269234,849,141426,536,116757,133,11051,664,78552,852,100161,798,178713,"California",562303,0.178126383817977,105841,0.493,104145,0.485
"6964","stanislaus",6964,"2021-04-12",3580,272814,2037,143463,1099,117856,444,11495,1870,79176,1697,101858,2321,181034,"California",562303,0.181144329658565,105841,0.493,104145,0.485
"6965","stanislaus",6965,"2021-04-13",5182,277996,3411,146874,1758,119614,13,11508,2919,79871,2230,104088,2925,183959,"California",562303,0.185110163025984,105841,0.493,104145,0.485
"6966","stanislaus",6966,"2021-04-14",4636,282632,3248,150122,1387,121001,1,11509,2249,79768,2357,106445,2254,186213,"California",562303,0.189301853271279,105841,0.493,104145,0.485
"6967","stanislaus",6967,"2021-04-15",5370,288002,3305,153427,2063,123064,2,11511,3231,80899,2104,108549,3235,189448,"California",562303,0.193043608161436,105841,0.493,104145,0.485
"6968","stanislaus",6968,"2021-04-16",4272,292274,980,154407,3291,126355,1,11512,1808,80285,2424,110973,1810,191258,"California",562303,0.197354451247815,105841,0.493,104145,0.485
"6969","stanislaus",6969,"2021-04-17",3129,295403,2095,156502,1034,127389,0,11512,1829,80829,1289,112262,1833,193091,"California",562303,0.19964680963822,105841,0.493,104145,0.485
"6970","stanislaus",6970,"2021-04-18",526,295929,213,156715,313,127702,0,11512,403,81117,117,112379,405,193496,"California",562303,0.199854882509963,105841,0.493,104145,0.485
"6971","stanislaus",6971,"2021-04-19",3448,299377,2445,159160,1002,128704,1,11513,1638,80983,1780,114159,1646,195142,"California",562303,0.203020435601446,105841,0.493,104145,0.485
"6972","stanislaus",6972,"2021-04-20",3965,303342,2407,161567,1558,130262,0,11513,1737,80522,2200,116359,1739,196881,"California",562303,0.20693291695047,105841,0.493,104145,0.485
"6973","stanislaus",6973,"2021-04-21",3786,307128,2524,164091,1261,131523,1,11514,1600,79978,2151,118510,1607,198488,"California",562303,0.210758256669447,105841,0.493,104145,0.485
"6974","stanislaus",6974,"2021-04-22",3932,311060,2393,166484,1539,133062,0,11514,1575,79244,2314,120824,1580,200068,"California",562303,0.214873475688374,105841,0.493,104145,0.485
"6975","stanislaus",6975,"2021-04-23",3587,314647,842,167326,2745,135807,0,11514,1475,78706,2020,122844,1482,201550,"California",562303,0.218465844927023,105841,0.493,104145,0.485
"6976","stanislaus",6976,"2021-04-24",3721,318368,2919,170245,802,136609,0,11514,1733,78473,1973,124817,1740,203290,"California",562303,0.221974629336852,105841,0.493,104145,0.485
"6977","stanislaus",6977,"2021-04-25",931,319299,478,170723,453,137062,0,11514,681,78914,245,125062,686,203976,"California",562303,0.222410337487084,105841,0.493,104145,0.485
"6978","stanislaus",6978,"2021-04-26",3166,322465,2228,172951,932,137994,6,11520,924,77625,2227,127289,938,204914,"California",562303,0.226370835652664,105841,0.493,104145,0.485
"6979","stanislaus",6979,"2021-04-27",3797,326262,2660,175611,1095,139089,42,11562,1060,76009,2719,130008,1103,206017,"California",562303,0.231206306919935,105841,0.493,104145,0.485
"6980","stanislaus",6980,"2021-04-28",4122,330384,2903,178514,1157,140246,62,11624,1805,75586,2302,132310,1879,207896,"California",562303,0.235300185131504,105841,0.493,104145,0.485
"6981","stanislaus",6981,"2021-04-29",3568,333952,2224,180738,1296,141542,48,11672,1396,74882,2157,134467,1453,209349,"California",562303,0.23913619525416,105841,0.493,104145,0.485
"6982","stanislaus",6982,"2021-04-30",4478,338430,2041,182779,2353,143895,84,11756,1773,74052,2695,137162,1865,211214,"California",562303,0.243928984906714,105841,0.493,104145,0.485
"6983","stanislaus",6983,"2021-05-01",2700,341130,1921,184700,739,144634,40,11796,1009,73427,1682,138844,1057,212271,"California",562303,0.246920254738104,105841,0.493,104145,0.485
"6984","stanislaus",6984,"2021-05-02",1065,342195,608,185308,421,145055,36,11832,515,73438,545,139389,556,212827,"California",562303,0.247889483072294,105841,0.493,104145,0.485
"6985","stanislaus",6985,"2021-05-03",2376,344571,1895,187203,414,145469,67,11899,892,72935,1474,140863,971,213798,"California",562303,0.25051084557614,105841,0.493,104145,0.485
"6986","stanislaus",6986,"2021-05-04",3405,347976,2436,189639,887,146356,82,11981,1015,71660,2381,143244,1106,214904,"California",562303,0.254745217436151,105841,0.493,104145,0.485
"6987","stanislaus",6987,"2021-05-05",3124,351100,2107,191746,944,147300,73,12054,1044,70717,2063,145307,1120,216024,"California",562303,0.258414057901167,105841,0.493,104145,0.485
"6988","stanislaus",6988,"2021-05-06",3067,354167,2282,194028,676,147976,109,12163,1005,69788,2049,147356,1120,217144,"California",562303,0.262058000757599,105841,0.493,104145,0.485
"6989","stanislaus",6989,"2021-05-07",2257,356424,877,194905,1239,149215,141,12304,925,69531,1324,148680,1067,218211,"California",562303,0.264412603169466,105841,0.493,104145,0.485
"6990","stanislaus",6990,"2021-05-08",1930,358354,1320,196225,576,149791,34,12338,691,69033,1227,149907,729,218940,"California",562303,0.266594700721853,105841,0.493,104145,0.485
"6991","sutter",6991,"2020-12-15",1,1,1,1,0,0,0,0,1,1,0,0,1,1,"California",105747,0,17367,0.407,24375,0.572
"6992","sutter",6992,"2020-12-16",4,5,4,5,0,0,0,0,4,5,0,0,4,5,"California",105747,0,17367,0.407,24375,0.572
"6993","sutter",6993,"2020-12-17",2,7,2,7,0,0,0,0,2,7,0,0,2,7,"California",105747,0,17367,0.407,24375,0.572
"6994","sutter",6994,"2020-12-18",20,27,20,27,0,0,0,0,20,27,0,0,20,27,"California",105747,0,17367,0.407,24375,0.572
"6995","sutter",6995,"2020-12-19",44,71,44,71,0,0,0,0,44,71,0,0,44,71,"California",105747,0,17367,0.407,24375,0.572
"6996","sutter",6996,"2020-12-20",42,113,42,113,0,0,0,0,42,113,0,0,42,113,"California",105747,0,17367,0.407,24375,0.572
"6997","sutter",6997,"2020-12-21",100,213,100,213,0,0,0,0,100,213,0,0,100,213,"California",105747,0,17367,0.407,24375,0.572
"6998","sutter",6998,"2020-12-22",172,385,172,385,0,0,0,0,172,385,0,0,172,385,"California",105747,0,17367,0.407,24375,0.572
"6999","sutter",6999,"2020-12-23",116,501,111,496,5,5,0,0,116,501,0,0,116,501,"California",105747,0,17367,0.407,24375,0.572
"7000","sutter",7000,"2020-12-24",17,518,11,507,6,11,0,0,17,518,0,0,17,518,"California",105747,0,17367,0.407,24375,0.572
"7001","sutter",7001,"2020-12-26",38,556,34,541,4,15,0,0,38,556,0,0,38,556,"California",105747,0,17367,0.407,24375,0.572
"7002","sutter",7002,"2020-12-27",24,580,23,564,1,16,0,0,24,580,0,0,24,580,"California",105747,0,17367,0.407,24375,0.572
"7003","sutter",7003,"2020-12-28",83,663,55,619,28,44,0,0,83,663,0,0,83,663,"California",105747,0,17367,0.407,24375,0.572
"7004","sutter",7004,"2020-12-29",102,765,14,633,88,132,0,0,102,765,0,0,102,765,"California",105747,0,17367,0.407,24375,0.572
"7005","sutter",7005,"2020-12-30",137,902,34,667,103,235,0,0,137,902,0,0,137,902,"California",105747,0,17367,0.407,24375,0.572
"7006","sutter",7006,"2020-12-31",70,972,6,673,64,299,0,0,70,972,0,0,70,972,"California",105747,0,17367,0.407,24375,0.572
"7007","sutter",7007,"2021-01-01",3,975,3,676,0,299,0,0,3,975,0,0,3,975,"California",105747,0,17367,0.407,24375,0.572
"7008","sutter",7008,"2021-01-02",133,1108,131,807,2,301,0,0,133,1108,0,0,133,1108,"California",105747,0,17367,0.407,24375,0.572
"7009","sutter",7009,"2021-01-03",1,1109,0,807,1,302,0,0,1,1109,0,0,1,1109,"California",105747,0,17367,0.407,24375,0.572
"7010","sutter",7010,"2021-01-04",247,1356,139,946,108,410,0,0,247,1356,0,0,247,1356,"California",105747,0,17367,0.407,24375,0.572
"7011","sutter",7011,"2021-01-05",100,1456,57,1003,43,453,0,0,98,1452,2,2,98,1454,"California",105747,1.89130660917095e-05,17367,0.407,24375,0.572
"7012","sutter",7012,"2021-01-06",204,1660,50,1053,154,607,0,0,199,1646,5,7,199,1653,"California",105747,6.61957313209831e-05,17367,0.407,24375,0.572
"7013","sutter",7013,"2021-01-07",251,1911,151,1204,100,707,0,0,242,1880,8,15,242,1895,"California",105747,0.000141847995687821,17367,0.407,24375,0.572
"7014","sutter",7014,"2021-01-08",147,2058,40,1244,107,814,0,0,130,1993,17,32,130,2025,"California",105747,0.000302609057467351,17367,0.407,24375,0.572
"7015","sutter",7015,"2021-01-09",46,2104,43,1287,3,817,0,0,5,1957,41,73,5,2030,"California",105747,0.000690326912347395,17367,0.407,24375,0.572
"7016","sutter",7016,"2021-01-10",397,2501,37,1324,360,1177,0,0,359,2279,37,110,359,2389,"California",105747,0.00104021863504402,17367,0.407,24375,0.572
"7017","sutter",7017,"2021-01-11",132,2633,114,1438,18,1195,0,0,26,2199,106,216,26,2415,"California",105747,0.00204261113790462,17367,0.407,24375,0.572
"7018","sutter",7018,"2021-01-12",201,2834,164,1602,37,1232,0,0,58,2114,143,359,58,2473,"California",105747,0.00339489536346185,17367,0.407,24375,0.572
"7019","sutter",7019,"2021-01-13",161,2995,98,1700,63,1295,0,0,71,2096,89,448,71,2544,"California",105747,0.00423652680454292,17367,0.407,24375,0.572
"7020","sutter",7020,"2021-01-14",145,3140,49,1749,96,1391,0,0,126,2203,19,467,126,2670,"California",105747,0.00441620093241416,17367,0.407,24375,0.572
"7021","sutter",7021,"2021-01-15",436,3576,132,1881,304,1695,0,0,421,2609,15,482,421,3091,"California",105747,0.00455804892810198,17367,0.407,24375,0.572
"7022","sutter",7022,"2021-01-16",384,3960,41,1922,343,2038,0,0,353,2932,30,512,353,3444,"California",105747,0.00484174491947762,17367,0.407,24375,0.572
"7023","sutter",7023,"2021-01-17",26,3986,24,1946,2,2040,0,0,10,2926,16,528,10,3454,"California",105747,0.0049930494482113,17367,0.407,24375,0.572
"7024","sutter",7024,"2021-01-18",116,4102,61,2007,55,2095,0,0,69,2948,47,575,69,3523,"California",105747,0.00543750650136647,17367,0.407,24375,0.572
"7025","sutter",7025,"2021-01-19",104,4206,43,2050,61,2156,0,0,79,3002,25,600,79,3602,"California",105747,0.00567391982751284,17367,0.407,24375,0.572
"7026","sutter",7026,"2021-01-20",255,4461,190,2240,65,2221,0,0,235,3217,20,620,235,3837,"California",105747,0.00586305048842993,17367,0.407,24375,0.572
"7027","sutter",7027,"2021-01-21",472,4933,303,2543,169,2390,0,0,453,3651,19,639,453,4290,"California",105747,0.00604272461630117,17367,0.407,24375,0.572
"7028","sutter",7028,"2021-01-22",269,5202,81,2624,188,2578,0,0,260,3902,9,648,260,4550,"California",105747,0.00612783341371386,17367,0.407,24375,0.572
"7029","sutter",7029,"2021-01-23",397,5599,40,2664,357,2935,0,0,370,4245,27,675,370,4920,"California",105747,0.00638315980595194,17367,0.407,24375,0.572
"7030","sutter",7030,"2021-01-24",17,5616,14,2678,3,2938,0,0,15,4258,2,677,15,4935,"California",105747,0.00640207287204365,17367,0.407,24375,0.572
"7031","sutter",7031,"2021-01-25",307,5923,197,2875,110,3048,0,0,152,4256,154,831,152,5087,"California",105747,0.00785837896110528,17367,0.407,24375,0.572
"7032","sutter",7032,"2021-01-26",243,6166,103,2978,140,3188,0,0,143,4300,99,930,143,5230,"California",105747,0.0087945757326449,17367,0.407,24375,0.572
"7033","sutter",7033,"2021-01-27",386,6552,255,3233,131,3319,0,0,320,4554,66,996,320,5550,"California",105747,0.00941870691367131,17367,0.407,24375,0.572
"7034","sutter",7034,"2021-01-28",525,7077,301,3534,224,3543,0,0,395,4820,129,1125,395,5945,"California",105747,0.0106385996765866,17367,0.407,24375,0.572
"7035","sutter",7035,"2021-01-29",419,7496,146,3680,273,3816,0,0,254,4909,165,1290,254,6199,"California",105747,0.0121989276291526,17367,0.407,24375,0.572
"7036","sutter",7036,"2021-01-30",775,8271,38,3718,737,4553,0,0,764,5662,11,1301,764,6963,"California",105747,0.012302949492657,17367,0.407,24375,0.572
"7037","sutter",7037,"2021-01-31",27,8298,27,3745,0,4553,0,0,27,5689,0,1301,27,6990,"California",105747,0.012302949492657,17367,0.407,24375,0.572
"7038","sutter",7038,"2021-02-01",165,8463,49,3794,116,4669,0,0,134,5792,31,1332,134,7124,"California",105747,0.0125961020170785,17367,0.407,24375,0.572
"7039","sutter",7039,"2021-02-02",244,8707,27,3821,217,4886,0,0,212,5972,32,1364,212,7336,"California",105747,0.0128987110745459,17367,0.407,24375,0.572
"7040","sutter",7040,"2021-02-03",443,9150,38,3859,405,5291,0,0,210,5949,233,1597,210,7546,"California",105747,0.01510208327423,17367,0.407,24375,0.572
"7041","sutter",7041,"2021-02-04",670,9820,366,4225,304,5595,0,0,620,6519,50,1647,620,8166,"California",105747,0.0155749099265227,17367,0.407,24375,0.572
"7042","sutter",7042,"2021-02-05",285,10105,32,4257,253,5848,0,0,136,6506,149,1796,136,8302,"California",105747,0.0169839333503551,17367,0.407,24375,0.572
"7043","sutter",7043,"2021-02-06",735,10840,29,4286,706,6554,0,0,713,7197,22,1818,713,9015,"California",105747,0.0171919770773639,17367,0.407,24375,0.572
"7044","sutter",7044,"2021-02-07",23,10863,20,4306,3,6557,0,0,19,7212,4,1822,19,9034,"California",105747,0.0172298032095473,17367,0.407,24375,0.572
"7045","sutter",7045,"2021-02-08",134,10997,29,4335,105,6662,0,0,98,7274,36,1858,98,9132,"California",105747,0.0175702383991981,17367,0.407,24375,0.572
"7046","sutter",7046,"2021-02-09",245,11242,45,4380,200,6862,0,0,184,7397,61,1919,184,9316,"California",105747,0.0181470869149952,17367,0.407,24375,0.572
"7047","sutter",7047,"2021-02-10",818,12060,379,4759,439,7301,0,0,177,6934,640,2559,177,9493,"California",105747,0.0241992680643422,17367,0.407,24375,0.572
"7048","sutter",7048,"2021-02-11",603,12663,275,5034,328,7629,0,0,345,7021,258,2817,345,9838,"California",105747,0.0266390535901728,17367,0.407,24375,0.572
"7049","sutter",7049,"2021-02-12",633,13296,67,5101,566,8195,0,0,310,7009,322,3139,310,10148,"California",105747,0.029684057230938,17367,0.407,24375,0.572
"7050","sutter",7050,"2021-02-13",898,14194,49,5150,849,9044,0,0,781,7673,117,3256,781,10929,"California",105747,0.030790471597303,17367,0.407,24375,0.572
"7051","sutter",7051,"2021-02-14",90,14284,25,5175,65,9109,0,0,80,7743,10,3266,80,11009,"California",105747,0.0308850369277615,17367,0.407,24375,0.572
"7052","sutter",7052,"2021-02-15",198,14482,73,5248,125,9234,0,0,119,7783,79,3345,119,11128,"California",105747,0.0316321030383841,17367,0.407,24375,0.572
"7053","sutter",7053,"2021-02-16",289,14771,45,5293,244,9478,0,0,205,7905,83,3428,205,11333,"California",105747,0.03241699528119,17367,0.407,24375,0.572
"7054","sutter",7054,"2021-02-17",823,15594,428,5721,395,9873,0,0,129,7340,694,4122,129,11462,"California",105747,0.0389798292150132,17367,0.407,24375,0.572
"7055","sutter",7055,"2021-02-18",700,16294,55,5776,645,10518,0,0,489,7619,210,4332,489,11951,"California",105747,0.0409657011546427,17367,0.407,24375,0.572
"7056","sutter",7056,"2021-02-19",665,16959,378,6154,287,10805,0,0,463,7882,200,4532,463,12414,"California",105747,0.0428570077638136,17367,0.407,24375,0.572
"7057","sutter",7057,"2021-02-20",622,17581,55,6209,567,11372,0,0,519,8299,102,4634,519,12933,"California",105747,0.0438215741344908,17367,0.407,24375,0.572
"7058","sutter",7058,"2021-02-21",29,17610,26,6235,3,11375,0,0,6,8282,23,4657,6,12939,"California",105747,0.0440390743945455,17367,0.407,24375,0.572
"7059","sutter",7059,"2021-02-22",207,17817,122,6357,85,11460,0,0,87,8249,120,4777,87,13026,"California",105747,0.045173858360048,17367,0.407,24375,0.572
"7060","sutter",7060,"2021-02-23",223,18040,33,6390,190,11650,0,0,97,8220,126,4903,97,13123,"California",105747,0.0463653815238257,17367,0.407,24375,0.572
"7061","sutter",7061,"2021-02-24",960,19000,349,6739,611,12261,0,0,190,7641,769,5672,190,13313,"California",105747,0.053637455436088,17367,0.407,24375,0.572
"7062","sutter",7062,"2021-02-25",784,19784,497,7236,287,12548,0,0,603,8066,178,5850,603,13916,"California",105747,0.0553207183182502,17367,0.407,24375,0.572
"7063","sutter",7063,"2021-02-26",370,20154,59,7295,311,12859,0,0,154,8006,214,6064,154,14070,"California",105747,0.0573444163900631,17367,0.407,24375,0.572
"7064","sutter",7064,"2021-02-27",865,21019,44,7339,821,13680,0,0,710,8559,157,6221,710,14780,"California",105747,0.0588290920782623,17367,0.407,24375,0.572
"7065","sutter",7065,"2021-02-28",83,21102,38,7377,45,13725,0,0,64,8605,18,6239,64,14844,"California",105747,0.0589993096730877,17367,0.407,24375,0.572
"7066","sutter",7066,"2021-03-01",247,21349,61,7438,186,13911,0,0,150,8658,97,6336,150,14994,"California",105747,0.0599165933785356,17367,0.407,24375,0.572
"7067","sutter",7067,"2021-03-02",334,21683,57,7495,277,14188,0,0,160,8645,173,6509,160,15154,"California",105747,0.0615525735954684,17367,0.407,24375,0.572
"7068","sutter",7068,"2021-03-03",1384,23067,514,8009,870,15058,0,0,647,8561,731,7240,647,15801,"California",105747,0.0684652992519882,17367,0.407,24375,0.572
"7069","sutter",7069,"2021-03-04",1256,24323,867,8876,389,15447,0,0,950,9209,302,7542,950,16751,"California",105747,0.0713211722318364,17367,0.407,24375,0.572
"7070","sutter",7070,"2021-03-05",337,24660,77,8953,259,15706,1,1,204,9282,132,7674,205,16956,"California",105747,0.0725694345938892,17367,0.407,24375,0.572
"7071","sutter",7071,"2021-03-06",1022,25682,46,8999,971,16677,5,6,860,9985,162,7836,865,17821,"California",105747,0.0741013929473177,17367,0.407,24375,0.572
"7072","sutter",7072,"2021-03-07",64,25746,23,9022,40,16717,1,7,44,10010,20,7856,45,17866,"California",105747,0.0742905236082348,17367,0.407,24375,0.572
"7073","sutter",7073,"2021-03-08",226,25972,79,9101,135,16852,12,19,158,10112,68,7924,170,18036,"California",105747,0.0749335678553529,17367,0.407,24375,0.572
"7074","sutter",7074,"2021-03-09",386,26358,136,9237,237,17089,13,32,183,10106,202,8126,196,18232,"California",105747,0.0768437875306155,17367,0.407,24375,0.572
"7075","sutter",7075,"2021-03-10",1571,27929,683,9920,827,17916,61,93,527,9653,1041,9167,588,18820,"California",105747,0.0866880384313503,17367,0.407,24375,0.572
"7076","sutter",7076,"2021-03-11",894,28823,442,10362,433,18349,19,112,647,10075,244,9411,666,19486,"California",105747,0.0889954324945389,17367,0.407,24375,0.572
"7077","sutter",7077,"2021-03-12",672,29495,110,10472,380,18729,182,294,198,9982,471,9882,378,19864,"California",105747,0.0934494595591364,17367,0.407,24375,0.572
"7078","sutter",7078,"2021-03-13",981,30476,747,11219,217,18946,17,311,778,10576,201,10083,795,20659,"California",105747,0.0953502227013532,17367,0.407,24375,0.572
"7079","sutter",7079,"2021-03-14",128,30604,21,11240,96,19042,11,322,43,10545,85,10168,54,20713,"California",105747,0.0961540280102509,17367,0.407,24375,0.572
"7080","sutter",7080,"2021-03-15",318,30922,66,11306,203,19245,49,371,151,10579,166,10334,200,20913,"California",105747,0.0977238124958628,17367,0.407,24375,0.572
"7081","sutter",7081,"2021-03-16",388,31310,86,11392,255,19500,47,418,210,10657,178,10512,256,21169,"California",105747,0.0994070753780249,17367,0.407,24375,0.572
"7082","sutter",7082,"2021-03-17",1497,32807,565,11957,913,20413,19,437,310,9807,1179,11691,329,21498,"California",105747,0.110556327839088,17367,0.407,24375,0.572
"7083","sutter",7083,"2021-03-18",963,33770,176,12133,587,21000,200,637,568,10180,394,12085,767,22265,"California",105747,0.114282201859154,17367,0.407,24375,0.572
"7084","sutter",7084,"2021-03-19",462,34232,164,12297,269,21269,29,666,283,10315,177,12262,312,22577,"California",105747,0.115956008208271,17367,0.407,24375,0.572
"7085","sutter",7085,"2021-03-20",951,35183,116,12413,824,22093,11,677,863,11101,88,12350,874,23451,"California",105747,0.116788183116306,17367,0.407,24375,0.572
"7086","sutter",7086,"2021-03-21",67,35250,47,12460,17,22110,3,680,37,11111,30,12380,40,23491,"California",105747,0.117071879107682,17367,0.407,24375,0.572
"7087","sutter",7087,"2021-03-22",287,35537,120,12580,141,22251,26,706,212,11275,74,12454,238,23729,"California",105747,0.117771662553075,17367,0.407,24375,0.572
"7088","sutter",7088,"2021-03-23",376,35913,116,12696,228,22479,32,738,254,11439,122,12576,286,24015,"California",105747,0.118925359584669,17367,0.407,24375,0.572
"7089","sutter",7089,"2021-03-24",1684,37597,773,13469,841,23320,70,808,317,10473,1353,13929,387,24402,"California",105747,0.131720048795711,17367,0.407,24375,0.572
"7090","sutter",7090,"2021-03-25",1038,38635,679,14148,318,23638,41,849,369,10216,667,14596,410,24812,"California",105747,0.138027556337296,17367,0.407,24375,0.572
"7091","sutter",7091,"2021-03-26",487,39122,174,14322,296,23934,17,866,294,10337,190,14786,311,25123,"California",105747,0.139824297616008,17367,0.407,24375,0.572
"7092","sutter",7092,"2021-03-27",932,40054,63,14385,867,24801,2,868,824,11058,105,14891,826,25949,"California",105747,0.140817233585823,17367,0.407,24375,0.572
"7093","sutter",7093,"2021-03-28",125,40179,71,14456,54,24855,0,868,78,11091,45,14936,78,26027,"California",105747,0.141242777572886,17367,0.407,24375,0.572
"7094","sutter",7094,"2021-03-29",427,40606,144,14600,228,25083,55,923,226,11173,199,15135,281,26308,"California",105747,0.143124627649011,17367,0.407,24375,0.572
"7095","sutter",7095,"2021-03-30",476,41082,159,14759,307,25390,10,933,317,11341,159,15294,327,26635,"California",105747,0.144628216403302,17367,0.407,24375,0.572
"7096","sutter",7096,"2021-03-31",1244,42326,175,14934,1053,26443,16,949,444,11010,790,16084,459,27094,"California",105747,0.152098877509527,17367,0.407,24375,0.572
"7097","sutter",7097,"2021-04-01",1375,43701,732,15666,456,26899,187,1136,420,10668,948,17032,606,27700,"California",105747,0.161063670836998,17367,0.407,24375,0.572
"7098","sutter",7098,"2021-04-02",513,44214,99,15765,296,27195,118,1254,201,10673,311,17343,316,28016,"California",105747,0.164004652614259,17367,0.407,24375,0.572
"7099","sutter",7099,"2021-04-03",909,45123,77,15842,209,27404,623,1877,120,10629,787,18130,743,28759,"California",105747,0.171446944121346,17367,0.407,24375,0.572
"7100","sutter",7100,"2021-04-04",117,45240,22,15864,89,27493,6,1883,54,10626,63,18193,60,28819,"California",105747,0.172042705703235,17367,0.407,24375,0.572
"7101","sutter",7101,"2021-04-05",368,45608,146,16010,186,27679,36,1919,177,10651,188,18381,213,29032,"California",105747,0.173820533915856,17367,0.407,24375,0.572
"7102","sutter",7102,"2021-04-06",509,46117,196,16206,257,27936,56,1975,272,10743,236,18617,328,29360,"California",105747,0.176052275714677,17367,0.407,24375,0.572
"7103","sutter",7103,"2021-04-07",1465,47582,864,17070,526,28462,75,2050,603,10565,856,19473,678,30038,"California",105747,0.184147068001929,17367,0.407,24375,0.572
"7104","sutter",7104,"2021-04-08",1024,48606,575,17645,340,28802,109,2159,561,10775,458,19931,668,30706,"California",105747,0.188478160136931,17367,0.407,24375,0.572
"7105","sutter",7105,"2021-04-09",558,49164,246,17891,249,29051,63,2222,235,10752,321,20252,298,31004,"California",105747,0.19151370724465,17367,0.407,24375,0.572
"7106","sutter",7106,"2021-04-10",819,49983,106,17997,88,29139,625,2847,105,10764,712,20964,724,31728,"California",105747,0.198246758773299,17367,0.407,24375,0.572
"7107","sutter",7107,"2021-04-11",110,50093,28,18025,40,29179,42,2889,32,10760,78,21042,74,31802,"California",105747,0.198984368350875,17367,0.407,24375,0.572
"7108","sutter",7108,"2021-04-12",337,50430,91,18116,192,29371,54,2943,137,10751,200,21242,191,31993,"California",105747,0.200875674960046,17367,0.407,24375,0.572
"7109","sutter",7109,"2021-04-13",429,50859,126,18242,303,29674,0,2943,214,10752,213,21455,214,32207,"California",105747,0.202889916498813,17367,0.407,24375,0.572
"7110","sutter",7110,"2021-04-14",1292,52151,160,18402,1131,30805,1,2944,213,9893,1073,22528,214,32421,"California",105747,0.213036776457015,17367,0.407,24375,0.572
"7111","sutter",7111,"2021-04-15",535,52686,174,18576,361,31166,0,2944,214,9788,319,22847,214,32635,"California",105747,0.216053410498643,17367,0.407,24375,0.572
"7112","sutter",7112,"2021-04-16",393,53079,122,18698,271,31437,0,2944,180,9756,212,23059,180,32815,"California",105747,0.218058195504364,17367,0.407,24375,0.572
"7113","sutter",7113,"2021-04-17",577,53656,84,18782,493,31930,0,2944,506,10193,69,23128,506,33321,"California",105747,0.218710696284528,17367,0.407,24375,0.572
"7114","sutter",7114,"2021-04-18",69,53725,10,18792,59,31989,0,2944,42,10209,26,23154,42,33363,"California",105747,0.21895656614372,17367,0.407,24375,0.572
"7115","sutter",7115,"2021-04-19",289,54014,110,18902,179,32168,0,2944,121,10164,166,23320,121,33484,"California",105747,0.220526350629332,17367,0.407,24375,0.572
"7116","sutter",7116,"2021-04-20",391,54405,136,19038,255,32423,0,2944,202,10178,188,23508,202,33686,"California",105747,0.222304178841953,17367,0.407,24375,0.572
"7117","sutter",7117,"2021-04-21",1237,55642,423,19461,814,33237,0,2944,478,9906,750,24258,478,34164,"California",105747,0.229396578626344,17367,0.407,24375,0.572
"7118","sutter",7118,"2021-04-22",474,56116,166,19627,308,33545,0,2944,246,9925,227,24485,246,34410,"California",105747,0.231543211627753,17367,0.407,24375,0.572
"7119","sutter",7119,"2021-04-23",399,56515,117,19744,282,33827,0,2944,187,9901,211,24696,187,34597,"California",105747,0.233538540100428,17367,0.407,24375,0.572
"7120","sutter",7120,"2021-04-24",324,56839,105,19849,219,34046,0,2944,185,9948,138,24834,185,34782,"California",105747,0.234843541660756,17367,0.407,24375,0.572
"7121","sutter",7121,"2021-04-25",157,56996,75,19924,82,34128,0,2944,86,9966,68,24902,86,34868,"California",105747,0.235486585907874,17367,0.407,24375,0.572
"7122","sutter",7122,"2021-04-26",259,57255,60,19984,197,34325,2,2946,114,9939,143,25045,116,34984,"California",105747,0.236838870133432,17367,0.407,24375,0.572
"7123","sutter",7123,"2021-04-27",487,57742,228,20212,255,34580,4,2950,225,9909,259,25304,229,35213,"California",105747,0.239288112192308,17367,0.407,24375,0.572
"7124","sutter",7124,"2021-04-28",817,58559,342,20554,467,35047,8,2958,259,9623,553,25857,267,35480,"California",105747,0.244517574966666,17367,0.407,24375,0.572
"7125","sutter",7125,"2021-04-29",773,59332,134,20688,638,35685,1,2959,308,9470,462,26319,309,35789,"California",105747,0.248886493233851,17367,0.407,24375,0.572
"7126","sutter",7126,"2021-04-30",356,59688,109,20797,234,35919,13,2972,145,9419,208,26527,157,35946,"California",105747,0.250853452107388,17367,0.407,24375,0.572
"7127","sutter",7127,"2021-05-01",294,59982,105,20902,148,36067,41,3013,124,9417,167,26694,165,36111,"California",105747,0.252432693126046,17367,0.407,24375,0.572
"7128","sutter",7128,"2021-05-02",78,60060,51,20953,25,36092,2,3015,45,9431,33,26727,47,36158,"California",105747,0.252744758716559,17367,0.407,24375,0.572
"7129","sutter",7129,"2021-05-03",171,60231,108,21061,53,36145,10,3025,70,9410,101,26828,80,36238,"California",105747,0.253699868554191,17367,0.407,24375,0.572
"7130","sutter",7130,"2021-05-04",485,60716,233,21294,189,36334,63,3088,208,9406,274,27102,270,36508,"California",105747,0.256290958608755,17367,0.407,24375,0.572
"7131","sutter",7131,"2021-05-05",527,61243,137,21431,382,36716,8,3096,154,9201,367,27469,162,36670,"California",105747,0.259761506236584,17367,0.407,24375,0.572
"7132","sutter",7132,"2021-05-06",368,61611,230,21661,117,36833,21,3117,164,9182,204,27673,185,36855,"California",105747,0.261690638977938,17367,0.407,24375,0.572
"7133","sutter",7133,"2021-05-07",404,62015,147,21808,234,37067,23,3140,147,9098,254,27927,170,37025,"California",105747,0.264092598371585,17367,0.407,24375,0.572
"7134","sutter",7134,"2021-05-08",201,62216,45,21853,149,37216,7,3147,107,9119,93,28020,114,37139,"California",105747,0.26497205594485,17367,0.407,24375,0.572
"7135","tehama",7135,"2020-12-15",1,1,1,1,0,0,0,0,1,1,0,0,1,1,"California",65885,0,8911,0.31,19141,0.666
"7136","tehama",7136,"2020-12-16",2,3,2,3,0,0,0,0,2,3,0,0,2,3,"California",65885,0,8911,0.31,19141,0.666
"7137","tehama",7137,"2020-12-17",12,15,12,15,0,0,0,0,12,15,0,0,12,15,"California",65885,0,8911,0.31,19141,0.666
"7138","tehama",7138,"2020-12-18",2,17,2,17,0,0,0,0,3,18,0,0,3,18,"California",65885,0,8911,0.31,19141,0.666
"7139","tehama",7139,"2020-12-21",33,50,33,50,0,0,0,0,33,51,0,0,33,51,"California",65885,0,8911,0.31,19141,0.666
"7140","tehama",7140,"2020-12-22",68,118,62,112,6,6,0,0,68,119,0,0,68,119,"California",65885,0,8911,0.31,19141,0.666
"7141","tehama",7141,"2020-12-23",48,166,40,152,8,14,0,0,48,167,0,0,48,167,"California",65885,0,8911,0.31,19141,0.666
"7142","tehama",7142,"2020-12-24",5,171,3,155,2,16,0,0,5,172,0,0,5,172,"California",65885,0,8911,0.31,19141,0.666
"7143","tehama",7143,"2020-12-26",3,174,2,157,1,17,0,0,3,175,0,0,3,175,"California",65885,0,8911,0.31,19141,0.666
"7144","tehama",7144,"2020-12-27",2,176,2,159,0,17,0,0,2,177,0,0,2,177,"California",65885,0,8911,0.31,19141,0.666
"7145","tehama",7145,"2020-12-28",56,232,43,202,13,30,0,0,56,233,0,0,56,233,"California",65885,0,8911,0.31,19141,0.666
"7146","tehama",7146,"2020-12-29",31,263,31,233,0,30,0,0,31,264,0,0,31,264,"California",65885,0,8911,0.31,19141,0.666
"7147","tehama",7147,"2020-12-30",54,317,38,271,16,46,0,0,53,317,0,0,53,317,"California",65885,0,8911,0.31,19141,0.666
"7148","tehama",7148,"2020-12-31",14,331,4,275,10,56,0,0,14,331,0,0,14,331,"California",65885,0,8911,0.31,19141,0.666
"7149","tehama",7149,"2021-01-01",2,333,0,275,2,58,0,0,2,333,0,0,2,333,"California",65885,0,8911,0.31,19141,0.666
"7150","tehama",7150,"2021-01-04",32,365,9,284,23,81,0,0,32,365,0,0,32,365,"California",65885,0,8911,0.31,19141,0.666
"7151","tehama",7151,"2021-01-05",70,435,43,327,27,108,0,0,67,429,3,3,67,432,"California",65885,4.55338847992715e-05,8911,0.31,19141,0.666
"7152","tehama",7152,"2021-01-06",71,506,21,348,50,158,0,0,62,483,8,11,62,494,"California",65885,0.000166957577597329,8911,0.31,19141,0.666
"7153","tehama",7153,"2021-01-07",57,563,7,355,50,208,0,0,56,538,1,12,56,550,"California",65885,0.000182135539197086,8911,0.31,19141,0.666
"7154","tehama",7154,"2021-01-08",33,596,24,379,9,217,0,0,28,561,5,17,28,578,"California",65885,0.000258025347195872,8911,0.31,19141,0.666
"7155","tehama",7155,"2021-01-09",7,603,5,384,2,219,0,0,5,564,2,19,5,583,"California",65885,0.000288381270395386,8911,0.31,19141,0.666
"7156","tehama",7156,"2021-01-10",1,604,0,384,1,220,0,0,1,565,0,19,1,584,"California",65885,0.000288381270395386,8911,0.31,19141,0.666
"7157","tehama",7157,"2021-01-11",48,652,46,430,2,222,0,0,15,547,33,52,15,599,"California",65885,0.000789254003187372,8911,0.31,19141,0.666
"7158","tehama",7158,"2021-01-12",116,768,96,526,20,242,0,0,71,573,45,97,71,670,"California",65885,0.00147226227517644,8911,0.31,19141,0.666
"7159","tehama",7159,"2021-01-13",73,841,55,581,18,260,0,0,27,554,46,143,27,697,"California",65885,0.00217044850876527,8911,0.31,19141,0.666
"7160","tehama",7160,"2021-01-14",225,1066,50,631,175,435,0,0,223,775,2,145,223,920,"California",65885,0.00220080443196479,8911,0.31,19141,0.666
"7161","tehama",7161,"2021-01-15",247,1313,74,705,173,608,0,0,243,1014,4,149,243,1163,"California",65885,0.00226151627836382,8911,0.31,19141,0.666
"7162","tehama",7162,"2021-01-16",272,1585,27,732,245,853,0,0,269,1280,3,152,269,1432,"California",65885,0.00230705016316309,8911,0.31,19141,0.666
"7163","tehama",7163,"2021-01-17",13,1598,9,741,4,857,0,0,11,1289,2,154,11,1443,"California",65885,0.0023374060863626,8911,0.31,19141,0.666
"7164","tehama",7164,"2021-01-18",10,1608,6,747,4,861,0,0,5,1289,5,159,5,1448,"California",65885,0.00241329589436139,8911,0.31,19141,0.666
"7165","tehama",7165,"2021-01-19",288,1896,62,809,226,1087,0,0,233,1467,55,214,233,1681,"California",65885,0.00324808378234803,8911,0.31,19141,0.666
"7166","tehama",7166,"2021-01-20",301,2197,87,896,214,1301,0,0,251,1669,49,263,251,1932,"California",65885,0.00399180390073613,8911,0.31,19141,0.666
"7167","tehama",7167,"2021-01-21",214,2411,11,907,203,1504,0,0,204,1863,10,273,204,2136,"California",65885,0.0041435835167337,8911,0.31,19141,0.666
"7168","tehama",7168,"2021-01-22",223,2634,21,928,202,1706,0,0,220,2080,3,276,220,2356,"California",65885,0.00418911740153297,8911,0.31,19141,0.666
"7169","tehama",7169,"2021-01-23",261,2895,10,938,251,1957,0,0,260,2339,1,277,260,2616,"California",65885,0.00420429536313273,8911,0.31,19141,0.666
"7170","tehama",7170,"2021-01-25",32,2927,14,952,18,1975,0,0,14,2335,18,295,14,2630,"California",65885,0.00447749867192836,8911,0.31,19141,0.666
"7171","tehama",7171,"2021-01-26",323,3250,42,994,281,2256,0,0,286,2584,37,332,286,2916,"California",65885,0.00503908325111938,8911,0.31,19141,0.666
"7172","tehama",7172,"2021-01-27",299,3549,21,1015,278,2534,0,0,279,2843,20,352,279,3195,"California",65885,0.00534264248311452,8911,0.31,19141,0.666
"7173","tehama",7173,"2021-01-28",340,3889,29,1044,311,2845,0,0,325,3153,15,367,325,3520,"California",65885,0.00557031190711087,8911,0.31,19141,0.666
"7174","tehama",7174,"2021-01-29",321,4210,19,1063,302,3147,0,0,304,3440,17,384,304,3824,"California",65885,0.00582833725430675,8911,0.31,19141,0.666
"7175","tehama",7175,"2021-01-30",103,4313,2,1065,101,3248,0,0,102,3541,1,385,102,3926,"California",65885,0.0058435152159065,8911,0.31,19141,0.666
"7176","tehama",7176,"2021-01-31",1,4314,0,1065,1,3249,0,0,1,3542,0,385,1,3927,"California",65885,0.0058435152159065,8911,0.31,19141,0.666
"7177","tehama",7177,"2021-02-01",78,4392,22,1087,56,3305,0,0,36,3536,42,427,36,3963,"California",65885,0.0064809896030963,8911,0.31,19141,0.666
"7178","tehama",7178,"2021-02-02",347,4739,63,1150,284,3589,0,0,250,3692,94,521,250,4213,"California",65885,0.00790771799347348,8911,0.31,19141,0.666
"7179","tehama",7179,"2021-02-03",387,5126,12,1162,375,3964,0,0,343,3991,44,565,343,4556,"California",65885,0.00857554830386279,8911,0.31,19141,0.666
"7180","tehama",7180,"2021-02-04",475,5601,98,1260,377,4341,0,0,396,4309,79,644,397,4953,"California",65885,0.00977460727024361,8911,0.31,19141,0.666
"7181","tehama",7181,"2021-02-05",173,5774,73,1333,100,4441,0,0,111,4358,62,706,111,5064,"California",65885,0.0107156408894286,8911,0.31,19141,0.666
"7182","tehama",7182,"2021-02-06",28,5802,13,1346,15,4456,0,0,16,4362,12,718,16,5080,"California",65885,0.0108977764286256,8911,0.31,19141,0.666
"7183","tehama",7183,"2021-02-07",5,5807,4,1350,1,4457,0,0,2,4361,3,721,2,5082,"California",65885,0.0109433103134249,8911,0.31,19141,0.666
"7184","tehama",7184,"2021-02-08",36,5843,14,1364,22,4479,0,0,27,4379,9,730,27,5109,"California",65885,0.0110799119678227,8911,0.31,19141,0.666
"7185","tehama",7185,"2021-02-09",78,5921,34,1398,44,4523,0,0,44,4389,34,764,44,5153,"California",65885,0.0115959626622145,8911,0.31,19141,0.666
"7186","tehama",7186,"2021-02-10",233,6154,62,1460,171,4694,0,0,157,4470,76,840,157,5310,"California",65885,0.012749487743796,8911,0.31,19141,0.666
"7187","tehama",7187,"2021-02-11",222,6376,16,1476,206,4900,0,0,82,4414,138,978,82,5392,"California",65885,0.0148440464445625,8911,0.31,19141,0.666
"7188","tehama",7188,"2021-02-12",364,6740,65,1541,299,5199,0,0,174,4398,190,1168,174,5566,"California",65885,0.0177278591485164,8911,0.31,19141,0.666
"7189","tehama",7189,"2021-02-13",386,7126,13,1554,373,5572,0,0,147,4306,239,1407,147,5713,"California",65885,0.0213553919708583,8911,0.31,19141,0.666
"7190","tehama",7190,"2021-02-14",33,7159,0,1554,33,5605,0,0,32,4337,1,1408,32,5745,"California",65885,0.0213705699324581,8911,0.31,19141,0.666
"7191","tehama",7191,"2021-02-15",51,7210,9,1563,42,5647,0,0,45,4376,6,1414,45,5790,"California",65885,0.0214616377020566,8911,0.31,19141,0.666
"7192","tehama",7192,"2021-02-16",242,7452,16,1579,226,5873,0,0,60,4254,182,1596,60,5850,"California",65885,0.0242240267132124,8911,0.31,19141,0.666
"7193","tehama",7193,"2021-02-17",280,7732,12,1591,268,6141,0,0,54,4082,226,1822,54,5904,"California",65885,0.0276542460347575,8911,0.31,19141,0.666
"7194","tehama",7194,"2021-02-18",368,8100,32,1623,336,6477,0,0,144,4002,224,2046,144,6048,"California",65885,0.0310541094331031,8911,0.31,19141,0.666
"7195","tehama",7195,"2021-02-19",213,8313,18,1641,195,6672,0,0,42,3873,171,2217,42,6090,"California",65885,0.0336495408666616,8911,0.31,19141,0.666
"7196","tehama",7196,"2021-02-20",271,8584,6,1647,265,6937,0,0,26,3654,245,2462,26,6116,"California",65885,0.0373681414586021,8911,0.31,19141,0.666
"7197","tehama",7197,"2021-02-22",37,8621,13,1660,24,6961,0,0,24,3665,13,2475,24,6140,"California",65885,0.037565454959399,8911,0.31,19141,0.666
"7198","tehama",7198,"2021-02-23",46,8667,19,1679,27,6988,0,0,26,3671,20,2495,26,6166,"California",65885,0.0378690141913941,8911,0.31,19141,0.666
"7199","tehama",7199,"2021-02-24",298,8965,12,1691,286,7274,0,0,26,3425,272,2767,26,6192,"California",65885,0.041997419746528,8911,0.31,19141,0.666
"7200","tehama",7200,"2021-02-25",377,9342,61,1752,316,7590,0,0,38,3124,339,3106,38,6230,"California",65885,0.0471427487288457,8911,0.31,19141,0.666
"7201","tehama",7201,"2021-02-26",455,9797,19,1771,436,8026,0,0,70,2809,385,3491,70,6300,"California",65885,0.0529862639447522,8911,0.31,19141,0.666
"7202","tehama",7202,"2021-02-27",294,10091,5,1776,289,8315,0,0,34,2583,260,3751,34,6334,"California",65885,0.0569325339606891,8911,0.31,19141,0.666
"7203","tehama",7203,"2021-02-28",23,10114,2,1778,21,8336,0,0,20,2600,3,3754,20,6354,"California",65885,0.0569780678454884,8911,0.31,19141,0.666
"7204","tehama",7204,"2021-03-01",65,10179,8,1786,57,8393,0,0,31,2597,34,3788,31,6385,"California",65885,0.0574941185398801,8911,0.31,19141,0.666
"7205","tehama",7205,"2021-03-02",131,10310,18,1804,113,8506,0,0,30,2526,101,3889,30,6415,"California",65885,0.0590270926614556,8911,0.31,19141,0.666
"7206","tehama",7206,"2021-03-03",146,10456,33,1837,113,8619,0,0,47,2474,99,3988,47,6462,"California",65885,0.0605297108598315,8911,0.31,19141,0.666
"7207","tehama",7207,"2021-03-04",620,11076,36,1873,584,9203,0,0,222,2305,391,4379,222,6684,"California",65885,0.0664642938453366,8911,0.31,19141,0.666
"7208","tehama",7208,"2021-03-05",396,11472,18,1891,378,9581,0,0,215,2340,180,4559,215,6899,"California",65885,0.0691963269332929,8911,0.31,19141,0.666
"7209","tehama",7209,"2021-03-06",299,11771,17,1908,282,9863,0,0,81,2205,217,4776,82,6981,"California",65885,0.0724899446004402,8911,0.31,19141,0.666
"7210","tehama",7210,"2021-03-07",5,11776,1,1909,4,9867,0,0,3,2207,1,4777,3,6984,"California",65885,0.0725051225620399,8911,0.31,19141,0.666
"7211","tehama",7211,"2021-03-08",58,11834,12,1921,31,9898,15,15,27,2219,30,4807,42,7026,"California",65885,0.0729604614100326,8911,0.31,19141,0.666
"7212","tehama",7212,"2021-03-09",364,12198,8,1929,337,10235,19,34,309,2492,55,4862,328,7354,"California",65885,0.0737952492980193,8911,0.31,19141,0.666
"7213","tehama",7213,"2021-03-10",351,12549,12,1941,318,10553,21,55,69,2301,281,5143,90,7444,"California",65885,0.078060256507551,8911,0.31,19141,0.666
"7214","tehama",7214,"2021-03-11",486,13035,17,1958,423,10976,46,101,343,2547,143,5286,389,7833,"California",65885,0.0802307050163163,8911,0.31,19141,0.666
"7215","tehama",7215,"2021-03-12",304,13339,19,1977,220,11196,65,166,179,2666,125,5411,244,8077,"California",65885,0.082127950216286,8911,0.31,19141,0.666
"7216","tehama",7216,"2021-03-13",45,13384,8,1985,31,11227,6,172,6,2639,39,5450,12,8089,"California",65885,0.0827198907186765,8911,0.31,19141,0.666
"7217","tehama",7217,"2021-03-14",51,13435,3,1988,37,11264,11,183,10,2619,41,5491,21,8110,"California",65885,0.0833421871442665,8911,0.31,19141,0.666
"7218","tehama",7218,"2021-03-15",151,13586,21,2009,110,11374,20,203,84,2656,67,5558,104,8214,"California",65885,0.0843591105714502,8911,0.31,19141,0.666
"7219","tehama",7219,"2021-03-16",412,13998,14,2023,360,11734,38,241,311,2905,100,5658,349,8563,"California",65885,0.085876906731426,8911,0.31,19141,0.666
"7220","tehama",7220,"2021-03-17",422,14420,22,2045,368,12102,32,273,337,3191,83,5741,369,8932,"California",65885,0.0871366775442058,8911,0.31,19141,0.666
"7221","tehama",7221,"2021-03-18",489,14909,26,2071,439,12541,24,297,310,3348,177,5918,334,9266,"California",65885,0.0898231767473628,8911,0.31,19141,0.666
"7222","tehama",7222,"2021-03-19",318,15227,23,2094,282,12823,13,310,276,3595,42,5960,289,9555,"California",65885,0.0904606511345526,8911,0.31,19141,0.666
"7223","tehama",7223,"2021-03-20",40,15267,8,2102,30,12853,2,312,28,3613,12,5972,30,9585,"California",65885,0.0906427866737497,8911,0.31,19141,0.666
"7224","tehama",7224,"2021-03-21",12,15279,5,2107,7,12860,0,312,12,3625,0,5972,12,9597,"California",65885,0.0906427866737497,8911,0.31,19141,0.666
"7225","tehama",7225,"2021-03-22",90,15369,7,2114,66,12926,17,329,49,3650,41,6013,66,9663,"California",65885,0.0912650830993398,8911,0.31,19141,0.666
"7226","tehama",7226,"2021-03-23",87,15456,26,2140,54,12980,7,336,68,3706,19,6032,75,9738,"California",65885,0.0915534643697351,8911,0.31,19141,0.666
"7227","tehama",7227,"2021-03-24",86,15542,16,2156,68,13048,2,338,55,3732,31,6063,57,9795,"California",65885,0.0920239811793276,8911,0.31,19141,0.666
"7228","tehama",7228,"2021-03-25",517,16059,353,2509,151,13199,13,351,468,4165,48,6111,481,10276,"California",65885,0.092752523336116,8911,0.31,19141,0.666
"7229","tehama",7229,"2021-03-26",506,16565,398,2907,96,13295,12,363,431,4533,75,6186,443,10719,"California",65885,0.0938908704560977,8911,0.31,19141,0.666
"7230","tehama",7230,"2021-03-27",451,17016,359,3266,67,13362,25,388,384,4876,66,6252,409,11128,"California",65885,0.0948926159216817,8911,0.31,19141,0.666
"7231","tehama",7231,"2021-03-28",34,17050,13,3279,21,13383,0,388,22,4886,12,6264,22,11150,"California",65885,0.0950747514608788,8911,0.31,19141,0.666
"7232","tehama",7232,"2021-03-29",122,17172,31,3310,90,13473,1,389,78,4920,44,6308,78,11228,"California",65885,0.0957425817712681,8911,0.31,19141,0.666
"7233","tehama",7233,"2021-03-30",373,17545,222,3532,149,13622,2,391,255,5059,118,6426,257,11485,"California",65885,0.0975335812400395,8911,0.31,19141,0.666
"7234","tehama",7234,"2021-03-31",397,17942,296,3828,98,13720,3,394,325,5315,71,6497,327,11812,"California",65885,0.0986112165136222,8911,0.31,19141,0.666
"7235","tehama",7235,"2021-04-01",525,18467,246,4074,273,13993,6,400,392,5580,133,6630,398,12210,"California",65885,0.10062988540639,8911,0.31,19141,0.666
"7236","tehama",7236,"2021-04-02",454,18921,215,4289,233,14226,6,406,269,5670,184,6814,274,12484,"California",65885,0.103422630340745,8911,0.31,19141,0.666
"7237","tehama",7237,"2021-04-03",61,18982,3,4292,53,14279,5,411,30,5674,31,6845,35,12519,"California",65885,0.103893147150338,8911,0.31,19141,0.666
"7238","tehama",7238,"2021-04-04",34,19016,6,4298,27,14306,1,412,22,5685,12,6857,23,12542,"California",65885,0.104075282689535,8911,0.31,19141,0.666
"7239","tehama",7239,"2021-04-05",115,19131,21,4319,68,14374,26,438,60,5716,55,6912,86,12628,"California",65885,0.104910070577521,8911,0.31,19141,0.666
"7240","tehama",7240,"2021-04-06",490,19621,110,4429,329,14703,51,489,140,5557,350,7262,191,12819,"California",65885,0.110222357137436,8911,0.31,19141,0.666
"7241","tehama",7241,"2021-04-07",419,20040,282,4711,93,14796,44,533,304,5790,114,7376,347,13166,"California",65885,0.111952644759809,8911,0.31,19141,0.666
"7242","tehama",7242,"2021-04-08",600,20640,174,4885,388,15184,38,571,229,5687,370,7746,267,13433,"California",65885,0.117568490551719,8911,0.31,19141,0.666
"7243","tehama",7243,"2021-04-09",430,21070,193,5078,204,15388,33,604,215,5722,213,7959,248,13681,"California",65885,0.120801396372467,8911,0.31,19141,0.666
"7244","tehama",7244,"2021-04-10",72,21142,9,5087,37,15425,26,630,39,5754,33,7992,65,13746,"California",65885,0.121302269105259,8911,0.31,19141,0.666
"7245","tehama",7245,"2021-04-11",33,21175,7,5094,15,15440,11,641,8,5748,25,8017,19,13765,"California",65885,0.121681718145253,8911,0.31,19141,0.666
"7246","tehama",7246,"2021-04-12",113,21288,6,5100,88,15528,19,660,43,5740,70,8087,62,13827,"California",65885,0.122744175457236,8911,0.31,19141,0.666
"7247","tehama",7247,"2021-04-13",313,21601,61,5161,252,15780,0,660,65,5558,248,8335,66,13893,"California",65885,0.126508309933976,8911,0.31,19141,0.666
"7248","tehama",7248,"2021-04-14",475,22076,51,5212,424,16204,0,660,52,5188,422,8757,52,13945,"California",65885,0.132913409729073,8911,0.31,19141,0.666
"7249","tehama",7249,"2021-04-15",495,22571,191,5403,304,16508,0,660,84,4861,411,9168,84,14029,"California",65885,0.139151551946574,8911,0.31,19141,0.666
"7250","tehama",7250,"2021-04-16",587,23158,335,5738,252,16760,0,660,75,4424,512,9680,75,14104,"California",65885,0.146922668285649,8911,0.31,19141,0.666
"7251","tehama",7251,"2021-04-17",347,23505,268,6006,79,16839,0,660,41,4161,305,9985,42,14146,"California",65885,0.151551946573575,8911,0.31,19141,0.666
"7252","tehama",7252,"2021-04-18",16,23521,2,6008,14,16853,0,660,12,4169,4,9989,12,14158,"California",65885,0.151612658419974,8911,0.31,19141,0.666
"7253","tehama",7253,"2021-04-19",93,23614,7,6015,86,16939,0,660,40,4156,53,10042,40,14198,"California",65885,0.152417090384761,8911,0.31,19141,0.666
"7254","tehama",7254,"2021-04-20",500,24114,412,6427,88,17027,0,660,146,3952,352,10394,148,14346,"California",65885,0.157759732867876,8911,0.31,19141,0.666
"7255","tehama",7255,"2021-04-21",518,24632,444,6871,74,17101,0,660,168,3770,350,10744,168,14514,"California",65885,0.163072019427791,8911,0.31,19141,0.666
"7256","tehama",7256,"2021-04-22",514,25146,363,7234,151,17252,0,660,150,3557,363,11107,150,14664,"California",65885,0.168581619488503,8911,0.31,19141,0.666
"7257","tehama",7257,"2021-04-23",445,25591,347,7581,98,17350,0,660,204,3521,241,11348,205,14869,"California",65885,0.172239508234044,8911,0.31,19141,0.666
"7258","tehama",7258,"2021-04-24",104,25695,18,7599,86,17436,0,660,30,3477,74,11422,30,14899,"California",65885,0.173362677392426,8911,0.31,19141,0.666
"7259","tehama",7259,"2021-04-25",29,25724,18,7617,11,17447,0,660,11,3470,18,11440,11,14910,"California",65885,0.173635880701222,8911,0.31,19141,0.666
"7260","tehama",7260,"2021-04-26",72,25796,7,7624,65,17512,0,660,41,3481,30,11470,41,14951,"California",65885,0.174091219549215,8911,0.31,19141,0.666
"7261","tehama",7261,"2021-04-27",248,26044,203,7827,45,17557,0,660,91,3415,157,11627,91,15042,"California",65885,0.176474159520376,8911,0.31,19141,0.666
"7262","tehama",7262,"2021-04-28",395,26439,318,8145,60,17617,17,677,65,3167,330,11957,82,15124,"California",65885,0.181482886848296,8911,0.31,19141,0.666
"7263","tehama",7263,"2021-04-29",350,26789,171,8316,174,17791,5,682,67,2957,282,12239,72,15196,"California",65885,0.185763072019428,8911,0.31,19141,0.666
"7264","tehama",7264,"2021-04-30",324,27113,240,8556,78,17869,6,688,112,2863,212,12451,118,15314,"California",65885,0.188980799878576,8911,0.31,19141,0.666
"7265","tehama",7265,"2021-05-01",72,27185,4,8560,65,17934,3,691,14,2822,58,12509,17,15331,"California",65885,0.189861121651362,8911,0.31,19141,0.666
"7266","tehama",7266,"2021-05-02",46,27231,24,8584,10,17944,12,703,26,2840,20,12529,38,15369,"California",65885,0.190164680883357,8911,0.31,19141,0.666
"7267","tehama",7267,"2021-05-03",117,27348,41,8625,68,18012,8,711,62,2855,55,12584,70,15439,"California",65885,0.190999468771344,8911,0.31,19141,0.666
"7268","tehama",7268,"2021-05-04",153,27501,53,8678,93,18105,7,718,66,2841,87,12671,73,15512,"California",65885,0.192319951430523,8911,0.31,19141,0.666
"7269","tehama",7269,"2021-05-05",89,27590,22,8700,56,18161,11,729,40,2843,49,12720,51,15563,"California",65885,0.193063671548911,8911,0.31,19141,0.666
"7270","tehama",7270,"2021-05-06",163,27753,88,8788,57,18218,18,747,96,2890,67,12787,114,15677,"California",65885,0.194080594976095,8911,0.31,19141,0.666
"7271","tehama",7271,"2021-05-07",161,27914,69,8857,82,18300,10,757,43,2828,115,12902,53,15730,"California",65885,0.195826060560067,8911,0.31,19141,0.666
"7272","tehama",7272,"2021-05-08",47,27961,6,8863,40,18340,1,758,11,2804,36,12938,12,15742,"California",65885,0.196372467177658,8911,0.31,19141,0.666
"7273","trinity",7273,"2020-12-17",4,4,4,4,0,0,0,0,4,4,0,0,4,4,"California",13354,0,2851,0.456,3188,0.509
"7274","trinity",7274,"2020-12-18",2,6,2,6,0,0,0,0,2,6,0,0,2,6,"California",13354,0,2851,0.456,3188,0.509
"7275","trinity",7275,"2020-12-21",39,45,39,45,0,0,0,0,39,45,0,0,39,45,"California",13354,0,2851,0.456,3188,0.509
"7276","trinity",7276,"2020-12-22",5,50,5,50,0,0,0,0,5,50,0,0,5,50,"California",13354,0,2851,0.456,3188,0.509
"7277","trinity",7277,"2020-12-23",5,55,5,55,0,0,0,0,5,55,0,0,5,55,"California",13354,0,2851,0.456,3188,0.509
"7278","trinity",7278,"2020-12-28",30,85,30,85,0,0,0,0,30,85,0,0,30,85,"California",13354,0,2851,0.456,3188,0.509
"7279","trinity",7279,"2020-12-29",8,93,7,92,1,1,0,0,8,93,0,0,8,93,"California",13354,0,2851,0.456,3188,0.509
"7280","trinity",7280,"2020-12-30",10,103,8,100,2,3,0,0,10,103,0,0,10,103,"California",13354,0,2851,0.456,3188,0.509
"7281","trinity",7281,"2020-12-31",2,105,1,101,1,4,0,0,2,105,0,0,2,105,"California",13354,0,2851,0.456,3188,0.509
"7282","trinity",7282,"2021-01-04",28,133,0,101,28,32,0,0,27,132,0,0,27,132,"California",13354,0,2851,0.456,3188,0.509
"7283","trinity",7283,"2021-01-05",2,135,1,102,1,33,0,0,2,134,0,0,2,134,"California",13354,0,2851,0.456,3188,0.509
"7284","trinity",7284,"2021-01-06",24,159,4,106,20,53,0,0,20,150,4,4,20,154,"California",13354,0.000299535719634566,2851,0.456,3188,0.509
"7285","trinity",7285,"2021-01-08",49,208,2,108,47,100,0,0,48,196,2,6,48,202,"California",13354,0.00044930357945185,2851,0.456,3188,0.509
"7286","trinity",7286,"2021-01-11",42,250,39,147,3,103,0,0,4,162,38,44,4,206,"California",13354,0.00329489291598023,2851,0.456,3188,0.509
"7287","trinity",7287,"2021-01-12",9,259,7,154,2,105,0,0,4,161,5,49,4,210,"California",13354,0.00366931256552344,2851,0.456,3188,0.509
"7288","trinity",7288,"2021-01-13",7,266,4,158,3,108,0,0,4,162,3,52,4,214,"California",13354,0.00389396435524936,2851,0.456,3188,0.509
"7289","trinity",7289,"2021-01-14",4,270,1,159,3,111,0,0,4,166,0,52,4,218,"California",13354,0.00389396435524936,2851,0.456,3188,0.509
"7290","trinity",7290,"2021-01-15",4,274,0,159,4,115,0,0,4,170,0,52,4,222,"California",13354,0.00389396435524936,2851,0.456,3188,0.509
"7291","trinity",7291,"2021-01-16",4,278,0,159,4,119,0,0,4,174,0,52,4,226,"California",13354,0.00389396435524936,2851,0.456,3188,0.509
"7292","trinity",7292,"2021-01-18",31,309,31,190,0,119,0,0,1,145,30,82,1,227,"California",13354,0.00614048225250861,2851,0.456,3188,0.509
"7293","trinity",7293,"2021-01-19",96,405,14,204,82,201,0,0,82,213,14,96,82,309,"California",13354,0.00718885727122959,2851,0.456,3188,0.509
"7294","trinity",7294,"2021-01-20",19,424,3,207,16,217,0,0,17,228,2,98,17,326,"California",13354,0.00733862513104688,2851,0.456,3188,0.509
"7295","trinity",7295,"2021-01-21",17,441,7,214,10,227,0,0,17,245,0,98,17,343,"California",13354,0.00733862513104688,2851,0.456,3188,0.509
"7296","trinity",7296,"2021-01-22",5,446,1,215,4,231,0,0,5,250,0,98,5,348,"California",13354,0.00733862513104688,2851,0.456,3188,0.509
"7297","trinity",7297,"2021-01-23",7,453,3,218,4,235,0,0,7,257,0,98,7,355,"California",13354,0.00733862513104688,2851,0.456,3188,0.509
"7298","trinity",7298,"2021-01-25",14,467,1,219,13,248,0,0,13,269,1,99,13,368,"California",13354,0.00741350906095552,2851,0.456,3188,0.509
"7299","trinity",7299,"2021-01-26",10,477,1,220,9,257,0,0,9,277,1,100,9,377,"California",13354,0.00748839299086416,2851,0.456,3188,0.509
"7300","trinity",7300,"2021-01-27",12,489,0,220,12,269,0,0,12,289,0,100,12,389,"California",13354,0.00748839299086416,2851,0.456,3188,0.509
"7301","trinity",7301,"2021-01-28",13,502,3,223,10,279,0,0,10,296,3,103,10,399,"California",13354,0.00771304478059009,2851,0.456,3188,0.509
"7302","trinity",7302,"2021-01-29",3,505,1,224,2,281,0,0,2,297,1,104,2,401,"California",13354,0.00778792871049873,2851,0.456,3188,0.509
"7303","trinity",7303,"2021-01-30",12,517,11,235,1,282,0,0,12,309,0,104,12,413,"California",13354,0.00778792871049873,2851,0.456,3188,0.509
"7304","trinity",7304,"2021-02-01",2,519,1,236,1,283,0,0,1,309,1,105,1,414,"California",13354,0.00786281264040737,2851,0.456,3188,0.509
"7305","trinity",7305,"2021-02-02",13,532,3,239,10,293,0,0,13,322,0,105,13,427,"California",13354,0.00786281264040737,2851,0.456,3188,0.509
"7306","trinity",7306,"2021-02-03",6,538,1,240,5,298,0,0,3,322,3,108,3,430,"California",13354,0.00808746443013329,2851,0.456,3188,0.509
"7307","trinity",7307,"2021-02-04",42,580,32,272,10,308,0,0,35,350,7,115,35,465,"California",13354,0.00861165193949378,2851,0.456,3188,0.509
"7308","trinity",7308,"2021-02-05",350,930,0,272,350,658,0,0,320,640,30,145,320,785,"California",13354,0.010858169836753,2851,0.456,3188,0.509
"7309","trinity",7309,"2021-02-06",210,1140,5,277,205,863,0,0,203,836,7,152,203,988,"California",13354,0.0113823573461135,2851,0.456,3188,0.509
"7310","trinity",7310,"2021-02-07",1,1141,0,277,1,864,0,0,1,837,0,152,1,989,"California",13354,0.0113823573461135,2851,0.456,3188,0.509
"7311","trinity",7311,"2021-02-08",25,1166,0,277,25,889,0,0,15,842,10,162,15,1004,"California",13354,0.0121311966451999,2851,0.456,3188,0.509
"7312","trinity",7312,"2021-02-09",27,1193,2,279,25,914,0,0,11,837,16,178,11,1015,"California",13354,0.0133293395237382,2851,0.456,3188,0.509
"7313","trinity",7313,"2021-02-10",122,1315,10,289,112,1026,0,0,102,919,20,198,102,1117,"California",13354,0.014827018121911,2851,0.456,3188,0.509
"7314","trinity",7314,"2021-02-11",339,1654,2,291,337,1363,0,0,332,1244,7,205,332,1449,"California",13354,0.0153512056312715,2851,0.456,3188,0.509
"7315","trinity",7315,"2021-02-12",14,1668,6,297,8,1371,0,0,10,1250,4,209,10,1459,"California",13354,0.0156507413509061,2851,0.456,3188,0.509
"7316","trinity",7316,"2021-02-13",12,1680,5,302,7,1378,0,0,5,1248,7,216,5,1464,"California",13354,0.0161749288602666,2851,0.456,3188,0.509
"7317","trinity",7317,"2021-02-14",2,1682,2,304,0,1378,0,0,2,1250,0,216,2,1466,"California",13354,0.0161749288602666,2851,0.456,3188,0.509
"7318","trinity",7318,"2021-02-15",47,1729,0,304,47,1425,0,0,47,1297,0,216,47,1513,"California",13354,0.0161749288602666,2851,0.456,3188,0.509
"7319","trinity",7319,"2021-02-16",6,1735,2,306,4,1429,0,0,3,1297,3,219,3,1516,"California",13354,0.0163995806499925,2851,0.456,3188,0.509
"7320","trinity",7320,"2021-02-17",94,1829,2,308,92,1521,0,0,84,1371,10,229,84,1600,"California",13354,0.0171484199490789,2851,0.456,3188,0.509
"7321","trinity",7321,"2021-02-18",4,1833,0,308,4,1525,0,0,1,1369,3,232,1,1601,"California",13354,0.0173730717388049,2851,0.456,3188,0.509
"7322","trinity",7322,"2021-02-19",304,2137,2,310,302,1827,0,0,290,1645,14,246,290,1891,"California",13354,0.0184214467575258,2851,0.456,3188,0.509
"7323","trinity",7323,"2021-02-20",141,2278,14,324,127,1954,0,0,113,1730,28,274,113,2004,"California",13354,0.0205181967949678,2851,0.456,3188,0.509
"7324","trinity",7324,"2021-02-22",8,2286,0,324,8,1962,0,0,5,1732,3,277,5,2009,"California",13354,0.0207428485846937,2851,0.456,3188,0.509
"7325","trinity",7325,"2021-02-23",11,2297,4,328,7,1969,0,0,6,1733,5,282,6,2015,"California",13354,0.0211172682342369,2851,0.456,3188,0.509
"7326","trinity",7326,"2021-02-24",30,2327,8,336,22,1991,0,0,7,1717,23,305,7,2022,"California",13354,0.0228395986221357,2851,0.456,3188,0.509
"7327","trinity",7327,"2021-02-25",36,2363,23,359,13,2004,0,0,5,1691,31,336,5,2027,"California",13354,0.0251610004493036,2851,0.456,3188,0.509
"7328","trinity",7328,"2021-02-26",11,2374,1,360,10,2014,0,0,5,1690,6,342,5,2032,"California",13354,0.0256103040287554,2851,0.456,3188,0.509
"7329","trinity",7329,"2021-02-27",9,2383,7,367,2,2016,0,0,4,1689,5,347,4,2036,"California",13354,0.0259847236782986,2851,0.456,3188,0.509
"7330","trinity",7330,"2021-03-01",9,2392,0,367,9,2025,0,0,5,1690,4,351,5,2041,"California",13354,0.0262842593979332,2851,0.456,3188,0.509
"7331","trinity",7331,"2021-03-02",9,2401,3,370,6,2031,0,0,2,1685,7,358,2,2043,"California",13354,0.0268084469072937,2851,0.456,3188,0.509
"7332","trinity",7332,"2021-03-03",5,2406,0,370,5,2036,0,0,4,1688,1,359,4,2047,"California",13354,0.0268833308372023,2851,0.456,3188,0.509
"7333","trinity",7333,"2021-03-04",24,2430,19,389,5,2041,0,0,14,1692,10,369,14,2061,"California",13354,0.0276321701362888,2851,0.456,3188,0.509
"7334","trinity",7334,"2021-03-05",388,2818,1,390,387,2428,0,0,121,1550,263,632,121,2182,"California",13354,0.0473266437022615,2851,0.456,3188,0.509
"7335","trinity",7335,"2021-03-06",202,3020,7,397,195,2623,0,0,27,1402,175,807,27,2209,"California",13354,0.0604313314362738,2851,0.456,3188,0.509
"7336","trinity",7336,"2021-03-07",4,3024,3,400,1,2624,0,0,3,1404,1,808,3,2212,"California",13354,0.0605062153661824,2851,0.456,3188,0.509
"7337","trinity",7337,"2021-03-08",3,3027,0,400,2,2626,1,1,1,1404,2,810,2,2214,"California",13354,0.0606559832259997,2851,0.456,3188,0.509
"7338","trinity",7338,"2021-03-09",94,3121,0,400,92,2718,2,3,89,1490,5,815,91,2305,"California",13354,0.0610304028755429,2851,0.456,3188,0.509
"7339","trinity",7339,"2021-03-10",126,3247,3,403,120,2838,3,6,38,1443,88,903,41,2346,"California",13354,0.0676201887075034,2851,0.456,3188,0.509
"7340","trinity",7340,"2021-03-11",14,3261,4,407,8,2846,2,8,5,1441,9,912,7,2353,"California",13354,0.0682941440766811,2851,0.456,3188,0.509
"7341","trinity",7341,"2021-03-12",385,3646,5,412,374,3220,6,14,90,1242,295,1207,96,2449,"California",13354,0.0903849033997304,2851,0.456,3188,0.509
"7342","trinity",7342,"2021-03-13",13,3659,8,420,3,3223,2,16,8,1247,5,1212,10,2459,"California",13354,0.0907593230492736,2851,0.456,3188,0.509
"7343","trinity",7343,"2021-03-14",2,3661,0,420,2,3225,0,16,2,1249,0,1212,2,2461,"California",13354,0.0907593230492736,2851,0.456,3188,0.509
"7344","trinity",7344,"2021-03-15",67,3728,0,420,66,3291,1,17,14,1211,53,1265,15,2476,"California",13354,0.0947281713344316,2851,0.456,3188,0.509
"7345","trinity",7345,"2021-03-16",115,3843,7,427,108,3399,0,17,101,1298,14,1279,101,2577,"California",13354,0.0957765463531526,2851,0.456,3188,0.509
"7346","trinity",7346,"2021-03-17",100,3943,3,430,97,3496,0,17,26,1250,74,1353,26,2603,"California",13354,0.101317957166392,2851,0.456,3188,0.509
"7347","trinity",7347,"2021-03-18",10,3953,2,432,5,3501,3,20,5,1253,5,1358,8,2611,"California",13354,0.101692376815935,2851,0.456,3188,0.509
"7348","trinity",7348,"2021-03-19",459,4412,4,436,345,3846,110,130,36,976,423,1781,146,2757,"California",13354,0.133368279167291,2851,0.456,3188,0.509
"7349","trinity",7349,"2021-03-20",104,4516,7,443,97,3943,0,130,69,1011,34,1815,69,2826,"California",13354,0.135914332784185,2851,0.456,3188,0.509
"7350","trinity",7350,"2021-03-21",4,4520,0,443,3,3946,1,131,3,1014,1,1816,4,2830,"California",13354,0.135989216714093,2851,0.456,3188,0.509
"7351","trinity",7351,"2021-03-22",2,4522,0,443,2,3948,0,131,2,1016,0,1816,2,2832,"California",13354,0.135989216714093,2851,0.456,3188,0.509
"7352","trinity",7352,"2021-03-23",96,4618,2,445,94,4042,0,131,78,1076,18,1834,78,2910,"California",13354,0.137337127452449,2851,0.456,3188,0.509
"7353","trinity",7353,"2021-03-24",12,4630,1,446,11,4053,0,131,9,1082,3,1837,9,2919,"California",13354,0.137561779242175,2851,0.456,3188,0.509
"7354","trinity",7354,"2021-03-25",110,4740,8,454,96,4149,6,137,84,1146,26,1863,90,3009,"California",13354,0.139508761419799,2851,0.456,3188,0.509
"7355","trinity",7355,"2021-03-26",85,4825,8,462,77,4226,0,137,78,1217,7,1870,78,3087,"California",13354,0.14003294892916,2851,0.456,3188,0.509
"7356","trinity",7356,"2021-03-27",18,4843,4,466,5,4231,9,146,7,1222,11,1881,16,3103,"California",13354,0.140856672158155,2851,0.456,3188,0.509
"7357","trinity",7357,"2021-03-28",5,4848,3,469,2,4233,0,146,1,1219,4,1885,1,3104,"California",13354,0.141156207877789,2851,0.456,3188,0.509
"7358","trinity",7358,"2021-03-29",5,4853,0,469,5,4238,0,146,2,1218,3,1888,2,3106,"California",13354,0.141380859667515,2851,0.456,3188,0.509
"7359","trinity",7359,"2021-03-30",77,4930,5,474,72,4310,0,146,67,1275,10,1898,67,3173,"California",13354,0.142129698966602,2851,0.456,3188,0.509
"7360","trinity",7360,"2021-03-31",56,4986,5,479,19,4329,32,178,21,1292,35,1933,52,3225,"California",13354,0.144750636513404,2851,0.456,3188,0.509
"7361","trinity",7361,"2021-04-01",41,5027,11,490,19,4348,11,189,21,1304,20,1953,32,3257,"California",13354,0.146248315111577,2851,0.456,3188,0.509
"7362","trinity",7362,"2021-04-02",242,5269,5,495,163,4511,74,263,72,1281,169,2122,146,3403,"California",13354,0.158903699266137,2851,0.456,3188,0.509
"7363","trinity",7363,"2021-04-03",18,5287,13,508,5,4516,0,263,8,1279,10,2132,8,3411,"California",13354,0.159652538565224,2851,0.456,3188,0.509
"7364","trinity",7364,"2021-04-04",10,5297,8,516,2,4518,0,263,8,1285,2,2134,8,3419,"California",13354,0.159802306425041,2851,0.456,3188,0.509
"7365","trinity",7365,"2021-04-05",59,5356,6,522,52,4570,1,264,55,1337,4,2138,56,3475,"California",13354,0.160101842144676,2851,0.456,3188,0.509
"7366","trinity",7366,"2021-04-06",115,5471,15,537,97,4667,3,267,27,1279,88,2226,30,3505,"California",13354,0.166691627976636,2851,0.456,3188,0.509
"7367","trinity",7367,"2021-04-07",22,5493,12,549,5,4672,5,272,14,1290,8,2234,19,3524,"California",13354,0.167290699415905,2851,0.456,3188,0.509
"7368","trinity",7368,"2021-04-08",87,5580,10,559,75,4747,2,274,50,1305,37,2271,52,3576,"California",13354,0.170061404822525,2851,0.456,3188,0.509
"7369","trinity",7369,"2021-04-09",168,5748,20,579,143,4890,5,279,89,1320,79,2350,94,3670,"California",13354,0.175977235285308,2851,0.456,3188,0.509
"7370","trinity",7370,"2021-04-10",11,5759,7,586,4,4894,0,279,10,1329,1,2351,10,3680,"California",13354,0.176052119215216,2851,0.456,3188,0.509
"7371","trinity",7371,"2021-04-11",9,5768,5,591,2,4896,2,281,4,1330,5,2356,6,3686,"California",13354,0.17642653886476,2851,0.456,3188,0.509
"7372","trinity",7372,"2021-04-12",77,5845,5,596,71,4967,1,282,64,1382,12,2368,64,3750,"California",13354,0.177325146023663,2851,0.456,3188,0.509
"7373","trinity",7373,"2021-04-13",97,5942,5,601,92,5059,0,282,10,1305,87,2455,10,3760,"California",13354,0.183840047925715,2851,0.456,3188,0.509
"7374","trinity",7374,"2021-04-14",10,5952,5,606,5,5064,0,282,6,1307,4,2459,6,3766,"California",13354,0.18413958364535,2851,0.456,3188,0.509
"7375","trinity",7375,"2021-04-15",43,5995,10,616,33,5097,0,282,14,1292,29,2488,14,3780,"California",13354,0.1863112176127,2851,0.456,3188,0.509
"7376","trinity",7376,"2021-04-16",143,6138,12,628,131,5228,0,282,71,1291,72,2560,71,3851,"California",13354,0.191702860566123,2851,0.456,3188,0.509
"7377","trinity",7377,"2021-04-17",11,6149,5,633,6,5234,0,282,9,1298,2,2562,9,3860,"California",13354,0.19185262842594,2851,0.456,3188,0.509
"7378","trinity",7378,"2021-04-18",2,6151,1,634,1,5235,0,282,0,1296,2,2564,0,3860,"California",13354,0.192002396285757,2851,0.456,3188,0.509
"7379","trinity",7379,"2021-04-19",5,6156,2,636,3,5238,0,282,4,1299,1,2565,4,3864,"California",13354,0.192077280215666,2851,0.456,3188,0.509
"7380","trinity",7380,"2021-04-20",92,6248,8,644,84,5322,0,282,20,1247,72,2637,20,3884,"California",13354,0.197468923169088,2851,0.456,3188,0.509
"7381","trinity",7381,"2021-04-21",22,6270,9,653,13,5335,0,282,9,1243,13,2650,9,3893,"California",13354,0.1984424142579,2851,0.456,3188,0.509
"7382","trinity",7382,"2021-04-22",91,6361,5,658,86,5421,0,282,14,1180,77,2727,14,3907,"California",13354,0.204208476860866,2851,0.456,3188,0.509
"7383","trinity",7383,"2021-04-23",182,6543,6,664,176,5597,0,282,113,1224,69,2796,113,4020,"California",13354,0.209375468024562,2851,0.456,3188,0.509
"7384","trinity",7384,"2021-04-24",20,6563,13,677,7,5604,0,282,5,1214,15,2811,5,4025,"California",13354,0.210498726973192,2851,0.456,3188,0.509
"7385","trinity",7385,"2021-04-25",10,6573,9,686,1,5605,0,282,3,1211,6,2817,3,4028,"California",13354,0.210948030552643,2851,0.456,3188,0.509
"7386","trinity",7386,"2021-04-26",45,6618,6,692,39,5644,0,282,40,1246,5,2822,40,4068,"California",13354,0.211322450202187,2851,0.456,3188,0.509
"7387","trinity",7387,"2021-04-27",85,6703,7,699,78,5722,0,282,22,1205,63,2885,22,4090,"California",13354,0.216040137786431,2851,0.456,3188,0.509
"7388","trinity",7388,"2021-04-28",33,6736,11,710,22,5744,0,282,12,1196,21,2906,12,4102,"California",13354,0.217612700314513,2851,0.456,3188,0.509
"7389","trinity",7389,"2021-04-29",34,6770,13,723,21,5765,0,282,12,1186,22,2928,12,4114,"California",13354,0.219260146772503,2851,0.456,3188,0.509
"7390","trinity",7390,"2021-04-30",26,6796,20,743,6,5771,0,282,8,1176,18,2946,8,4122,"California",13354,0.220608057510858,2851,0.456,3188,0.509
"7391","trinity",7391,"2021-05-01",14,6810,8,751,1,5772,5,287,4,1175,10,2956,9,4131,"California",13354,0.221356896809945,2851,0.456,3188,0.509
"7392","trinity",7392,"2021-05-02",8,6818,5,756,1,5773,2,289,2,1173,6,2962,4,4135,"California",13354,0.221806200389396,2851,0.456,3188,0.509
"7393","trinity",7393,"2021-05-03",58,6876,13,769,44,5817,1,290,10,1136,48,3010,11,4146,"California",13354,0.225400629025011,2851,0.456,3188,0.509
"7394","trinity",7394,"2021-05-04",21,6897,12,781,8,5825,1,291,10,1136,11,3021,11,4157,"California",13354,0.226224352254006,2851,0.456,3188,0.509
"7395","trinity",7395,"2021-05-05",11,6908,6,787,5,5830,0,291,4,1133,7,3028,4,4161,"California",13354,0.226748539763367,2851,0.456,3188,0.509
"7396","trinity",7396,"2021-05-06",73,6981,9,796,62,5892,2,293,16,1094,57,3085,18,4179,"California",13354,0.231016923768159,2851,0.456,3188,0.509
"7397","trinity",7397,"2021-05-07",168,7149,9,805,125,6017,34,327,11,982,157,3242,45,4224,"California",13354,0.242773700763816,2851,0.456,3188,0.509
"7398","trinity",7398,"2021-05-08",7,7156,3,808,4,6021,0,327,2,979,5,3247,2,4226,"California",13354,0.243148120413359,2851,0.456,3188,0.509
"7399","tulare",7399,"2020-12-15",1,1,1,1,0,0,0,0,1,1,0,0,1,1,"California",484423,0,66105,0.45,77579,0.528
"7400","tulare",7400,"2020-12-16",3,4,3,4,0,0,0,0,3,4,0,0,3,4,"California",484423,0,66105,0.45,77579,0.528
"7401","tulare",7401,"2020-12-17",110,114,110,114,0,0,0,0,110,114,0,0,110,114,"California",484423,0,66105,0.45,77579,0.528
"7402","tulare",7402,"2020-12-18",290,404,289,403,1,1,0,0,290,404,0,0,290,404,"California",484423,0,66105,0.45,77579,0.528
"7403","tulare",7403,"2020-12-19",327,731,327,730,0,1,0,0,327,731,0,0,327,731,"California",484423,0,66105,0.45,77579,0.528
"7404","tulare",7404,"2020-12-20",166,897,165,895,1,2,0,0,166,897,0,0,166,897,"California",484423,0,66105,0.45,77579,0.528
"7405","tulare",7405,"2020-12-21",423,1320,423,1318,0,2,0,0,443,1340,0,0,443,1340,"California",484423,0,66105,0.45,77579,0.528
"7406","tulare",7406,"2020-12-22",469,1789,467,1785,2,4,0,0,468,1808,0,0,468,1808,"California",484423,0,66105,0.45,77579,0.528
"7407","tulare",7407,"2020-12-23",327,2116,319,2104,8,12,0,0,325,2133,0,0,325,2133,"California",484423,0,66105,0.45,77579,0.528
"7408","tulare",7408,"2020-12-24",18,2134,16,2120,2,14,0,0,18,2151,0,0,18,2151,"California",484423,0,66105,0.45,77579,0.528
"7409","tulare",7409,"2020-12-26",8,2142,7,2127,1,15,0,0,8,2159,0,0,8,2159,"California",484423,0,66105,0.45,77579,0.528
"7410","tulare",7410,"2020-12-27",16,2158,12,2139,4,19,0,0,16,2175,0,0,16,2175,"California",484423,0,66105,0.45,77579,0.528
"7411","tulare",7411,"2020-12-28",481,2639,469,2608,12,31,0,0,480,2655,0,0,480,2655,"California",484423,0,66105,0.45,77579,0.528
"7412","tulare",7412,"2020-12-29",546,3185,478,3086,68,99,0,0,546,3201,0,0,546,3201,"California",484423,0,66105,0.45,77579,0.528
"7413","tulare",7413,"2020-12-30",474,3659,435,3521,39,138,0,0,474,3675,0,0,474,3675,"California",484423,0,66105,0.45,77579,0.528
"7414","tulare",7414,"2020-12-31",94,3753,22,3543,72,210,0,0,94,3769,0,0,94,3769,"California",484423,0,66105,0.45,77579,0.528
"7415","tulare",7415,"2021-01-01",2,3755,1,3544,1,211,0,0,2,3771,0,0,2,3771,"California",484423,0,66105,0.45,77579,0.528
"7416","tulare",7416,"2021-01-02",30,3785,17,3561,13,224,0,0,30,3801,0,0,30,3801,"California",484423,0,66105,0.45,77579,0.528
"7417","tulare",7417,"2021-01-03",23,3808,9,3570,14,238,0,0,23,3824,0,0,23,3824,"California",484423,0,66105,0.45,77579,0.528
"7418","tulare",7418,"2021-01-04",92,3900,16,3586,76,314,0,0,92,3916,0,0,92,3916,"California",484423,0,66105,0.45,77579,0.528
"7419","tulare",7419,"2021-01-05",460,4360,278,3864,182,496,0,0,458,4372,2,2,458,4374,"California",484423,4.12862312483098e-06,66105,0.45,77579,0.528
"7420","tulare",7420,"2021-01-06",864,5224,635,4499,229,725,0,0,854,5216,10,12,854,5228,"California",484423,2.47717387489859e-05,66105,0.45,77579,0.528
"7421","tulare",7421,"2021-01-07",781,6005,583,5082,198,923,0,0,673,5782,107,119,673,5901,"California",484423,0.000245653075927444,66105,0.45,77579,0.528
"7422","tulare",7422,"2021-01-08",1266,7271,574,5656,692,1615,0,0,928,6373,337,456,928,6829,"California",484423,0.000941326072461464,66105,0.45,77579,0.528
"7423","tulare",7423,"2021-01-09",741,8012,203,5859,538,2153,0,0,554,6740,187,643,554,7383,"California",484423,0.00132735233463316,66105,0.45,77579,0.528
"7424","tulare",7424,"2021-01-10",50,8062,44,5903,6,2159,0,0,11,6712,39,682,11,7394,"California",484423,0.00140786048556737,66105,0.45,77579,0.528
"7425","tulare",7425,"2021-01-11",1270,9332,769,6672,501,2660,0,0,834,7110,436,1118,834,8228,"California",484423,0.00230790032678052,66105,0.45,77579,0.528
"7426","tulare",7426,"2021-01-12",1404,10736,489,7161,915,3575,0,0,995,7698,408,1526,996,9224,"California",484423,0.00315013944424604,66105,0.45,77579,0.528
"7427","tulare",7427,"2021-01-13",437,11173,208,7369,229,3804,0,0,363,7987,74,1600,363,9587,"California",484423,0.00330289849986479,66105,0.45,77579,0.528
"7428","tulare",7428,"2021-01-14",491,11664,140,7509,351,4155,0,0,465,8437,15,1615,465,10052,"California",484423,0.00333386317330102,66105,0.45,77579,0.528
"7429","tulare",7429,"2021-01-15",1621,13285,153,7662,1468,5623,0,0,1612,10040,9,1624,1612,11664,"California",484423,0.00335244197736276,66105,0.45,77579,0.528
"7430","tulare",7430,"2021-01-16",1901,15186,114,7776,1787,7410,0,0,1887,11913,14,1638,1887,13551,"California",484423,0.00338134233923658,66105,0.45,77579,0.528
"7431","tulare",7431,"2021-01-17",141,15327,122,7898,19,7429,0,0,131,12034,10,1648,131,13682,"California",484423,0.00340198545486073,66105,0.45,77579,0.528
"7432","tulare",7432,"2021-01-18",692,16019,659,8557,33,7462,0,0,294,11930,398,2046,294,13976,"California",484423,0.0042235814567021,66105,0.45,77579,0.528
"7433","tulare",7433,"2021-01-19",1007,17026,684,9241,323,7785,0,0,579,12081,428,2474,579,14555,"California",484423,0.00510710680541593,66105,0.45,77579,0.528
"7434","tulare",7434,"2021-01-20",2425,19451,612,9853,1813,9598,0,0,2011,13703,389,2863,2011,16566,"California",484423,0.00591012400319555,66105,0.45,77579,0.528
"7435","tulare",7435,"2021-01-21",1550,21001,186,10039,1364,10962,0,0,1524,15206,21,2884,1524,18090,"California",484423,0.00595347454600628,66105,0.45,77579,0.528
"7436","tulare",7436,"2021-01-22",1059,22060,190,10229,869,11831,0,0,1034,16216,24,2908,1034,19124,"California",484423,0.00600301802350425,66105,0.45,77579,0.528
"7437","tulare",7437,"2021-01-23",438,22498,156,10385,282,12113,0,0,417,16612,21,2929,417,19541,"California",484423,0.00604636856631498,66105,0.45,77579,0.528
"7438","tulare",7438,"2021-01-24",30,22528,27,10412,3,12116,0,0,28,16638,2,2931,28,19569,"California",484423,0.00605049718943981,66105,0.45,77579,0.528
"7439","tulare",7439,"2021-01-25",1325,23853,979,11391,346,12462,0,0,1296,17905,29,2960,1296,20865,"California",484423,0.00611036222474986,66105,0.45,77579,0.528
"7440","tulare",7440,"2021-01-26",1499,25352,1100,12491,399,12861,0,0,1174,18755,324,3284,1174,22039,"California",484423,0.00677919917097248,66105,0.45,77579,0.528
"7441","tulare",7441,"2021-01-27",1501,26853,1071,13562,430,13291,0,0,924,19103,576,3860,924,22963,"California",484423,0.0079682426309238,66105,0.45,77579,0.528
"7442","tulare",7442,"2021-01-28",1203,28056,769,14331,434,13725,0,0,808,19516,395,4255,808,23771,"California",484423,0.00878364569807792,66105,0.45,77579,0.528
"7443","tulare",7443,"2021-01-29",1130,29186,720,15051,410,14135,0,0,820,20026,310,4565,820,24591,"California",484423,0.00942358228242672,66105,0.45,77579,0.528
"7444","tulare",7444,"2021-01-30",1674,30860,1580,16631,94,14229,0,0,1650,21653,24,4589,1651,26242,"California",484423,0.00947312575992469,66105,0.45,77579,0.528
"7445","tulare",7445,"2021-01-31",52,30912,47,16678,5,14234,0,0,49,21699,3,4592,49,26291,"California",484423,0.00947931869461194,66105,0.45,77579,0.528
"7446","tulare",7446,"2021-02-01",1185,32097,916,17594,269,14503,0,0,830,22175,354,4946,830,27121,"California",484423,0.010210084987707,66105,0.45,77579,0.528
"7447","tulare",7447,"2021-02-02",677,32774,328,17922,349,14852,0,0,445,22391,230,5176,446,27567,"California",484423,0.0106848766470626,66105,0.45,77579,0.528
"7448","tulare",7448,"2021-02-03",588,33362,262,18184,326,15178,0,0,336,22495,232,5408,336,27903,"California",484423,0.011163796929543,66105,0.45,77579,0.528
"7449","tulare",7449,"2021-02-04",552,33914,166,18350,386,15564,0,0,266,22477,285,5693,267,28170,"California",484423,0.0117521257248314,66105,0.45,77579,0.528
"7450","tulare",7450,"2021-02-05",1234,35148,237,18587,997,16561,0,0,416,22077,816,6509,416,28586,"California",484423,0.0134366039597624,66105,0.45,77579,0.528
"7451","tulare",7451,"2021-02-06",836,35984,158,18745,678,17239,0,0,268,21779,566,7075,268,28854,"California",484423,0.0146050043040896,66105,0.45,77579,0.528
"7452","tulare",7452,"2021-02-07",82,36066,70,18815,12,17251,0,0,23,21743,59,7134,23,28877,"California",484423,0.0147267986862721,66105,0.45,77579,0.528
"7453","tulare",7453,"2021-02-08",941,37007,328,19143,613,17864,0,0,244,21293,694,7828,244,29121,"California",484423,0.0161594309105885,66105,0.45,77579,0.528
"7454","tulare",7454,"2021-02-09",1409,38416,329,19472,1080,18944,0,0,362,20613,1042,8870,362,29483,"California",484423,0.0183104435586254,66105,0.45,77579,0.528
"7455","tulare",7455,"2021-02-10",2467,40883,1984,21456,483,19427,0,0,2067,22283,397,9267,2067,31550,"California",484423,0.0191299752489044,66105,0.45,77579,0.528
"7456","tulare",7456,"2021-02-11",1325,42208,377,21833,948,20375,0,0,906,22770,419,9686,906,32456,"California",484423,0.0199949217935565,66105,0.45,77579,0.528
"7457","tulare",7457,"2021-02-12",2780,44988,575,22408,2205,22580,0,0,1210,22417,1563,11249,1210,33666,"California",484423,0.0232214407656119,66105,0.45,77579,0.528
"7458","tulare",7458,"2021-02-13",2480,47468,157,22565,2323,24903,0,0,667,21275,1809,13058,667,34333,"California",484423,0.0269557803820215,66105,0.45,77579,0.528
"7459","tulare",7459,"2021-02-14",333,47801,36,22601,297,25200,0,0,300,21542,33,13091,300,34633,"California",484423,0.0270239026635812,66105,0.45,77579,0.528
"7460","tulare",7460,"2021-02-15",920,48721,294,22895,626,25826,0,0,663,21949,256,13347,663,35296,"California",484423,0.0275523664235596,66105,0.45,77579,0.528
"7461","tulare",7461,"2021-02-16",2834,51555,1597,24492,1237,27063,0,0,1078,21272,1755,15102,1078,36374,"California",484423,0.0311752332155988,66105,0.45,77579,0.528
"7462","tulare",7462,"2021-02-17",2698,54253,510,25002,2188,29251,0,0,461,19501,2232,17334,461,36835,"California",484423,0.0357827766229101,66105,0.45,77579,0.528
"7463","tulare",7463,"2021-02-18",2305,56558,456,25458,1849,31100,0,0,634,18472,1663,18997,634,37469,"California",484423,0.0392157267512071,66105,0.45,77579,0.528
"7464","tulare",7464,"2021-02-19",2298,58856,857,26315,1441,32541,0,0,944,18064,1352,20349,944,38413,"California",484423,0.0420066759835929,66105,0.45,77579,0.528
"7465","tulare",7465,"2021-02-20",2989,61845,1891,28206,1098,33639,0,0,1266,17612,1718,22067,1266,39679,"California",484423,0.0455531632478227,66105,0.45,77579,0.528
"7466","tulare",7466,"2021-02-21",94,61939,90,28296,4,33643,0,0,59,17636,35,22102,59,39738,"California",484423,0.0456254141525072,66105,0.45,77579,0.528
"7467","tulare",7467,"2021-02-22",1105,63044,700,28996,405,34048,0,0,210,16952,894,22996,210,39948,"California",484423,0.0474709086893067,66105,0.45,77579,0.528
"7468","tulare",7468,"2021-02-23",1947,64991,940,29936,1007,35055,0,0,1457,17920,489,23485,1457,41405,"California",484423,0.0484803570433278,66105,0.45,77579,0.528
"7469","tulare",7469,"2021-02-24",2476,67467,1551,31487,925,35980,0,0,2097,19640,378,23863,2098,43503,"California",484423,0.0492606668139209,66105,0.45,77579,0.528
"7470","tulare",7470,"2021-02-25",3486,70953,1951,33438,1535,37515,0,0,3071,22300,411,24274,3071,46574,"California",484423,0.0501090988660737,66105,0.45,77579,0.528
"7471","tulare",7471,"2021-02-26",3840,74793,1880,35318,1960,39475,0,0,3377,25216,461,24735,3377,49951,"California",484423,0.0510607464963472,66105,0.45,77579,0.528
"7472","tulare",7472,"2021-02-27",2901,77694,1394,36712,1507,40982,0,0,2768,27862,122,24857,2768,52719,"California",484423,0.0513125925069619,66105,0.45,77579,0.528
"7473","tulare",7473,"2021-02-28",1304,78998,1033,37745,271,41253,0,0,1284,29128,18,24875,1284,54003,"California",484423,0.0513497501150854,66105,0.45,77579,0.528
"7474","tulare",7474,"2021-03-01",1741,80739,773,38518,968,42221,0,0,1556,30501,183,25058,1556,55559,"California",484423,0.0517275191310074,66105,0.45,77579,0.528
"7475","tulare",7475,"2021-03-02",2689,83428,1194,39712,1495,43716,0,0,2520,32855,167,25225,2521,58080,"California",484423,0.0520722591619308,66105,0.45,77579,0.528
"7476","tulare",7476,"2021-03-03",3927,87355,2597,42309,1330,45046,0,0,1976,32885,1948,27173,1978,60058,"California",484423,0.0560935380855162,66105,0.45,77579,0.528
"7477","tulare",7477,"2021-03-04",2891,90246,1302,43611,1589,46635,0,0,2572,35141,316,27489,2572,62630,"California",484423,0.0567458605392395,66105,0.45,77579,0.528
"7478","tulare",7478,"2021-03-05",3295,93541,1699,45310,1581,48216,15,15,2787,37441,504,27993,2804,65434,"California",484423,0.0577862735666969,66105,0.45,77579,0.528
"7479","tulare",7479,"2021-03-06",3059,96600,1434,46744,1566,49782,59,74,2811,40064,245,28238,2868,68302,"California",484423,0.0582920298994887,66105,0.45,77579,0.528
"7480","tulare",7480,"2021-03-07",1092,97692,682,47426,389,50171,21,95,1052,41097,40,28278,1073,69375,"California",484423,0.0583746023619853,66105,0.45,77579,0.528
"7481","tulare",7481,"2021-03-08",1697,99389,1005,48431,523,50694,169,264,1378,42329,314,28592,1546,70921,"California",484423,0.0590227961925838,66105,0.45,77579,0.528
"7482","tulare",7482,"2021-03-09",3193,102582,2190,50621,856,51550,147,411,2796,44872,398,28990,2941,73862,"California",484423,0.0598443921944251,66105,0.45,77579,0.528
"7483","tulare",7483,"2021-03-10",2791,105373,1388,52009,1228,52778,175,586,2411,47085,371,29361,2584,76446,"California",484423,0.0606102517840813,66105,0.45,77579,0.528
"7484","tulare",7484,"2021-03-11",4141,109514,1965,53974,1876,54654,300,886,3204,49652,937,30298,3504,79950,"California",484423,0.0625445117180646,66105,0.45,77579,0.528
"7485","tulare",7485,"2021-03-12",4344,113858,2388,56362,1607,56261,349,1235,3073,51813,1263,31561,3424,83374,"California",484423,0.0651517372213953,66105,0.45,77579,0.528
"7486","tulare",7486,"2021-03-13",4005,117863,1849,58211,2051,58312,105,1340,3068,54055,931,32492,3173,86547,"California",484423,0.0670736112860042,66105,0.45,77579,0.528
"7487","tulare",7487,"2021-03-14",1802,119665,973,59184,609,58921,220,1560,1273,55019,528,33020,1492,88039,"California",484423,0.0681635677909596,66105,0.45,77579,0.528
"7488","tulare",7488,"2021-03-15",2738,122403,1619,60803,1004,59925,115,1675,1965,56329,771,33791,2081,90120,"California",484423,0.0697551520055819,66105,0.45,77579,0.528
"7489","tulare",7489,"2021-03-16",3420,125823,2115,62918,1228,61153,77,1752,1873,56738,1544,35335,1953,92073,"California",484423,0.0729424490579514,66105,0.45,77579,0.528
"7490","tulare",7490,"2021-03-17",4012,129835,2608,65526,1327,62480,77,1829,2270,57356,1736,37071,2354,94427,"California",484423,0.0765260939303047,66105,0.45,77579,0.528
"7491","tulare",7491,"2021-03-18",4599,134434,3351,68877,1175,63655,73,1902,2440,57718,2153,39224,2515,96942,"California",484423,0.0809705567241853,66105,0.45,77579,0.528
"7492","tulare",7492,"2021-03-19",5065,139499,3319,72196,1551,65206,195,2097,2716,58300,2331,41555,2913,99855,"California",484423,0.0857824669761758,66105,0.45,77579,0.528
"7493","tulare",7493,"2021-03-20",4453,143952,2762,74958,1319,66525,372,2469,2116,58463,2328,43883,2491,102346,"California",484423,0.090588184293479,66105,0.45,77579,0.528
"7494","tulare",7494,"2021-03-21",1919,145871,1631,76589,262,66787,26,2495,989,58550,927,44810,1014,103360,"California",484423,0.0925018011118382,66105,0.45,77579,0.528
"7495","tulare",7495,"2021-03-22",2499,148370,1711,78300,676,67463,112,2607,1667,59505,826,45636,1781,105141,"California",484423,0.0942069224623934,66105,0.45,77579,0.528
"7496","tulare",7496,"2021-03-23",3728,152098,2140,80440,1536,68999,52,2659,2084,60013,1634,47270,2142,107283,"California",484423,0.0975800075553803,66105,0.45,77579,0.528
"7497","tulare",7497,"2021-03-24",3164,155262,1955,82395,1167,70166,42,2701,1808,60514,1349,48619,1850,109133,"California",484423,0.100364763853079,66105,0.45,77579,0.528
"7498","tulare",7498,"2021-03-25",3461,158723,1803,84198,1486,71652,172,2873,1711,60655,1744,50363,1885,111018,"California",484423,0.103964923217931,66105,0.45,77579,0.528
"7499","tulare",7499,"2021-03-26",5208,163931,3107,87305,1992,73644,109,2982,2567,60708,2623,52986,2676,113694,"California",484423,0.109379612446147,66105,0.45,77579,0.528
"7500","tulare",7500,"2021-03-27",3521,167452,1807,89112,1616,75260,98,3080,992,59275,2521,55507,1088,114782,"California",484423,0.114583741894997,66105,0.45,77579,0.528
"7501","tulare",7501,"2021-03-28",1455,168907,1051,90163,373,75633,31,3111,675,59210,777,56284,712,115494,"California",484423,0.116187711978994,66105,0.45,77579,0.528
"7502","tulare",7502,"2021-03-29",2895,171802,1674,91837,1110,76743,111,3222,1224,58881,1666,57950,1337,116831,"California",484423,0.119626855041978,66105,0.45,77579,0.528
"7503","tulare",7503,"2021-03-30",4798,176600,2767,94604,1801,78544,230,3452,1550,57418,3240,61190,1777,118608,"California",484423,0.126315224504204,66105,0.45,77579,0.528
"7504","tulare",7504,"2021-03-31",3860,180460,2298,96902,1449,79993,113,3565,1570,56825,2282,63472,1689,120297,"California",484423,0.131025983489636,66105,0.45,77579,0.528
"7505","tulare",7505,"2021-04-01",4399,184859,2359,99261,1974,81967,66,3631,1543,55590,2846,66318,1611,121908,"California",484423,0.136901014196271,66105,0.45,77579,0.528
"7506","tulare",7506,"2021-04-02",5218,190077,2980,102241,2121,84088,117,3748,1644,53794,3558,69876,1762,123670,"California",484423,0.144245834735345,66105,0.45,77579,0.528
"7507","tulare",7507,"2021-04-03",3489,193566,2005,104246,1122,85210,362,4110,845,52394,2606,72482,1206,124876,"California",484423,0.149625430667,66105,0.45,77579,0.528
"7508","tulare",7508,"2021-04-04",1616,195182,1131,105377,478,85688,7,4117,390,51567,1224,73706,397,125273,"California",484423,0.152152148019396,66105,0.45,77579,0.528
"7509","tulare",7509,"2021-04-05",3317,198499,2327,107704,727,86415,263,4380,867,50260,2438,76144,1131,126404,"California",484423,0.157184939608565,66105,0.45,77579,0.528
"7510","tulare",7510,"2021-04-06",3404,201903,1467,109171,1445,87860,492,4872,934,49225,2464,78608,1429,127833,"California",484423,0.162271403298357,66105,0.45,77579,0.528
"7511","tulare",7511,"2021-04-07",3830,205733,1813,110984,1586,89446,431,5303,1277,48378,2546,81154,1699,129532,"California",484423,0.167527140536267,66105,0.45,77579,0.528
"7512","tulare",7512,"2021-04-08",4713,210446,2588,113572,1668,91114,457,5760,1542,47211,3162,84316,1995,131527,"California",484423,0.174054493696625,66105,0.45,77579,0.528
"7513","tulare",7513,"2021-04-09",4771,215217,2944,116516,1398,92512,429,6189,1826,46530,2937,87253,2256,133783,"California",484423,0.180117376755439,66105,0.45,77579,0.528
"7514","tulare",7514,"2021-04-10",3802,219019,2053,118569,1433,93945,316,6505,973,44995,2822,90075,1287,135070,"California",484423,0.185942863984575,66105,0.45,77579,0.528
"7515","tulare",7515,"2021-04-11",1577,220596,1038,119607,468,94413,71,6576,590,44672,984,91059,661,135731,"California",484423,0.187974146561992,66105,0.45,77579,0.528
"7516","tulare",7516,"2021-04-12",3361,223957,2106,121713,662,95075,593,7169,1083,44080,2269,93328,1677,137408,"California",484423,0.192658069497113,66105,0.45,77579,0.528
"7517","tulare",7517,"2021-04-13",2403,226360,1585,123298,808,95883,10,7179,917,43535,1474,94802,929,138337,"California",484423,0.195700864740114,66105,0.45,77579,0.528
"7518","tulare",7518,"2021-04-14",2833,229193,1674,124972,1159,97042,0,7179,929,42563,1901,96703,929,139266,"California",484423,0.199625121020265,66105,0.45,77579,0.528
"7519","tulare",7519,"2021-04-15",3244,232437,2130,127102,1114,98156,0,7179,1453,42234,1782,98485,1453,140719,"California",484423,0.20330372422449,66105,0.45,77579,0.528
"7520","tulare",7520,"2021-04-16",3645,236082,2214,129316,1431,99587,0,7179,1478,41555,2157,100642,1478,142197,"California",484423,0.20775644426462,66105,0.45,77579,0.528
"7521","tulare",7521,"2021-04-17",2199,238281,1298,130614,901,100488,0,7179,1178,41716,1018,101660,1179,143376,"California",484423,0.209857913435159,66105,0.45,77579,0.528
"7522","tulare",7522,"2021-04-18",1516,239797,1187,131801,329,100817,0,7179,812,41826,702,102362,812,144188,"California",484423,0.211307060151975,66105,0.45,77579,0.528
"7523","tulare",7523,"2021-04-19",2115,241912,1219,133020,894,101711,2,7181,899,41513,1214,103576,901,145089,"California",484423,0.213813134388747,66105,0.45,77579,0.528
"7524","tulare",7524,"2021-04-20",2320,244232,1303,134323,1017,102728,0,7181,992,41190,1315,104891,992,146081,"California",484423,0.216527704093323,66105,0.45,77579,0.528
"7525","tulare",7525,"2021-04-21",2170,246402,1316,135639,854,103582,0,7181,786,40627,1349,106240,786,146867,"California",484423,0.219312460391022,66105,0.45,77579,0.528
"7526","tulare",7526,"2021-04-22",2095,248497,1169,136808,926,104508,0,7181,738,40027,1338,107578,738,147605,"California",484423,0.222074509261534,66105,0.45,77579,0.528
"7527","tulare",7527,"2021-04-23",2550,251047,1570,138378,979,105487,1,7182,1006,39499,1534,109112,1006,148611,"California",484423,0.225241163198279,66105,0.45,77579,0.528
"7528","tulare",7528,"2021-04-24",1636,252683,1054,139432,580,106067,2,7184,861,39592,770,109882,863,149474,"California",484423,0.226830683101339,66105,0.45,77579,0.528
"7529","tulare",7529,"2021-04-25",695,253378,522,139954,173,106240,0,7184,267,39431,428,110310,267,149741,"California",484423,0.227714208450053,66105,0.45,77579,0.528
"7530","tulare",7530,"2021-04-26",1431,254809,844,140798,568,106808,19,7203,601,39225,824,111134,618,150359,"California",484423,0.229415201177483,66105,0.45,77579,0.528
"7531","tulare",7531,"2021-04-27",1564,256373,601,141399,926,107734,37,7240,662,39023,900,112034,698,151057,"California",484423,0.231273081583657,66105,0.45,77579,0.528
"7532","tulare",7532,"2021-04-28",1700,258073,968,142367,691,108425,41,7281,672,38712,1024,113058,713,151770,"California",484423,0.233386936623571,66105,0.45,77579,0.528
"7533","tulare",7533,"2021-04-29",1985,260058,1190,143557,758,109183,37,7318,776,38324,1199,114257,811,152581,"California",484423,0.235862046186907,66105,0.45,77579,0.528
"7534","tulare",7534,"2021-04-30",2419,262477,1767,145324,603,109786,49,7367,896,37751,1518,115775,945,153526,"California",484423,0.238995671138654,66105,0.45,77579,0.528
"7535","tulare",7535,"2021-05-01",1405,263882,1208,146532,185,109971,12,7379,722,37809,676,116451,734,154260,"California",484423,0.240391145754846,66105,0.45,77579,0.528
"7536","tulare",7536,"2021-05-02",583,264465,495,147027,72,110043,16,7395,189,37623,391,116842,205,154465,"California",484423,0.241198291575751,66105,0.45,77579,0.528
"7537","tulare",7537,"2021-05-03",1605,266070,1090,148117,391,110434,124,7519,348,36845,1250,118092,472,154937,"California",484423,0.24377868102877,66105,0.45,77579,0.528
"7538","tulare",7538,"2021-05-04",1543,267613,822,148939,650,111084,71,7590,624,36627,912,119004,694,155631,"California",484423,0.245661333173693,66105,0.45,77579,0.528
"7539","tulare",7539,"2021-05-05",1267,268880,615,149554,573,111657,79,7669,448,36346,808,119812,527,156158,"California",484423,0.247329296916125,66105,0.45,77579,0.528
"7540","tulare",7540,"2021-05-06",1933,270813,1315,150869,572,112229,46,7715,581,35626,1346,121158,626,156784,"California",484423,0.250107860279136,66105,0.45,77579,0.528
"7541","tulare",7541,"2021-05-07",1820,272633,1227,152096,523,112752,70,7785,511,34906,1299,122457,579,157363,"California",484423,0.252789400998714,66105,0.45,77579,0.528
"7542","tulare",7542,"2021-05-08",1236,273869,810,152906,400,113152,26,7811,522,34748,706,123163,548,157911,"California",484423,0.254246804961779,66105,0.45,77579,0.528
"7543","tuolumne",7543,"2020-12-16",47,47,47,47,0,0,0,0,47,47,0,0,47,47,"California",52351,0,11978,0.394,17689,0.582
"7544","tuolumne",7544,"2020-12-17",17,64,17,64,0,0,0,0,17,64,0,0,17,64,"California",52351,0,11978,0.394,17689,0.582
"7545","tuolumne",7545,"2020-12-18",101,165,100,164,1,1,0,0,101,165,0,0,101,165,"California",52351,0,11978,0.394,17689,0.582
"7546","tuolumne",7546,"2020-12-19",5,170,5,169,0,1,0,0,5,170,0,0,5,170,"California",52351,0,11978,0.394,17689,0.582
"7547","tuolumne",7547,"2020-12-20",1,171,1,170,0,1,0,0,1,171,0,0,1,171,"California",52351,0,11978,0.394,17689,0.582
"7548","tuolumne",7548,"2020-12-21",116,287,102,272,14,15,0,0,116,287,0,0,116,287,"California",52351,0,11978,0.394,17689,0.582
"7549","tuolumne",7549,"2020-12-22",172,459,172,444,0,15,0,0,172,459,0,0,172,459,"California",52351,0,11978,0.394,17689,0.582
"7550","tuolumne",7550,"2020-12-23",186,645,184,628,2,17,0,0,186,645,0,0,186,645,"California",52351,0,11978,0.394,17689,0.582
"7551","tuolumne",7551,"2020-12-26",3,648,3,631,0,17,0,0,3,648,0,0,3,648,"California",52351,0,11978,0.394,17689,0.582
"7552","tuolumne",7552,"2020-12-28",77,725,75,706,2,19,0,0,77,725,0,0,77,725,"California",52351,0,11978,0.394,17689,0.582
"7553","tuolumne",7553,"2020-12-29",102,827,39,745,63,82,0,0,102,827,0,0,102,827,"California",52351,0,11978,0.394,17689,0.582
"7554","tuolumne",7554,"2020-12-30",78,905,22,767,56,138,0,0,78,905,0,0,78,905,"California",52351,0,11978,0.394,17689,0.582
"7555","tuolumne",7555,"2020-12-31",27,932,20,787,7,145,0,0,27,932,0,0,27,932,"California",52351,0,11978,0.394,17689,0.582
"7556","tuolumne",7556,"2021-01-01",7,939,6,793,1,146,0,0,7,939,0,0,7,939,"California",52351,0,11978,0.394,17689,0.582
"7557","tuolumne",7557,"2021-01-02",118,1057,115,908,3,149,0,0,118,1057,0,0,118,1057,"California",52351,0,11978,0.394,17689,0.582
"7558","tuolumne",7558,"2021-01-03",2,1059,2,910,0,149,0,0,2,1059,0,0,2,1059,"California",52351,0,11978,0.394,17689,0.582
"7559","tuolumne",7559,"2021-01-04",69,1128,26,936,43,192,0,0,69,1128,0,0,69,1128,"California",52351,0,11978,0.394,17689,0.582
"7560","tuolumne",7560,"2021-01-05",93,1221,27,963,66,258,0,0,90,1216,3,3,91,1219,"California",52351,5.73054955970278e-05,11978,0.394,17689,0.582
"7561","tuolumne",7561,"2021-01-06",132,1353,72,1035,60,318,0,0,68,1220,64,67,68,1287,"California",52351,0.00127982273500029,11978,0.394,17689,0.582
"7562","tuolumne",7562,"2021-01-07",119,1472,63,1098,56,374,0,0,64,1229,55,122,64,1351,"California",52351,0.00233042348761246,11978,0.394,17689,0.582
"7563","tuolumne",7563,"2021-01-08",103,1575,79,1177,24,398,0,0,26,1180,76,198,27,1378,"California",52351,0.00378216270940383,11978,0.394,17689,0.582
"7564","tuolumne",7564,"2021-01-09",1,1576,0,1177,1,399,0,0,1,1181,0,198,1,1379,"California",52351,0.00378216270940383,11978,0.394,17689,0.582
"7565","tuolumne",7565,"2021-01-10",3,1579,1,1178,2,401,0,0,3,1184,0,198,3,1382,"California",52351,0.00378216270940383,11978,0.394,17689,0.582
"7566","tuolumne",7566,"2021-01-11",116,1695,90,1268,26,427,0,0,34,1136,82,280,34,1416,"California",52351,0.00534851292238926,11978,0.394,17689,0.582
"7567","tuolumne",7567,"2021-01-12",102,1797,86,1354,16,443,0,0,17,1068,85,365,17,1433,"California",52351,0.00697216863097171,11978,0.394,17689,0.582
"7568","tuolumne",7568,"2021-01-13",231,2028,125,1479,106,549,0,0,182,1202,49,414,183,1616,"California",52351,0.00790815839238983,11978,0.394,17689,0.582
"7569","tuolumne",7569,"2021-01-14",147,2175,107,1586,40,589,0,0,42,1140,104,518,42,1658,"California",52351,0.00989474890642013,11978,0.394,17689,0.582
"7570","tuolumne",7570,"2021-01-15",475,2650,72,1658,403,992,0,0,413,1493,61,579,414,2072,"California",52351,0.0110599606502264,11978,0.394,17689,0.582
"7571","tuolumne",7571,"2021-01-16",7,2657,3,1661,4,996,0,0,6,1498,1,580,6,2078,"California",52351,0.011079062482092,11978,0.394,17689,0.582
"7572","tuolumne",7572,"2021-01-17",8,2665,5,1666,3,999,0,0,7,1505,0,580,7,2085,"California",52351,0.011079062482092,11978,0.394,17689,0.582
"7573","tuolumne",7573,"2021-01-18",46,2711,38,1704,8,1007,0,0,9,1478,36,616,9,2094,"California",52351,0.0117667284292564,11978,0.394,17689,0.582
"7574","tuolumne",7574,"2021-01-19",477,3188,73,1777,404,1411,0,0,431,1863,46,662,431,2525,"California",52351,0.0126454126950775,11978,0.394,17689,0.582
"7575","tuolumne",7575,"2021-01-20",76,3264,58,1835,18,1429,0,0,24,1836,51,713,24,2549,"California",52351,0.0136196061202269,11978,0.394,17689,0.582
"7576","tuolumne",7576,"2021-01-21",56,3320,23,1858,33,1462,0,0,40,1860,16,729,40,2589,"California",52351,0.0139252354300777,11978,0.394,17689,0.582
"7577","tuolumne",7577,"2021-01-22",168,3488,16,1874,152,1614,0,0,161,2014,7,736,161,2750,"California",52351,0.0140589482531375,11978,0.394,17689,0.582
"7578","tuolumne",7578,"2021-01-23",666,4154,147,2021,519,2133,0,0,551,2462,115,851,563,3313,"California",52351,0.0162556589176902,11978,0.394,17689,0.582
"7579","tuolumne",7579,"2021-01-24",523,4677,1,2022,522,2655,0,0,519,2979,3,854,520,3833,"California",52351,0.0163129644132872,11978,0.394,17689,0.582
"7580","tuolumne",7580,"2021-01-25",49,4726,28,2050,21,2676,0,0,22,2975,27,881,23,3856,"California",52351,0.0168287138736605,11978,0.394,17689,0.582
"7581","tuolumne",7581,"2021-01-26",80,4806,68,2118,12,2688,0,0,40,2976,40,921,41,3897,"California",52351,0.0175927871482875,11978,0.394,17689,0.582
"7582","tuolumne",7582,"2021-01-27",61,4867,4,2122,57,2745,0,0,8,2932,52,973,8,3905,"California",52351,0.0185860824053027,11978,0.394,17689,0.582
"7583","tuolumne",7583,"2021-01-28",27,4894,7,2129,20,2765,0,0,18,2941,9,982,18,3923,"California",52351,0.0187579988920938,11978,0.394,17689,0.582
"7584","tuolumne",7584,"2021-01-29",74,4968,6,2135,68,2833,0,0,35,2937,39,1021,35,3958,"California",52351,0.0195029703348551,11978,0.394,17689,0.582
"7585","tuolumne",7585,"2021-01-30",710,5678,553,2688,157,2990,0,0,687,3618,23,1044,704,4662,"California",52351,0.0199423124677657,11978,0.394,17689,0.582
"7586","tuolumne",7586,"2021-01-31",8,5686,2,2690,6,2996,0,0,5,3620,3,1047,5,4667,"California",52351,0.0199996179633627,11978,0.394,17689,0.582
"7587","tuolumne",7587,"2021-02-01",25,5711,6,2696,19,3015,0,0,22,3639,3,1050,22,4689,"California",52351,0.0200569234589597,11978,0.394,17689,0.582
"7588","tuolumne",7588,"2021-02-02",646,6357,37,2733,609,3624,0,0,635,4265,9,1059,635,5324,"California",52351,0.0202288399457508,11978,0.394,17689,0.582
"7589","tuolumne",7589,"2021-02-03",238,6595,109,2842,129,3753,0,0,86,4199,152,1211,86,5410,"California",52351,0.0231323183893335,11978,0.394,17689,0.582
"7590","tuolumne",7590,"2021-02-04",123,6718,13,2855,110,3863,0,0,60,4196,63,1274,60,5470,"California",52351,0.0243357337968711,11978,0.394,17689,0.582
"7591","tuolumne",7591,"2021-02-05",98,6816,12,2867,86,3949,0,0,35,4169,62,1336,35,5505,"California",52351,0.025520047372543,11978,0.394,17689,0.582
"7592","tuolumne",7592,"2021-02-06",854,7670,580,3447,274,4223,0,0,848,5014,6,1342,851,6356,"California",52351,0.0256346583637371,11978,0.394,17689,0.582
"7593","tuolumne",7593,"2021-02-07",8,7678,4,3451,4,4227,0,0,4,5014,4,1346,4,6360,"California",52351,0.0257110656911998,11978,0.394,17689,0.582
"7594","tuolumne",7594,"2021-02-08",91,7769,40,3491,51,4278,0,0,67,5057,24,1370,67,6427,"California",52351,0.026169509655976,11978,0.394,17689,0.582
"7595","tuolumne",7595,"2021-02-09",863,8632,53,3544,810,5088,0,0,823,5840,40,1410,823,7250,"California",52351,0.026933582930603,11978,0.394,17689,0.582
"7596","tuolumne",7596,"2021-02-10",92,8724,17,3561,75,5163,0,0,31,5811,60,1470,31,7281,"California",52351,0.0280796928425436,11978,0.394,17689,0.582
"7597","tuolumne",7597,"2021-02-11",142,8866,67,3628,75,5238,0,0,76,5821,66,1536,76,7357,"California",52351,0.0293404137456782,11978,0.394,17689,0.582
"7598","tuolumne",7598,"2021-02-12",648,9514,20,3648,628,5866,0,0,206,5586,441,1977,206,7563,"California",52351,0.0377643215984413,11978,0.394,17689,0.582
"7599","tuolumne",7599,"2021-02-13",149,9663,42,3690,107,5973,0,0,118,5679,25,2002,118,7681,"California",52351,0.0382418673950832,11978,0.394,17689,0.582
"7600","tuolumne",7600,"2021-02-14",148,9811,12,3702,136,6109,0,0,147,5825,1,2003,147,7828,"California",52351,0.0382609692269489,11978,0.394,17689,0.582
"7601","tuolumne",7601,"2021-02-15",185,9996,10,3712,175,6284,0,0,176,5992,9,2012,176,8004,"California",52351,0.0384328857137399,11978,0.394,17689,0.582
"7602","tuolumne",7602,"2021-02-16",529,10525,17,3729,512,6796,0,0,122,5712,404,2416,124,8128,"California",52351,0.046150025787473,11978,0.394,17689,0.582
"7603","tuolumne",7603,"2021-02-17",110,10635,63,3792,47,6843,0,0,63,5729,46,2462,63,8191,"California",52351,0.0470287100532941,11978,0.394,17689,0.582
"7604","tuolumne",7604,"2021-02-18",680,11315,26,3818,654,7497,0,0,629,6308,51,2513,630,8821,"California",52351,0.0480029034784436,11978,0.394,17689,0.582
"7605","tuolumne",7605,"2021-02-19",142,11457,23,3841,119,7616,0,0,43,6252,99,2612,43,8864,"California",52351,0.0498939848331455,11978,0.394,17689,0.582
"7606","tuolumne",7606,"2021-02-20",905,12362,342,4183,563,8179,0,0,386,6134,505,3117,387,9251,"California",52351,0.0595404099253118,11978,0.394,17689,0.582
"7607","tuolumne",7607,"2021-02-21",976,13338,37,4220,939,9118,0,0,469,6101,504,3621,471,9722,"California",52351,0.0691677331856125,11978,0.394,17689,0.582
"7608","tuolumne",7608,"2021-02-22",79,13417,58,4278,21,9139,0,0,47,6117,31,3652,47,9769,"California",52351,0.0697598899734485,11978,0.394,17689,0.582
"7609","tuolumne",7609,"2021-02-23",48,13465,24,4302,24,9163,0,0,26,6122,21,3673,26,9795,"California",52351,0.0701610284426276,11978,0.394,17689,0.582
"7610","tuolumne",7610,"2021-02-24",103,13568,58,4360,45,9208,0,0,43,6106,59,3732,43,9838,"California",52351,0.0712880365227025,11978,0.394,17689,0.582
"7611","tuolumne",7611,"2021-02-25",1053,14621,35,4395,1018,10226,0,0,1022,7097,31,3763,1022,10860,"California",52351,0.0718801933105385,11978,0.394,17689,0.582
"7612","tuolumne",7612,"2021-02-26",144,14765,10,4405,134,10360,0,0,121,7195,23,3786,121,10981,"California",52351,0.072319535443449,11978,0.394,17689,0.582
"7613","tuolumne",7613,"2021-02-27",951,15716,578,4983,373,10733,0,0,248,6759,686,4472,250,11231,"California",52351,0.0854233921033027,11978,0.394,17689,0.582
"7614","tuolumne",7614,"2021-02-28",56,15772,4,4987,52,10785,0,0,53,6810,2,4474,53,11284,"California",52351,0.0854615957670341,11978,0.394,17689,0.582
"7615","tuolumne",7615,"2021-03-01",112,15884,21,5008,91,10876,0,0,77,6855,33,4507,78,11362,"California",52351,0.0860919562186014,11978,0.394,17689,0.582
"7616","tuolumne",7616,"2021-03-02",705,16589,73,5081,632,11508,0,0,106,6363,598,5105,106,11468,"California",52351,0.0975148516742756,11978,0.394,17689,0.582
"7617","tuolumne",7617,"2021-03-03",90,16679,22,5103,68,11576,0,0,65,6403,25,5130,65,11533,"California",52351,0.0979923974709175,11978,0.394,17689,0.582
"7618","tuolumne",7618,"2021-03-04",1170,17849,75,5178,1095,12671,0,0,1107,7447,63,5193,1107,12640,"California",52351,0.099195812878455,11978,0.394,17689,0.582
"7619","tuolumne",7619,"2021-03-05",85,17934,10,5188,75,12746,0,0,48,7460,36,5229,49,12689,"California",52351,0.0998834788256194,11978,0.394,17689,0.582
"7620","tuolumne",7620,"2021-03-06",1055,18989,604,5792,449,13195,2,2,204,6820,847,6076,207,12896,"California",52351,0.116062730415847,11978,0.394,17689,0.582
"7621","tuolumne",7621,"2021-03-07",41,19030,12,5804,14,13209,15,17,18,6830,23,6099,33,12929,"California",52351,0.116502072548757,11978,0.394,17689,0.582
"7622","tuolumne",7622,"2021-03-08",195,19225,88,5892,100,13309,7,24,139,6920,56,6155,146,13075,"California",52351,0.117571775133235,11978,0.394,17689,0.582
"7623","tuolumne",7623,"2021-03-09",858,20083,16,5908,831,14140,11,35,68,6214,786,6941,80,13155,"California",52351,0.132585814979657,11978,0.394,17689,0.582
"7624","tuolumne",7624,"2021-03-10",78,20161,12,5920,55,14195,11,46,53,6253,25,6966,64,13219,"California",52351,0.133063360776298,11978,0.394,17689,0.582
"7625","tuolumne",7625,"2021-03-11",1285,21446,38,5958,1241,15436,6,52,1259,7494,26,6992,1267,14486,"California",52351,0.133560008404806,11978,0.394,17689,0.582
"7626","tuolumne",7626,"2021-03-12",299,21745,35,5993,249,15685,15,67,190,7594,108,7100,208,14694,"California",52351,0.135623006246299,11978,0.394,17689,0.582
"7627","tuolumne",7627,"2021-03-13",112,21857,12,6005,100,15785,0,67,84,7652,27,7127,85,14779,"California",52351,0.136138755706672,11978,0.394,17689,0.582
"7628","tuolumne",7628,"2021-03-14",142,21999,8,6013,125,15910,9,76,8,7540,134,7261,22,14801,"California",52351,0.138698401176673,11978,0.394,17689,0.582
"7629","tuolumne",7629,"2021-03-15",293,22292,79,6092,212,16122,2,78,100,7457,192,7453,109,14910,"California",52351,0.142365952894883,11978,0.394,17689,0.582
"7630","tuolumne",7630,"2021-03-16",803,23095,40,6132,752,16874,11,89,665,7996,137,7590,676,15586,"California",52351,0.14498290386048,11978,0.394,17689,0.582
"7631","tuolumne",7631,"2021-03-17",150,23245,30,6162,107,16981,13,102,77,8014,71,7661,89,15675,"California",52351,0.146339133922943,11978,0.394,17689,0.582
"7632","tuolumne",7632,"2021-03-18",949,24194,29,6191,907,17888,13,115,318,7717,629,8290,332,16007,"California",52351,0.158354186166453,11978,0.394,17689,0.582
"7633","tuolumne",7633,"2021-03-19",132,24326,16,6207,85,17973,31,146,71,7759,59,8349,101,16108,"California",52351,0.159481194246528,11978,0.394,17689,0.582
"7634","tuolumne",7634,"2021-03-20",89,24415,7,6214,72,18045,10,156,37,7754,51,8400,46,16154,"California",52351,0.160455387671678,11978,0.394,17689,0.582
"7635","tuolumne",7635,"2021-03-21",834,25249,391,6605,434,18479,9,165,39,7014,789,9189,49,16203,"California",52351,0.175526733013696,11978,0.394,17689,0.582
"7636","tuolumne",7636,"2021-03-22",163,25412,72,6677,72,18551,19,184,97,7064,66,9255,116,16319,"California",52351,0.176787453916831,11978,0.394,17689,0.582
"7637","tuolumne",7637,"2021-03-23",709,26121,639,7316,56,18607,14,198,673,7714,36,9291,686,17005,"California",52351,0.177475119863995,11978,0.394,17689,0.582
"7638","tuolumne",7638,"2021-03-24",110,26231,20,7336,72,18679,18,216,77,7777,32,9323,95,17100,"California",52351,0.178086378483697,11978,0.394,17689,0.582
"7639","tuolumne",7639,"2021-03-25",1295,27526,23,7359,1269,19948,3,219,323,7133,970,10293,326,17426,"California",52351,0.196615155393402,11978,0.394,17689,0.582
"7640","tuolumne",7640,"2021-03-26",269,27795,16,7375,230,20178,23,242,111,7119,148,10441,134,17560,"California",52351,0.199442226509522,11978,0.394,17689,0.582
"7641","tuolumne",7641,"2021-03-27",579,28374,54,7429,525,20703,0,242,318,7179,259,10700,319,17879,"California",52351,0.204389600962732,11978,0.394,17689,0.582
"7642","tuolumne",7642,"2021-03-28",49,28423,8,7437,41,20744,0,242,9,7150,39,10739,10,17889,"California",52351,0.205134572405494,11978,0.394,17689,0.582
"7643","tuolumne",7643,"2021-03-29",204,28627,82,7519,122,20866,0,242,107,7163,94,10833,107,17996,"California",52351,0.206930144600867,11978,0.394,17689,0.582
"7644","tuolumne",7644,"2021-03-30",162,28789,11,7530,150,21016,1,243,120,7243,41,10874,121,18117,"California",52351,0.20771331970736,11978,0.394,17689,0.582
"7645","tuolumne",7645,"2021-03-31",95,28884,14,7544,79,21095,2,245,37,7227,56,10930,40,18157,"California",52351,0.208783022291838,11978,0.394,17689,0.582
"7646","tuolumne",7646,"2021-04-01",1251,30135,32,7576,1219,22314,0,245,226,6431,1023,11953,227,18384,"California",52351,0.228324196290424,11978,0.394,17689,0.582
"7647","tuolumne",7647,"2021-04-02",165,30300,11,7587,128,22442,26,271,92,6478,71,12024,118,18502,"California",52351,0.229680426352887,11978,0.394,17689,0.582
"7648","tuolumne",7648,"2021-04-03",425,30725,35,7622,389,22831,1,272,238,6532,187,12211,241,18743,"California",52351,0.233252468911769,11978,0.394,17689,0.582
"7649","tuolumne",7649,"2021-04-04",32,30757,2,7624,30,22861,0,272,20,6541,11,12222,20,18763,"California",52351,0.233462589062291,11978,0.394,17689,0.582
"7650","tuolumne",7650,"2021-04-05",126,30883,19,7643,101,22962,6,278,55,6531,71,12293,61,18824,"California",52351,0.234818819124754,11978,0.394,17689,0.582
"7651","tuolumne",7651,"2021-04-06",646,31529,516,8159,103,23065,27,305,513,6939,133,12426,541,19365,"California",52351,0.237359362762889,11978,0.394,17689,0.582
"7652","tuolumne",7652,"2021-04-07",126,31655,37,8196,73,23138,16,321,48,6925,78,12504,64,19429,"California",52351,0.238849305648412,11978,0.394,17689,0.582
"7653","tuolumne",7653,"2021-04-08",1436,33091,33,8229,1389,24527,14,335,240,5986,1193,13697,254,19683,"California",52351,0.261637791064163,11978,0.394,17689,0.582
"7654","tuolumne",7654,"2021-04-09",267,33358,41,8270,182,24709,44,379,125,6017,142,13839,173,19856,"California",52351,0.264350251189089,11978,0.394,17689,0.582
"7655","tuolumne",7655,"2021-04-10",56,33414,2,8272,34,24743,20,399,23,6028,32,13871,43,19899,"California",52351,0.264961509808791,11978,0.394,17689,0.582
"7656","tuolumne",7656,"2021-04-11",17,33431,2,8274,12,24755,3,402,12,6038,5,13876,15,19914,"California",52351,0.265057018968119,11978,0.394,17689,0.582
"7657","tuolumne",7657,"2021-04-12",164,33595,67,8341,92,24847,5,407,90,6065,68,13944,95,20009,"California",52351,0.266355943534985,11978,0.394,17689,0.582
"7658","tuolumne",7658,"2021-04-13",784,34379,36,8377,748,25595,0,407,170,5629,606,14550,170,20179,"California",52351,0.277931653645585,11978,0.394,17689,0.582
"7659","tuolumne",7659,"2021-04-14",144,34523,27,8404,117,25712,0,407,70,5629,71,14621,71,20250,"California",52351,0.279287883708048,11978,0.394,17689,0.582
"7660","tuolumne",7660,"2021-04-15",337,34860,20,8424,317,26029,0,407,55,5407,277,14898,55,20305,"California",52351,0.28457909113484,11978,0.394,17689,0.582
"7661","tuolumne",7661,"2021-04-16",241,35101,50,8474,191,26220,0,407,135,5443,99,14997,135,20440,"California",52351,0.286470172489542,11978,0.394,17689,0.582
"7662","tuolumne",7662,"2021-04-17",43,35144,6,8480,37,26257,0,407,27,5454,16,15013,27,20467,"California",52351,0.286775801799393,11978,0.394,17689,0.582
"7663","tuolumne",7663,"2021-04-18",8,35152,2,8482,6,26263,0,407,3,5453,4,15017,3,20470,"California",52351,0.286852209126855,11978,0.394,17689,0.582
"7664","tuolumne",7664,"2021-04-19",167,35319,78,8560,89,26352,0,407,89,5466,76,15093,89,20559,"California",52351,0.288303948348647,11978,0.394,17689,0.582
"7665","tuolumne",7665,"2021-04-20",711,36030,618,9178,93,26445,0,407,77,4916,627,15720,77,20636,"California",52351,0.300280796928425,11978,0.394,17689,0.582
"7666","tuolumne",7666,"2021-04-21",116,36146,26,9204,90,26535,0,407,61,4927,50,15770,61,20697,"California",52351,0.301235888521709,11978,0.394,17689,0.582
"7667","tuolumne",7667,"2021-04-22",693,36839,46,9250,647,27182,0,407,422,5088,261,16031,422,21119,"California",52351,0.306221466638651,11978,0.394,17689,0.582
"7668","tuolumne",7668,"2021-04-23",160,36999,31,9281,129,27311,0,407,85,5100,73,16104,85,21204,"California",52351,0.307615900364845,11978,0.394,17689,0.582
"7669","tuolumne",7669,"2021-04-24",80,37079,18,9299,62,27373,0,407,52,5124,28,16132,52,21256,"California",52351,0.308150751657084,11978,0.394,17689,0.582
"7670","tuolumne",7670,"2021-04-25",27,37106,10,9309,17,27390,0,407,24,5145,3,16135,24,21280,"California",52351,0.308208057152681,11978,0.394,17689,0.582
"7671","tuolumne",7671,"2021-04-26",151,37257,56,9365,95,27485,0,407,69,5134,81,16216,70,21350,"California",52351,0.309755305533801,11978,0.394,17689,0.582
"7672","tuolumne",7672,"2021-04-27",131,37388,21,9386,103,27588,7,414,59,5130,70,16286,66,21416,"California",52351,0.311092433764398,11978,0.394,17689,0.582
"7673","tuolumne",7673,"2021-04-28",115,37503,25,9411,79,27667,11,425,64,5155,50,16336,75,21491,"California",52351,0.312047525357682,11978,0.394,17689,0.582
"7674","tuolumne",7674,"2021-04-29",271,37774,16,9427,247,27914,8,433,49,4991,221,16557,57,21548,"California",52351,0.316269030199996,11978,0.394,17689,0.582
"7675","tuolumne",7675,"2021-04-30",348,38122,21,9448,315,28229,12,445,65,4788,280,16837,77,21625,"California",52351,0.321617543122385,11978,0.394,17689,0.582
"7676","tuolumne",7676,"2021-05-01",24,38146,7,9455,13,28242,4,449,16,4800,8,16845,20,21645,"California",52351,0.321770357777311,11978,0.394,17689,0.582
"7677","tuolumne",7677,"2021-05-02",26,38172,3,9458,21,28263,2,451,19,4814,7,16852,21,21666,"California",52351,0.321904070600371,11978,0.394,17689,0.582
"7678","tuolumne",7678,"2021-05-03",81,38253,12,9470,64,28327,5,456,22,4783,58,16910,27,21693,"California",52351,0.32301197684858,11978,0.394,17689,0.582
"7679","tuolumne",7679,"2021-05-04",679,38932,600,10070,74,28401,5,461,198,4505,480,17390,202,21895,"California",52351,0.332180856144104,11978,0.394,17689,0.582
"7680","tuolumne",7680,"2021-05-05",91,39023,26,10096,62,28463,3,464,47,4514,42,17432,51,21946,"California",52351,0.332983133082463,11978,0.394,17689,0.582
"7681","tuolumne",7681,"2021-05-06",269,39292,12,10108,245,28708,12,476,32,4325,232,17664,43,21989,"California",52351,0.337414758075299,11978,0.394,17689,0.582
"7682","tuolumne",7682,"2021-05-07",310,39602,25,10133,277,28985,8,484,56,4136,253,17917,64,22053,"California",52351,0.342247521537315,11978,0.394,17689,0.582
"7683","tuolumne",7683,"2021-05-08",47,39649,7,10140,36,29021,4,488,30,4153,17,17934,34,22087,"California",52351,0.342572252679032,11978,0.394,17689,0.582
"7684","ventura",7684,"2020-12-15",5,5,5,5,0,0,0,0,5,5,0,0,5,5,"California",852747,0,251388,0.595,162207,0.384
"7685","ventura",7685,"2020-12-16",72,77,72,77,0,0,0,0,72,77,0,0,72,77,"California",852747,0,251388,0.595,162207,0.384
"7686","ventura",7686,"2020-12-17",249,326,249,326,0,0,0,0,249,326,0,0,249,326,"California",852747,0,251388,0.595,162207,0.384
"7687","ventura",7687,"2020-12-18",1411,1737,1411,1737,0,0,0,0,1411,1737,0,0,1411,1737,"California",852747,0,251388,0.595,162207,0.384
"7688","ventura",7688,"2020-12-19",911,2648,911,2648,0,0,0,0,911,2648,0,0,911,2648,"California",852747,0,251388,0.595,162207,0.384
"7689","ventura",7689,"2020-12-20",430,3078,430,3078,0,0,0,0,430,3078,0,0,430,3078,"California",852747,0,251388,0.595,162207,0.384
"7690","ventura",7690,"2020-12-21",1468,4546,1468,4546,0,0,0,0,1468,4546,0,0,1468,4546,"California",852747,0,251388,0.595,162207,0.384
"7691","ventura",7691,"2020-12-22",1104,5650,1099,5645,5,5,0,0,1104,5650,0,0,1104,5650,"California",852747,0,251388,0.595,162207,0.384
"7692","ventura",7692,"2020-12-23",1028,6678,980,6625,48,53,0,0,1028,6678,0,0,1028,6678,"California",852747,0,251388,0.595,162207,0.384
"7693","ventura",7693,"2020-12-24",477,7155,379,7004,98,151,0,0,477,7155,0,0,477,7155,"California",852747,0,251388,0.595,162207,0.384
"7694","ventura",7694,"2020-12-25",11,7166,7,7011,4,155,0,0,11,7166,0,0,11,7166,"California",852747,0,251388,0.595,162207,0.384
"7695","ventura",7695,"2020-12-26",111,7277,91,7102,20,175,0,0,111,7277,0,0,111,7277,"California",852747,0,251388,0.595,162207,0.384
"7696","ventura",7696,"2020-12-27",58,7335,27,7129,31,206,0,0,58,7335,0,0,58,7335,"California",852747,0,251388,0.595,162207,0.384
"7697","ventura",7697,"2020-12-28",1072,8407,932,8061,140,346,0,0,1072,8407,0,0,1072,8407,"California",852747,0,251388,0.595,162207,0.384
"7698","ventura",7698,"2020-12-29",1171,9578,764,8825,407,753,0,0,1171,9578,0,0,1171,9578,"California",852747,0,251388,0.595,162207,0.384
"7699","ventura",7699,"2020-12-30",1987,11565,1522,10347,465,1218,0,0,1987,11565,0,0,1987,11565,"California",852747,0,251388,0.595,162207,0.384
"7700","ventura",7700,"2020-12-31",479,12044,161,10508,318,1536,0,0,479,12044,0,0,479,12044,"California",852747,0,251388,0.595,162207,0.384
"7701","ventura",7701,"2021-01-01",25,12069,7,10515,18,1554,0,0,25,12069,0,0,25,12069,"California",852747,0,251388,0.595,162207,0.384
"7702","ventura",7702,"2021-01-02",174,12243,79,10594,95,1649,0,0,174,12243,0,0,174,12243,"California",852747,0,251388,0.595,162207,0.384
"7703","ventura",7703,"2021-01-03",16,12259,8,10602,8,1657,0,0,16,12259,0,0,16,12259,"California",852747,0,251388,0.595,162207,0.384
"7704","ventura",7704,"2021-01-04",1083,13342,552,11154,531,2188,0,0,1082,13341,0,0,1082,13341,"California",852747,0,251388,0.595,162207,0.384
"7705","ventura",7705,"2021-01-05",1373,14715,777,11931,596,2784,0,0,1332,14632,41,41,1332,14673,"California",852747,4.80799111577056e-05,251388,0.595,162207,0.384
"7706","ventura",7706,"2021-01-06",2058,16773,1180,13111,878,3662,0,0,1627,15839,422,463,1629,16302,"California",852747,0.00054295119185409,251388,0.595,162207,0.384
"7707","ventura",7707,"2021-01-07",2068,18841,1326,14437,742,4404,0,0,1181,16135,885,1348,1181,17483,"California",852747,0.00158077366440457,251388,0.595,162207,0.384
"7708","ventura",7708,"2021-01-08",2197,21038,1474,15911,723,5127,0,0,906,15753,1289,2637,907,18390,"California",852747,0.00309235916397243,251388,0.595,162207,0.384
"7709","ventura",7709,"2021-01-09",721,21759,500,16411,221,5348,0,0,319,15670,402,3039,319,18709,"California",852747,0.00356377682946994,251388,0.595,162207,0.384
"7710","ventura",7710,"2021-01-10",343,22102,327,16738,16,5364,0,0,129,15585,214,3253,129,18838,"California",852747,0.00381473051209796,251388,0.595,162207,0.384
"7711","ventura",7711,"2021-01-11",2446,24548,1488,18226,958,6322,0,0,1494,16130,952,4205,1497,20335,"California",852747,0.00493112259556469,251388,0.595,162207,0.384
"7712","ventura",7712,"2021-01-12",3042,27590,1612,19838,1430,7752,0,0,2017,17122,1025,5230,2017,22352,"California",852747,0.00613312037450733,251388,0.595,162207,0.384
"7713","ventura",7713,"2021-01-13",2925,30515,1424,21262,1501,9253,0,0,2041,18283,881,6111,2042,24394,"California",852747,0.00716625212401803,251388,0.595,162207,0.384
"7714","ventura",7714,"2021-01-14",2736,33251,1062,22324,1674,10927,0,0,2288,20125,447,6558,2289,26683,"California",852747,0.00769044042371301,251388,0.595,162207,0.384
"7715","ventura",7715,"2021-01-15",2890,36141,972,23296,1918,12845,0,0,2677,22590,213,6771,2678,29361,"California",852747,0.00794022142558109,251388,0.595,162207,0.384
"7716","ventura",7716,"2021-01-16",484,36625,187,23483,297,13142,0,0,404,22914,80,6851,404,29765,"California",852747,0.00803403588637662,251388,0.595,162207,0.384
"7717","ventura",7717,"2021-01-17",259,36884,137,23620,122,13264,0,0,253,23161,6,6857,253,30018,"California",852747,0.00804107197093628,251388,0.595,162207,0.384
"7718","ventura",7718,"2021-01-18",2219,39103,1673,25293,546,13810,0,0,1668,24280,550,7407,1669,31687,"California",852747,0.0086860463889055,251388,0.595,162207,0.384
"7719","ventura",7719,"2021-01-19",3042,42145,2120,27413,922,14732,0,0,2147,25535,895,8302,2150,33837,"California",852747,0.00973559566905542,251388,0.595,162207,0.384
"7720","ventura",7720,"2021-01-20",4095,46240,3143,30556,952,15684,0,0,3041,27526,1051,9353,3042,36879,"California",852747,0.0109680831477566,251388,0.595,162207,0.384
"7721","ventura",7721,"2021-01-21",3842,50082,2675,33231,1167,16851,0,0,3166,30021,673,10026,3168,40047,"California",852747,0.0117572972991989,251388,0.595,162207,0.384
"7722","ventura",7722,"2021-01-22",3615,53697,2494,35725,1121,17972,0,0,3453,33312,162,10188,3453,43500,"California",852747,0.0119472715823099,251388,0.595,162207,0.384
"7723","ventura",7723,"2021-01-23",1184,54881,649,36374,535,18507,0,0,1084,34299,99,10287,1086,44586,"California",852747,0.0120633669775443,251388,0.595,162207,0.384
"7724","ventura",7724,"2021-01-24",452,55333,137,36511,315,18822,0,0,439,34725,13,10300,439,45025,"California",852747,0.0120786118274236,251388,0.595,162207,0.384
"7725","ventura",7725,"2021-01-25",3154,58487,2031,38542,1123,19945,0,0,2598,36769,555,10855,2599,47624,"California",852747,0.0127294496491926,251388,0.595,162207,0.384
"7726","ventura",7726,"2021-01-26",3714,62201,2206,40748,1508,21453,0,0,2715,38487,998,11853,2716,50340,"California",852747,0.0138997850476167,251388,0.595,162207,0.384
"7727","ventura",7727,"2021-01-27",3462,65663,1560,42308,1902,23355,0,0,2719,40467,739,12592,2719,53059,"California",852747,0.0147663961292153,251388,0.595,162207,0.384
"7728","ventura",7728,"2021-01-28",3874,69537,1993,44301,1881,25236,0,0,3260,43131,597,13189,3261,56320,"California",852747,0.0154664865429019,251388,0.595,162207,0.384
"7729","ventura",7729,"2021-01-29",4271,73808,2525,46826,1746,26982,0,0,3768,46409,490,13679,3768,60088,"California",852747,0.0160411001152745,251388,0.595,162207,0.384
"7730","ventura",7730,"2021-01-30",3036,76844,1964,48790,1072,28054,0,0,2865,49108,167,13846,2866,62954,"California",852747,0.0162369378021852,251388,0.595,162207,0.384
"7731","ventura",7731,"2021-01-31",835,77679,446,49236,389,28443,0,0,748,49770,86,13932,748,63702,"California",852747,0.0163377883475404,251388,0.595,162207,0.384
"7732","ventura",7732,"2021-02-01",3944,81623,2113,51349,1831,30274,0,0,3169,52169,772,14704,3171,66873,"California",852747,0.0172430978942172,251388,0.595,162207,0.384
"7733","ventura",7733,"2021-02-02",4406,86029,2375,53724,2031,32305,0,0,3381,54530,1021,15725,3382,70255,"California",852747,0.01844040495012,251388,0.595,162207,0.384
"7734","ventura",7734,"2021-02-03",4453,90482,2089,55813,2364,34669,0,0,3443,56969,1005,16730,3444,73699,"California",852747,0.0196189491138638,251388,0.595,162207,0.384
"7735","ventura",7735,"2021-02-04",4776,95258,2287,58100,2489,37158,0,0,3519,59241,1249,17979,3521,77220,"California",852747,0.0210836273830339,251388,0.595,162207,0.384
"7736","ventura",7736,"2021-02-05",4838,100096,2317,60417,2521,39679,0,0,3345,61108,1480,19459,3347,80567,"California",852747,0.0228191949077511,251388,0.595,162207,0.384
"7737","ventura",7737,"2021-02-06",2837,102933,1515,61932,1322,41001,0,0,2434,63140,402,19861,2434,83001,"California",852747,0.0232906125732486,251388,0.595,162207,0.384
"7738","ventura",7738,"2021-02-07",710,103643,241,62173,469,41470,0,0,584,63599,126,19987,585,83586,"California",852747,0.0234383703490015,251388,0.595,162207,0.384
"7739","ventura",7739,"2021-02-08",3498,107141,1624,63797,1874,43344,0,0,2428,64962,1065,21052,2428,86014,"California",852747,0.0246872753583419,251388,0.595,162207,0.384
"7740","ventura",7740,"2021-02-09",4716,111857,1971,65768,2745,46089,0,0,2464,65178,2251,23303,2467,88481,"California",852747,0.027326979748976,251388,0.595,162207,0.384
"7741","ventura",7741,"2021-02-10",4716,116573,2237,68005,2479,48568,0,0,2390,65254,2315,25618,2391,90872,"California",852747,0.0300417357082464,251388,0.595,162207,0.384
"7742","ventura",7742,"2021-02-11",4663,121236,1863,69868,2800,51368,0,0,2447,65495,2209,27827,2450,93322,"California",852747,0.0326321875069628,251388,0.595,162207,0.384
"7743","ventura",7743,"2021-02-12",6305,127541,2661,72529,3644,55012,0,0,3223,65641,3077,30904,3223,96545,"California",852747,0.0362405262053106,251388,0.595,162207,0.384
"7744","ventura",7744,"2021-02-13",3298,130839,1826,74355,1472,56484,0,0,1844,66037,1450,32354,1846,98391,"California",852747,0.0379409133072295,251388,0.595,162207,0.384
"7745","ventura",7745,"2021-02-14",1226,132065,124,74479,1102,57586,0,0,1010,66832,216,32570,1011,99402,"California",852747,0.0381942123513774,251388,0.595,162207,0.384
"7746","ventura",7746,"2021-02-15",3987,136052,1798,76277,2189,59775,0,0,2118,67084,1866,34436,2118,101520,"California",852747,0.040382434649433,251388,0.595,162207,0.384
"7747","ventura",7747,"2021-02-16",5545,141597,2706,78983,2839,62614,0,0,3011,67569,2526,36962,3011,104531,"California",852747,0.0433446262490516,251388,0.595,162207,0.384
"7748","ventura",7748,"2021-02-17",5233,146830,1920,80903,3313,65927,0,0,3266,68877,1958,38920,3266,107797,"California",852747,0.045640735177022,251388,0.595,162207,0.384
"7749","ventura",7749,"2021-02-18",5777,152607,1830,82733,3947,69874,0,0,3633,70377,2133,41053,3633,111430,"California",852747,0.0481420632379827,251388,0.595,162207,0.384
"7750","ventura",7750,"2021-02-19",6455,159062,3771,86504,2684,72558,0,0,3010,69951,3438,44491,3012,114442,"California",852747,0.0521737396906703,251388,0.595,162207,0.384
"7751","ventura",7751,"2021-02-20",4938,164000,3171,89675,1767,74325,0,0,2771,70565,2161,46652,2775,117217,"California",852747,0.0547079028129093,251388,0.595,162207,0.384
"7752","ventura",7752,"2021-02-21",1049,165049,760,90435,289,74614,0,0,432,70386,611,47263,432,117649,"California",852747,0.0554244107572351,251388,0.595,162207,0.384
"7753","ventura",7753,"2021-02-22",5370,170419,2409,92844,2961,77575,0,0,3454,71933,1907,49170,3454,121103,"California",852747,0.0576607129664484,251388,0.595,162207,0.384
"7754","ventura",7754,"2021-02-23",5932,176351,2968,95812,2964,80539,0,0,3415,72849,2501,51671,3417,124520,"California",852747,0.0605935875470685,251388,0.595,162207,0.384
"7755","ventura",7755,"2021-02-24",6994,183345,2608,98420,4386,84925,0,0,4246,74362,2735,54406,4248,128768,"California",852747,0.0638008694255154,251388,0.595,162207,0.384
"7756","ventura",7756,"2021-02-25",7494,190839,2572,100992,4922,89847,0,0,4575,76034,2905,57311,4577,133345,"California",852747,0.0672075070331529,251388,0.595,162207,0.384
"7757","ventura",7757,"2021-02-26",9347,200186,2767,103759,6580,96427,0,0,6162,79040,3158,60469,6164,139509,"California",852747,0.0709108328730561,251388,0.595,162207,0.384
"7758","ventura",7758,"2021-02-27",9996,210182,5273,109032,4723,101150,0,0,7373,83816,2607,63076,7383,146892,"California",852747,0.0739680116142303,251388,0.595,162207,0.384
"7759","ventura",7759,"2021-02-28",2569,212751,1634,110666,934,102084,1,1,2096,85446,466,63542,2096,148988,"California",852747,0.0745144808483642,251388,0.595,162207,0.384
"7760","ventura",7760,"2021-03-01",6947,219698,2813,113479,4134,106218,0,1,4633,87789,2303,65845,4646,153634,"California",852747,0.0772151646385153,251388,0.595,162207,0.384
"7761","ventura",7761,"2021-03-02",7481,227179,3936,117415,3543,109761,2,3,5251,90820,2220,68065,5251,158885,"California",852747,0.0798185159255911,251388,0.595,162207,0.384
"7762","ventura",7762,"2021-03-03",8520,235699,3901,121316,4619,114380,0,3,6075,94469,2430,70495,6079,164964,"California",852747,0.0826681301722551,251388,0.595,162207,0.384
"7763","ventura",7763,"2021-03-04",8105,243804,3869,125185,4236,118616,0,3,5474,97329,2617,73112,5477,170441,"California",852747,0.0857370357210286,251388,0.595,162207,0.384
"7764","ventura",7764,"2021-03-05",9974,253778,4801,129986,5163,123779,10,13,7085,101557,2875,75987,7103,177544,"California",852747,0.0891084929058677,251388,0.595,162207,0.384
"7765","ventura",7765,"2021-03-06",7234,261012,4396,134382,2685,126464,153,166,5320,105124,1908,77895,5475,183019,"California",852747,0.091345967795841,251388,0.595,162207,0.384
"7766","ventura",7766,"2021-03-07",1655,262667,606,134988,947,127411,102,268,1236,106043,419,78314,1338,184357,"California",852747,0.0918373210342575,251388,0.595,162207,0.384
"7767","ventura",7767,"2021-03-08",6737,269404,3413,138401,3170,130581,154,422,4632,108733,2099,80413,4789,189146,"California",852747,0.0942987779493801,251388,0.595,162207,0.384
"7768","ventura",7768,"2021-03-09",6548,275952,2821,141222,3527,134108,200,622,3676,109753,2858,83271,3878,193024,"California",852747,0.0976502995613001,251388,0.595,162207,0.384
"7769","ventura",7769,"2021-03-10",6804,282756,2967,144189,3599,137707,238,860,4488,112174,2305,85576,4726,197750,"California",852747,0.100353328712971,251388,0.595,162207,0.384
"7770","ventura",7770,"2021-03-11",6374,289130,2888,147077,3173,140880,313,1173,3421,112966,2940,88516,3732,201482,"California",852747,0.103801010147207,251388,0.595,162207,0.384
"7771","ventura",7771,"2021-03-12",8519,297649,3037,150114,4637,145517,845,2018,4110,113529,4391,92907,4954,206436,"California",852747,0.108950251364121,251388,0.595,162207,0.384
"7772","ventura",7772,"2021-03-13",6685,304334,2498,152612,3345,148862,842,2860,3758,115209,2918,95825,4598,211034,"California",852747,0.112372133821638,251388,0.595,162207,0.384
"7773","ventura",7773,"2021-03-14",2131,306465,478,153090,1158,150020,495,3355,730,115035,1400,97225,1226,212260,"California",852747,0.114013886885559,251388,0.595,162207,0.384
"7774","ventura",7774,"2021-03-15",6917,313382,2048,155138,3520,153540,1349,4704,2975,115439,3917,101142,4321,216581,"California",852747,0.11860727742226,251388,0.595,162207,0.384
"7775","ventura",7775,"2021-03-16",7920,321302,2461,157599,4345,157885,1114,5818,3993,116632,3913,105055,5106,221687,"California",852747,0.123195977235921,251388,0.595,162207,0.384
"7776","ventura",7776,"2021-03-17",7474,328776,2768,160367,4358,162243,348,6166,4472,118474,2980,108035,4822,226509,"California",852747,0.126690565900554,251388,0.595,162207,0.384
"7777","ventura",7777,"2021-03-18",7224,336000,3271,163638,3801,166044,152,6318,4704,120822,2506,110541,4854,231363,"California",852747,0.129629303884974,251388,0.595,162207,0.384
"7778","ventura",7778,"2021-03-19",8404,344404,3778,167416,4513,170557,113,6431,5024,122596,3361,113902,5135,236498,"California",852747,0.133570683919146,251388,0.595,162207,0.384
"7779","ventura",7779,"2021-03-20",8145,352549,5246,172662,2879,173436,20,6451,3894,122284,4227,118129,3915,240413,"California",852747,0.138527605491429,251388,0.595,162207,0.384
"7780","ventura",7780,"2021-03-21",2781,355330,1510,174172,900,174336,371,6822,1318,122520,1452,119581,1688,242101,"California",852747,0.140230337954868,251388,0.595,162207,0.384
"7781","ventura",7781,"2021-03-22",7345,362675,3687,177859,3556,177892,102,6924,4843,124981,2486,122067,4947,247048,"California",852747,0.143145622324089,251388,0.595,162207,0.384
"7782","ventura",7782,"2021-03-23",8186,370861,3885,181744,4227,182119,74,6998,4672,126238,3488,125555,4745,251793,"California",852747,0.147235932814774,251388,0.595,162207,0.384
"7783","ventura",7783,"2021-03-24",8869,379730,3407,185151,5387,187506,75,7073,4430,126334,4409,129964,4505,256298,"California",852747,0.152406282285367,251388,0.595,162207,0.384
"7784","ventura",7784,"2021-03-25",8798,388528,3906,189057,4792,192298,100,7173,4452,126559,4329,134293,4554,260852,"California",852747,0.157482817295165,251388,0.595,162207,0.384
"7785","ventura",7785,"2021-03-26",9822,398350,3347,192404,5822,198120,653,7826,3905,125226,5889,140182,4556,265408,"California",852747,0.164388734290475,251388,0.595,162207,0.384
"7786","ventura",7786,"2021-03-27",8118,406468,3903,196307,4175,202295,40,7866,2406,121981,5692,145874,2447,267855,"California",852747,0.171063633176077,251388,0.595,162207,0.384
"7787","ventura",7787,"2021-03-28",2527,408995,1407,197714,1111,203406,9,7875,1384,122237,1137,147011,1393,269248,"California",852747,0.172396971200133,251388,0.595,162207,0.384
"7788","ventura",7788,"2021-03-29",8448,417443,4257,201971,4148,207554,43,7918,4222,122304,4198,151209,4265,273513,"California",852747,0.177319885030378,251388,0.595,162207,0.384
"7789","ventura",7789,"2021-03-30",8929,426372,4408,206379,4394,211948,127,8045,4528,122570,4387,155596,4653,278166,"California",852747,0.182464435524253,251388,0.595,162207,0.384
"7790","ventura",7790,"2021-03-31",10691,437063,4822,211201,5242,217190,627,8672,4642,121812,6027,161623,5269,283435,"California",852747,0.189532182464436,251388,0.595,162207,0.384
"7791","ventura",7791,"2021-04-01",10654,447717,5189,216390,4587,221777,878,9550,5368,122790,5266,166889,6244,289679,"California",852747,0.195707519346301,251388,0.595,162207,0.384
"7792","ventura",7792,"2021-04-02",11610,459327,4594,220984,5719,227496,1297,10847,5535,123581,6046,172935,6837,296516,"California",852747,0.202797547220922,251388,0.595,162207,0.384
"7793","ventura",7793,"2021-04-03",8018,467345,3956,224940,2922,230418,1140,11987,3365,123440,4643,177578,4502,301018,"California",852747,0.208242303989343,251388,0.595,162207,0.384
"7794","ventura",7794,"2021-04-04",1712,469057,959,225899,621,231039,132,12119,1154,124174,552,178130,1286,302304,"California",852747,0.208889623768832,251388,0.595,162207,0.384
"7795","ventura",7795,"2021-04-05",9295,478352,4867,230766,3332,234371,1096,13215,4722,125432,4562,182692,5820,308124,"California",852747,0.214239393395697,251388,0.595,162207,0.384
"7796","ventura",7796,"2021-04-06",10837,489189,5548,236314,3808,238179,1481,14696,5559,127216,5254,187946,7038,315162,"California",852747,0.220400658108442,251388,0.595,162207,0.384
"7797","ventura",7797,"2021-04-07",11295,500484,5426,241740,4393,242572,1476,16172,5165,127737,6115,194061,6636,321798,"California",852747,0.2275716009555,251388,0.595,162207,0.384
"7798","ventura",7798,"2021-04-08",10221,510705,5296,247036,3988,246560,937,17109,5101,128664,5103,199164,6030,327828,"California",852747,0.233555790873495,251388,0.595,162207,0.384
"7799","ventura",7799,"2021-04-09",11083,521788,4337,251373,5038,251598,1708,18817,4842,128984,6223,205387,6543,334371,"California",852747,0.240853383242626,251388,0.595,162207,0.384
"7800","ventura",7800,"2021-04-10",9137,530925,3507,254880,3476,255074,2154,20971,3005,128022,6116,211503,5154,339525,"California",852747,0.248025498770444,251388,0.595,162207,0.384
"7801","ventura",7801,"2021-04-11",2427,533352,863,255743,995,256069,569,21540,687,127543,1733,213236,1254,340779,"California",852747,0.250057754527427,251388,0.595,162207,0.384
"7802","ventura",7802,"2021-04-12",8876,542228,4465,260208,3604,259673,807,22347,3734,126954,5124,218360,4535,345314,"California",852747,0.256066570741381,251388,0.595,162207,0.384
"7803","ventura",7803,"2021-04-13",8766,550994,4445,264653,4315,263988,6,22353,3748,125722,4986,223346,3754,349068,"California",852747,0.261913557010461,251388,0.595,162207,0.384
"7804","ventura",7804,"2021-04-14",8655,559649,4061,268714,4579,268567,15,22368,3361,123839,5261,228607,3378,352446,"California",852747,0.268083030488527,251388,0.595,162207,0.384
"7805","ventura",7805,"2021-04-15",9287,568936,4518,273232,4762,273329,7,22375,4090,122760,5176,233783,4097,356543,"California",852747,0.274152826101997,251388,0.595,162207,0.384
"7806","ventura",7806,"2021-04-16",10102,579038,4478,277710,5623,278952,1,22376,4840,122355,5247,239030,4842,361385,"California",852747,0.280305882049424,251388,0.595,162207,0.384
"7807","ventura",7807,"2021-04-17",8531,587569,5298,283008,3232,282184,1,22377,4997,123830,3523,242553,4998,366383,"California",852747,0.284437236366707,251388,0.595,162207,0.384
"7808","ventura",7808,"2021-04-18",2129,589698,1013,284021,1116,283300,0,22377,906,123518,1218,243771,906,367289,"California",852747,0.285865561532319,251388,0.595,162207,0.384
"7809","ventura",7809,"2021-04-19",8006,597704,4840,288861,3165,286465,1,22378,4624,124779,3365,247136,4626,371915,"California",852747,0.28981163228953,251388,0.595,162207,0.384
"7810","ventura",7810,"2021-04-20",9213,606917,4898,293759,4313,290778,2,22380,4350,124284,4848,251984,4353,376268,"California",852747,0.295496788613739,251388,0.595,162207,0.384
"7811","ventura",7811,"2021-04-21",8835,615752,4535,298294,4297,295075,3,22383,4204,123875,4617,256601,4208,380476,"California",852747,0.300911055682401,251388,0.595,162207,0.384
"7812","ventura",7812,"2021-04-22",10029,625781,5483,303777,4546,299621,0,22383,4498,122860,5513,262114,4498,384974,"California",852747,0.307376044711972,251388,0.595,162207,0.384
"7813","ventura",7813,"2021-04-23",10795,636576,5386,309163,5409,305030,0,22383,5407,122904,5363,267477,5407,390381,"California",852747,0.313665131627552,251388,0.595,162207,0.384
"7814","ventura",7814,"2021-04-24",10318,646894,5895,315058,4423,309453,0,22383,6116,124829,4192,271669,6117,396498,"California",852747,0.318581009373237,251388,0.595,162207,0.384
"7815","ventura",7815,"2021-04-25",2470,649364,1699,316757,771,310224,0,22383,1141,124644,1326,272995,1141,397639,"California",852747,0.320135984060923,251388,0.595,162207,0.384
"7816","ventura",7816,"2021-04-26",6836,656200,3959,320716,2813,313037,64,22447,2819,123525,3998,276993,2879,400518,"California",852747,0.324824361739179,251388,0.595,162207,0.384
"7817","ventura",7817,"2021-04-27",8021,664221,4444,325160,3409,316446,168,22615,2995,121674,5013,282006,3162,403680,"California",852747,0.330703010388779,251388,0.595,162207,0.384
"7818","ventura",7818,"2021-04-28",8239,672460,4811,329971,3115,319561,313,22928,3213,120193,5007,287013,3526,407206,"California",852747,0.336574622953819,251388,0.595,162207,0.384
"7819","ventura",7819,"2021-04-29",7742,680202,4215,334186,3267,322828,260,23188,2744,118221,4974,291987,3002,410208,"California",852747,0.34240753705378,251388,0.595,162207,0.384
"7820","ventura",7820,"2021-04-30",9290,689492,5430,339616,3591,326419,269,23457,3848,116914,5416,297403,4109,414317,"California",852747,0.348758776049637,251388,0.595,162207,0.384
"7821","ventura",7821,"2021-05-01",4938,694430,3632,343248,1204,327623,102,23559,1869,115832,3053,300456,1971,416288,"California",852747,0.352338970409746,251388,0.595,162207,0.384
"7822","ventura",7822,"2021-05-02",2128,696558,1426,344674,613,328236,89,23648,1032,115861,1092,301548,1121,417409,"California",852747,0.353619537799605,251388,0.595,162207,0.384
"7823","ventura",7823,"2021-05-03",6197,702755,3901,348575,2021,330257,275,23923,1943,113845,4233,305781,2217,419626,"California",852747,0.358583495456448,251388,0.595,162207,0.384
"7824","ventura",7824,"2021-05-04",6244,708999,3295,351870,2651,332908,298,24221,2254,112420,3976,309757,2551,422177,"California",852747,0.363246074157986,251388,0.595,162207,0.384
"7825","ventura",7825,"2021-05-05",4710,713709,2866,354736,1590,334498,254,24475,1695,111368,2998,312755,1946,424123,"California",852747,0.366761771076298,251388,0.595,162207,0.384
"7826","ventura",7826,"2021-05-06",5313,719022,3095,357831,1969,336467,249,24724,1761,109844,3535,316290,2011,426134,"California",852747,0.3709071975627,251388,0.595,162207,0.384
"7827","ventura",7827,"2021-05-07",5846,724868,3206,361037,2381,338848,259,24983,2037,108355,3784,320074,2295,428429,"California",852747,0.375344621558329,251388,0.595,162207,0.384
"7828","ventura",7828,"2021-05-08",4965,729833,4006,365043,805,339653,154,25137,1092,105740,3861,323935,1246,429675,"California",852747,0.379872341972472,251388,0.595,162207,0.384
"7829","yolo",7829,"2020-12-15",39,39,39,39,0,0,0,0,39,39,0,0,39,39,"California",223612,0,67598,0.695,27292,0.281
"7830","yolo",7830,"2020-12-16",78,117,78,117,0,0,0,0,78,117,0,0,78,117,"California",223612,0,67598,0.695,27292,0.281
"7831","yolo",7831,"2020-12-17",101,218,101,218,0,0,0,0,101,218,0,0,101,218,"California",223612,0,67598,0.695,27292,0.281
"7832","yolo",7832,"2020-12-18",210,428,210,428,0,0,0,0,210,428,0,0,210,428,"California",223612,0,67598,0.695,27292,0.281
"7833","yolo",7833,"2020-12-19",88,516,88,516,0,0,0,0,88,516,0,0,88,516,"California",223612,0,67598,0.695,27292,0.281
"7834","yolo",7834,"2020-12-20",100,616,100,616,0,0,0,0,100,616,0,0,100,616,"California",223612,0,67598,0.695,27292,0.281
"7835","yolo",7835,"2020-12-21",253,869,253,869,0,0,0,0,253,869,0,0,253,869,"California",223612,0,67598,0.695,27292,0.281
"7836","yolo",7836,"2020-12-22",381,1250,380,1249,1,1,0,0,381,1250,0,0,381,1250,"California",223612,0,67598,0.695,27292,0.281
"7837","yolo",7837,"2020-12-23",432,1682,412,1661,20,21,0,0,432,1682,0,0,432,1682,"California",223612,0,67598,0.695,27292,0.281
"7838","yolo",7838,"2020-12-24",151,1833,95,1756,56,77,0,0,151,1833,0,0,151,1833,"California",223612,0,67598,0.695,27292,0.281
"7839","yolo",7839,"2020-12-25",1,1834,1,1757,0,77,0,0,1,1834,0,0,1,1834,"California",223612,0,67598,0.695,27292,0.281
"7840","yolo",7840,"2020-12-26",75,1909,25,1782,50,127,0,0,75,1909,0,0,75,1909,"California",223612,0,67598,0.695,27292,0.281
"7841","yolo",7841,"2020-12-27",46,1955,19,1801,27,154,0,0,46,1955,0,0,46,1955,"California",223612,0,67598,0.695,27292,0.281
"7842","yolo",7842,"2020-12-28",346,2301,179,1980,167,321,0,0,346,2301,0,0,346,2301,"California",223612,0,67598,0.695,27292,0.281
"7843","yolo",7843,"2020-12-29",488,2789,267,2247,221,542,0,0,488,2789,0,0,488,2789,"California",223612,0,67598,0.695,27292,0.281
"7844","yolo",7844,"2020-12-30",622,3411,254,2501,368,910,0,0,622,3411,0,0,622,3411,"California",223612,0,67598,0.695,27292,0.281
"7845","yolo",7845,"2020-12-31",185,3596,95,2596,90,1000,0,0,185,3596,0,0,185,3596,"California",223612,0,67598,0.695,27292,0.281
"7846","yolo",7846,"2021-01-01",58,3654,56,2652,2,1002,0,0,58,3654,0,0,58,3654,"California",223612,0,67598,0.695,27292,0.281
"7847","yolo",7847,"2021-01-02",68,3722,25,2677,43,1045,0,0,68,3722,0,0,68,3722,"California",223612,0,67598,0.695,27292,0.281
"7848","yolo",7848,"2021-01-03",44,3766,19,2696,25,1070,0,0,44,3766,0,0,44,3766,"California",223612,0,67598,0.695,27292,0.281
"7849","yolo",7849,"2021-01-04",193,3959,43,2739,150,1220,0,0,193,3959,0,0,193,3959,"California",223612,0,67598,0.695,27292,0.281
"7850","yolo",7850,"2021-01-05",612,4571,236,2975,376,1596,0,0,551,4449,61,61,551,4510,"California",223612,0.000272793946657603,67598,0.695,27292,0.281
"7851","yolo",7851,"2021-01-06",480,5051,183,3158,297,1893,0,0,349,4667,131,192,349,4859,"California",223612,0.000858630127184588,67598,0.695,27292,0.281
"7852","yolo",7852,"2021-01-07",709,5760,233,3391,476,2369,0,0,520,4999,188,380,520,5379,"California",223612,0.0016993721267195,67598,0.695,27292,0.281
"7853","yolo",7853,"2021-01-08",632,6392,311,3702,321,2690,0,0,416,5200,215,595,416,5795,"California",223612,0.00266085898788974,67598,0.695,27292,0.281
"7854","yolo",7854,"2021-01-09",410,6802,69,3771,341,3031,0,0,364,5518,46,641,364,6159,"California",223612,0.00286657245586105,67598,0.695,27292,0.281
"7855","yolo",7855,"2021-01-10",393,7195,80,3851,313,3344,0,0,323,5771,70,711,323,6482,"California",223612,0.00317961468973043,67598,0.695,27292,0.281
"7856","yolo",7856,"2021-01-11",562,7757,325,4176,237,3581,0,0,293,5797,269,980,295,6777,"California",223612,0.00438259127417133,67598,0.695,27292,0.281
"7857","yolo",7857,"2021-01-12",481,8238,364,4540,117,3698,0,0,173,5663,308,1288,174,6951,"California",223612,0.00575997710319661,67598,0.695,27292,0.281
"7858","yolo",7858,"2021-01-13",770,9008,312,4852,458,4156,0,0,520,5933,250,1538,520,7471,"California",223612,0.00687798508130154,67598,0.695,27292,0.281
"7859","yolo",7859,"2021-01-14",376,9384,182,5034,194,4350,0,0,272,6101,104,1642,272,7743,"California",223612,0.00734307640019319,67598,0.695,27292,0.281
"7860","yolo",7860,"2021-01-15",623,10007,318,5352,305,4655,0,0,544,6567,79,1721,545,8288,"California",223612,0.00769636692127435,67598,0.695,27292,0.281
"7861","yolo",7861,"2021-01-16",740,10747,95,5447,645,5300,0,0,709,7245,31,1752,709,8997,"California",223612,0.00783499991055936,67598,0.695,27292,0.281
"7862","yolo",7862,"2021-01-17",186,10933,117,5564,69,5369,0,0,179,7417,7,1759,179,9176,"California",223612,0.0078663041339463,67598,0.695,27292,0.281
"7863","yolo",7863,"2021-01-18",478,11411,303,5867,175,5544,0,0,379,7697,99,1858,379,9555,"California",223612,0.00830903529327585,67598,0.695,27292,0.281
"7864","yolo",7864,"2021-01-19",556,11967,372,6239,184,5728,0,0,381,7903,175,2033,381,9936,"California",223612,0.00909164087794931,67598,0.695,27292,0.281
"7865","yolo",7865,"2021-01-20",659,12626,379,6618,280,6008,0,0,474,8193,184,2217,474,10410,"California",223612,0.00991449474983453,67598,0.695,27292,0.281
"7866","yolo",7866,"2021-01-21",648,13274,382,7000,266,6274,0,0,460,8465,188,2405,460,10870,"California",223612,0.0107552367493694,67598,0.695,27292,0.281
"7867","yolo",7867,"2021-01-22",746,14020,250,7250,496,6770,0,0,629,8979,115,2520,629,11499,"California",223612,0.0112695204192977,67598,0.695,27292,0.281
"7868","yolo",7868,"2021-01-23",613,14633,123,7373,490,7260,0,0,566,9498,47,2567,566,12065,"California",223612,0.0114797059191814,67598,0.695,27292,0.281
"7869","yolo",7869,"2021-01-24",207,14840,124,7497,83,7343,0,0,166,9623,41,2608,166,12231,"California",223612,0.0116630592275906,67598,0.695,27292,0.281
"7870","yolo",7870,"2021-01-25",728,15568,153,7650,575,7918,0,0,514,9923,214,2822,514,12745,"California",223612,0.0126200740568485,67598,0.695,27292,0.281
"7871","yolo",7871,"2021-01-26",817,16385,327,7977,490,8408,0,0,428,9962,389,3211,428,13173,"California",223612,0.0143596944707797,67598,0.695,27292,0.281
"7872","yolo",7872,"2021-01-27",557,16942,223,8200,334,8742,0,0,383,10171,174,3385,383,13556,"California",223612,0.0151378280235408,67598,0.695,27292,0.281
"7873","yolo",7873,"2021-01-28",1051,17993,566,8766,485,9227,0,0,925,10971,125,3510,925,14481,"California",223612,0.0156968320125932,67598,0.695,27292,0.281
"7874","yolo",7874,"2021-01-29",871,18864,263,9029,608,9835,0,0,789,11679,81,3591,789,15270,"California",223612,0.0160590665974992,67598,0.695,27292,0.281
"7875","yolo",7875,"2021-01-30",1515,20379,915,9944,600,10435,0,0,1406,12982,103,3694,1406,16676,"California",223612,0.0165196858844785,67598,0.695,27292,0.281
"7876","yolo",7876,"2021-01-31",249,20628,211,10155,38,10473,0,0,214,13162,34,3728,214,16890,"California",223612,0.0166717349695007,67598,0.695,27292,0.281
"7877","yolo",7877,"2021-02-01",844,21472,360,10515,484,10957,0,0,614,13549,227,3955,614,17504,"California",223612,0.01768688621362,67598,0.695,27292,0.281
"7878","yolo",7878,"2021-02-02",1323,22795,746,11261,577,11534,0,0,931,14089,392,4347,932,18436,"California",223612,0.0194399227232886,67598,0.695,27292,0.281
"7879","yolo",7879,"2021-02-03",1515,24310,398,11659,1117,12651,0,0,1182,14941,330,4677,1182,19618,"California",223612,0.0209156932543871,67598,0.695,27292,0.281
"7880","yolo",7880,"2021-02-04",1787,26097,282,11941,1505,14156,0,0,1237,15640,539,5216,1238,20856,"California",223612,0.0233261184551813,67598,0.695,27292,0.281
"7881","yolo",7881,"2021-02-05",1592,27689,900,12841,692,14848,0,0,1197,16443,395,5611,1198,22054,"California",223612,0.0250925710605871,67598,0.695,27292,0.281
"7882","yolo",7882,"2021-02-06",1917,29606,1247,14088,670,15518,0,0,1556,17639,361,5972,1557,23611,"California",223612,0.0267069745809706,67598,0.695,27292,0.281
"7883","yolo",7883,"2021-02-07",519,30125,249,14337,270,15788,0,0,171,17463,347,6319,171,23782,"California",223612,0.0282587696545803,67598,0.695,27292,0.281
"7884","yolo",7884,"2021-02-08",948,31073,332,14669,616,16404,0,0,605,17728,340,6659,605,24387,"California",223612,0.029779260504803,67598,0.695,27292,0.281
"7885","yolo",7885,"2021-02-09",860,31933,387,15056,473,16877,0,0,577,18022,283,6942,577,24964,"California",223612,0.0310448455360177,67598,0.695,27292,0.281
"7886","yolo",7886,"2021-02-10",1458,33391,476,15532,982,17859,0,0,821,18208,637,7579,823,25787,"California",223612,0.0338935298642291,67598,0.695,27292,0.281
"7887","yolo",7887,"2021-02-11",1567,34958,799,16331,768,18627,0,0,1185,19011,382,7961,1185,26972,"California",223612,0.0356018460547734,67598,0.695,27292,0.281
"7888","yolo",7888,"2021-02-12",1910,36868,750,17081,1160,19787,0,0,1442,19989,464,8425,1442,28414,"California",223612,0.0376768688621362,67598,0.695,27292,0.281
"7889","yolo",7889,"2021-02-13",2056,38924,712,17793,1344,21131,0,0,1391,20715,665,9090,1391,29805,"California",223612,0.0406507700838953,67598,0.695,27292,0.281
"7890","yolo",7890,"2021-02-14",571,39495,155,17948,416,21547,0,0,446,21037,124,9214,446,30251,"California",223612,0.0412053020410354,67598,0.695,27292,0.281
"7891","yolo",7891,"2021-02-15",531,40026,189,18137,342,21889,0,0,266,21039,265,9479,267,30518,"California",223612,0.0423903904978266,67598,0.695,27292,0.281
"7892","yolo",7892,"2021-02-16",1130,41156,426,18563,704,22593,0,0,812,21533,318,9797,812,31330,"California",223612,0.0438124966459761,67598,0.695,27292,0.281
"7893","yolo",7893,"2021-02-17",1390,42546,701,19264,689,23282,0,0,995,22133,395,10192,995,32325,"California",223612,0.0455789492513819,67598,0.695,27292,0.281
"7894","yolo",7894,"2021-02-18",2497,45043,814,20078,1683,24965,0,0,1727,23091,770,10962,1728,34053,"California",223612,0.049022413823945,67598,0.695,27292,0.281
"7895","yolo",7895,"2021-02-19",1742,46785,745,20823,997,25962,0,0,1121,23593,619,11581,1121,35174,"California",223612,0.0517906015777329,67598,0.695,27292,0.281
"7896","yolo",7896,"2021-02-20",2443,49228,949,21772,1494,27456,0,0,1373,23902,1065,12646,1374,36548,"California",223612,0.0565533155644599,67598,0.695,27292,0.281
"7897","yolo",7897,"2021-02-21",282,49510,225,21997,57,27513,0,0,73,23767,208,12854,73,36621,"California",223612,0.0574834982022432,67598,0.695,27292,0.281
"7898","yolo",7898,"2021-02-22",1362,50872,601,22598,761,28274,0,0,693,23792,668,13522,693,37314,"California",223612,0.0604708155197395,67598,0.695,27292,0.281
"7899","yolo",7899,"2021-02-23",1125,51997,842,23440,283,28557,0,0,438,23545,685,14207,438,37752,"California",223612,0.0635341573797471,67598,0.695,27292,0.281
"7900","yolo",7900,"2021-02-24",2091,54088,590,24030,1501,30058,0,0,1381,24218,708,14915,1381,39133,"California",223612,0.0667003559737402,67598,0.695,27292,0.281
"7901","yolo",7901,"2021-02-25",1380,55468,485,24515,895,30953,0,0,914,24667,465,15380,914,40047,"California",223612,0.0687798508130154,67598,0.695,27292,0.281
"7902","yolo",7902,"2021-02-26",2600,58068,1012,25527,1588,32541,0,0,1394,24858,1203,16583,1394,41441,"California",223612,0.0741597052036563,67598,0.695,27292,0.281
"7903","yolo",7903,"2021-02-27",1657,59725,766,26293,891,33432,0,0,1207,25615,450,17033,1207,42648,"California",223612,0.0761721195642452,67598,0.695,27292,0.281
"7904","yolo",7904,"2021-02-28",1775,61500,1493,27786,282,33714,0,0,680,25202,1093,18126,680,43328,"California",223612,0.08106005044452,67598,0.695,27292,0.281
"7905","yolo",7905,"2021-03-01",1102,62602,365,28151,737,34451,0,0,670,25442,430,18556,670,43998,"California",223612,0.0829830241668605,67598,0.695,27292,0.281
"7906","yolo",7906,"2021-03-02",1462,64064,681,28832,781,35232,0,0,931,25842,531,19087,931,44929,"California",223612,0.0853576731123553,67598,0.695,27292,0.281
"7907","yolo",7907,"2021-03-03",1840,65904,630,29462,1210,36442,0,0,833,25670,1005,20092,833,45762,"California",223612,0.0898520651843372,67598,0.695,27292,0.281
"7908","yolo",7908,"2021-03-04",2909,68813,1453,30915,1456,37898,0,0,1575,25914,1331,21423,1575,47337,"California",223612,0.0958043396597678,67598,0.695,27292,0.281
"7909","yolo",7909,"2021-03-05",2350,71163,1398,32313,941,38839,11,11,1472,26520,877,22300,1483,48820,"California",223612,0.0997263116469599,67598,0.695,27292,0.281
"7910","yolo",7910,"2021-03-06",1470,72633,1122,33435,319,39158,29,40,837,26756,630,22930,866,49686,"California",223612,0.102543691751784,67598,0.695,27292,0.281
"7911","yolo",7911,"2021-03-07",908,73541,673,34108,221,39379,14,54,772,27406,136,23066,786,50472,"California",223612,0.103151888091873,67598,0.695,27292,0.281
"7912","yolo",7912,"2021-03-08",1091,74632,486,34594,562,39941,43,97,763,27886,327,23393,807,51279,"California",223612,0.104614242527235,67598,0.695,27292,0.281
"7913","yolo",7913,"2021-03-09",1244,75876,671,35265,512,40453,61,158,754,28213,488,23881,815,52094,"California",223612,0.106796594100495,67598,0.695,27292,0.281
"7914","yolo",7914,"2021-03-10",1797,77673,1049,36314,459,40912,289,447,751,28204,1043,24924,1034,53128,"California",223612,0.111460923385149,67598,0.695,27292,0.281
"7915","yolo",7915,"2021-03-11",2345,80018,1601,37915,678,41590,66,513,1601,29129,743,25667,1668,54796,"California",223612,0.114783643096077,67598,0.695,27292,0.281
"7916","yolo",7916,"2021-03-12",2895,82913,1344,39259,1471,43061,80,593,1373,29067,1514,27181,1452,56248,"California",223612,0.121554299411481,67598,0.695,27292,0.281
"7917","yolo",7917,"2021-03-13",1844,84757,730,39989,937,43998,177,770,999,29401,842,28023,1176,57424,"California",223612,0.125319750281738,67598,0.695,27292,0.281
"7918","yolo",7918,"2021-03-14",1004,85761,211,40200,643,44641,150,920,523,29589,480,28503,668,58092,"California",223612,0.127466325599699,67598,0.695,27292,0.281
"7919","yolo",7919,"2021-03-15",1325,87086,774,40974,375,45016,176,1096,709,29858,614,29117,883,58975,"California",223612,0.130212153193925,67598,0.695,27292,0.281
"7920","yolo",7920,"2021-03-16",1869,88955,717,41691,1080,46096,72,1168,1103,30267,766,29883,1175,60150,"California",223612,0.133637729638839,67598,0.695,27292,0.281
"7921","yolo",7921,"2021-03-17",2487,91442,969,42660,1446,47542,72,1240,1705,31296,779,30662,1808,61958,"California",223612,0.137121442498614,67598,0.695,27292,0.281
"7922","yolo",7922,"2021-03-18",3017,94459,1018,43678,1775,49317,224,1464,1262,31031,1751,32413,1486,63444,"California",223612,0.144951970377261,67598,0.695,27292,0.281
"7923","yolo",7923,"2021-03-19",2086,96545,863,44541,1155,50472,68,1532,1095,31209,985,33398,1163,64607,"California",223612,0.149356921810994,67598,0.695,27292,0.281
"7924","yolo",7924,"2021-03-20",2749,99294,817,45358,1891,52363,41,1573,1115,30739,1628,35026,1158,65765,"California",223612,0.156637389764413,67598,0.695,27292,0.281
"7925","yolo",7925,"2021-03-21",316,99610,215,45573,93,52456,8,1581,229,30890,86,35112,237,66002,"California",223612,0.157021984508881,67598,0.695,27292,0.281
"7926","yolo",7926,"2021-03-22",1399,101009,487,46060,853,53309,59,1640,918,31388,478,35590,976,66978,"California",223612,0.159159615763018,67598,0.695,27292,0.281
"7927","yolo",7927,"2021-03-23",1732,102741,933,46993,743,54052,56,1696,1074,31860,657,36247,1129,68107,"California",223612,0.162097740729478,67598,0.695,27292,0.281
"7928","yolo",7928,"2021-03-24",2851,105592,1393,48386,1409,55461,49,1745,1423,31917,1416,37663,1473,69580,"California",223612,0.168430137917464,67598,0.695,27292,0.281
"7929","yolo",7929,"2021-03-25",2539,108131,1407,49793,1105,56566,27,1772,1258,31931,1271,38934,1285,70865,"California",223612,0.17411409047815,67598,0.695,27292,0.281
"7930","yolo",7930,"2021-03-26",2397,110528,1254,51047,1124,57690,19,1791,1033,31625,1357,40291,1051,71916,"California",223612,0.180182637783303,67598,0.695,27292,0.281
"7931","yolo",7931,"2021-03-27",1650,112178,455,51502,1179,58869,16,1807,762,31516,887,41178,778,72694,"California",223612,0.18414933008962,67598,0.695,27292,0.281
"7932","yolo",7932,"2021-03-28",1107,113285,862,52364,227,59096,18,1825,277,30985,826,42004,295,72989,"California",223612,0.187843228449278,67598,0.695,27292,0.281
"7933","yolo",7933,"2021-03-29",2012,115297,821,53185,1161,60257,30,1855,983,30973,1025,43029,1013,74002,"California",223612,0.192427061159508,67598,0.695,27292,0.281
"7934","yolo",7934,"2021-03-30",2269,117566,1069,54254,1177,61434,23,1878,1181,31094,1083,44112,1204,75206,"California",223612,0.197270271720659,67598,0.695,27292,0.281
"7935","yolo",7935,"2021-03-31",2342,119908,1215,55469,1091,62525,36,1914,1198,31185,1143,45255,1234,76440,"California",223612,0.202381804196555,67598,0.695,27292,0.281
"7936","yolo",7936,"2021-04-01",3828,123736,1840,57309,1513,64038,475,2389,1617,31068,2208,47463,2091,78531,"California",223612,0.212256050659177,67598,0.695,27292,0.281
"7937","yolo",7937,"2021-04-02",3375,127111,1502,58811,1729,65767,144,2533,2089,32021,1280,48743,2233,80764,"California",223612,0.217980251507075,67598,0.695,27292,0.281
"7938","yolo",7938,"2021-04-03",1786,128897,1078,59889,493,66260,215,2748,797,32045,988,49731,1012,81776,"California",223612,0.222398619036545,67598,0.695,27292,0.281
"7939","yolo",7939,"2021-04-04",386,129283,150,60039,174,66434,62,2810,145,32011,241,49972,207,81983,"California",223612,0.223476378727439,67598,0.695,27292,0.281
"7940","yolo",7940,"2021-04-05",1904,131187,731,60770,1075,67509,98,2908,1008,32226,891,50863,1106,83089,"California",223612,0.227460959161405,67598,0.695,27292,0.281
"7941","yolo",7941,"2021-04-06",2567,133754,1301,62071,1095,68604,171,3079,1315,32470,1243,52106,1487,84576,"California",223612,0.233019694828542,67598,0.695,27292,0.281
"7942","yolo",7942,"2021-04-07",2967,136721,1511,63582,1105,69709,351,3430,1916,33696,1045,53151,2271,86847,"California",223612,0.237692968177021,67598,0.695,27292,0.281
"7943","yolo",7943,"2021-04-08",2414,139135,1000,64582,943,70652,471,3901,1023,33799,1387,54538,1490,88337,"California",223612,0.243895676439547,67598,0.695,27292,0.281
"7944","yolo",7944,"2021-04-09",2570,141705,915,65497,1078,71730,577,4478,842,33486,1725,56263,1412,89749,"California",223612,0.251609931488471,67598,0.695,27292,0.281
"7945","yolo",7945,"2021-04-10",1726,143431,810,66307,740,72470,176,4654,1020,33979,702,56965,1195,90944,"California",223612,0.25474929789099,67598,0.695,27292,0.281
"7946","yolo",7946,"2021-04-11",887,144318,282,66589,560,73030,45,4699,363,33865,521,57486,407,91351,"California",223612,0.25707922651736,67598,0.695,27292,0.281
"7947","yolo",7947,"2021-04-12",1762,146080,522,67111,1096,74126,144,4843,1089,34428,670,58156,1233,92584,"California",223612,0.260075487898682,67598,0.695,27292,0.281
"7948","yolo",7948,"2021-04-13",1966,148046,910,68021,1056,75182,0,4843,1036,34535,929,59085,1036,93620,"California",223612,0.26423000554532,67598,0.695,27292,0.281
"7949","yolo",7949,"2021-04-14",2756,150802,756,68777,2000,77182,0,4843,1370,34523,1382,60467,1370,94990,"California",223612,0.270410353648284,67598,0.695,27292,0.281
"7950","yolo",7950,"2021-04-15",3310,154112,1134,69911,2176,79358,0,4843,2270,35758,1035,61502,2270,97260,"California",223612,0.275038906677638,67598,0.695,27292,0.281
"7951","yolo",7951,"2021-04-16",3029,157141,1952,71863,1077,80435,0,4843,1928,36592,1094,62596,1928,99188,"California",223612,0.279931309589825,67598,0.695,27292,0.281
"7952","yolo",7952,"2021-04-17",1597,158738,467,72330,1130,81565,0,4843,824,36646,770,63366,824,100012,"California",223612,0.283374774162388,67598,0.695,27292,0.281
"7953","yolo",7953,"2021-04-18",631,159369,303,72633,328,81893,0,4843,352,36722,276,63642,352,100364,"California",223612,0.284609054970216,67598,0.695,27292,0.281
"7954","yolo",7954,"2021-04-19",1667,161036,719,73352,947,82840,1,4844,769,36599,893,64535,770,101134,"California",223612,0.288602579468007,67598,0.695,27292,0.281
"7955","yolo",7955,"2021-04-20",2000,163036,1012,74364,988,83828,0,4844,1074,36749,924,65459,1074,102208,"California",223612,0.292734736955083,67598,0.695,27292,0.281
"7956","yolo",7956,"2021-04-21",1994,165030,992,75356,1002,84830,0,4844,1094,36947,896,66355,1094,103302,"California",223612,0.296741677548611,67598,0.695,27292,0.281
"7957","yolo",7957,"2021-04-22",1931,166961,874,76230,1057,85887,0,4844,960,36942,966,67321,961,104263,"California",223612,0.301061660376008,67598,0.695,27292,0.281
"7958","yolo",7958,"2021-04-23",2610,169571,1523,77753,1087,86974,0,4844,1169,36680,1431,68752,1169,105432,"California",223612,0.307461138042681,67598,0.695,27292,0.281
"7959","yolo",7959,"2021-04-24",1152,170723,630,78383,520,87494,2,4846,454,36446,690,69442,456,105888,"California",223612,0.310546840062251,67598,0.695,27292,0.281
"7960","yolo",7960,"2021-04-25",943,171666,402,78785,541,88035,0,4846,722,36948,220,69662,722,106610,"California",223612,0.311530687082983,67598,0.695,27292,0.281
"7961","yolo",7961,"2021-04-26",1161,172827,437,79222,721,88756,3,4849,474,36741,685,70347,478,107088,"California",223612,0.314594028942991,67598,0.695,27292,0.281
"7962","yolo",7962,"2021-04-27",1454,174281,665,79887,780,89536,9,4858,557,36412,897,71244,568,107656,"California",223612,0.318605441568431,67598,0.695,27292,0.281
"7963","yolo",7963,"2021-04-28",2011,176292,994,80881,990,90526,27,4885,703,35837,1305,72549,730,108386,"California",223612,0.324441443214139,67598,0.695,27292,0.281
"7964","yolo",7964,"2021-04-29",1724,178016,800,81681,841,91367,83,4968,662,35521,1061,73610,745,109131,"California",223612,0.329186269073216,67598,0.695,27292,0.281
"7965","yolo",7965,"2021-04-30",2003,180019,990,82671,956,92323,57,5025,961,35503,1036,74646,1018,110149,"California",223612,0.333819294134483,67598,0.695,27292,0.281
"7966","yolo",7966,"2021-05-01",1271,181290,985,83656,266,92589,20,5045,375,35003,895,75541,395,110544,"California",223612,0.337821762696099,67598,0.695,27292,0.281
"7967","yolo",7967,"2021-05-02",495,181785,401,84057,71,92660,23,5068,321,35173,174,75715,344,110888,"California",223612,0.33859989624886,67598,0.695,27292,0.281
"7968","yolo",7968,"2021-05-03",1117,182902,403,84460,681,93341,33,5101,299,34689,815,76530,331,111219,"California",223612,0.342244602257482,67598,0.695,27292,0.281
"7969","yolo",7969,"2021-05-04",1446,184348,658,85118,762,94103,26,5127,491,34255,951,77481,517,111736,"California",223612,0.346497504606193,67598,0.695,27292,0.281
"7970","yolo",7970,"2021-05-05",1538,185886,419,85537,1058,95161,61,5188,436,33659,1093,78574,497,112233,"California",223612,0.351385435486468,67598,0.695,27292,0.281
"7971","yolo",7971,"2021-05-06",1499,187385,704,86241,717,95878,78,5266,495,33241,990,79564,572,112805,"California",223612,0.355812747079763,67598,0.695,27292,0.281
"7972","yolo",7972,"2021-05-07",2273,189658,1368,87609,861,96739,44,5310,453,31924,1814,81378,497,113302,"California",223612,0.363925012968893,67598,0.695,27292,0.281
"7973","yolo",7973,"2021-05-08",816,190474,352,87961,407,97146,57,5367,303,31773,510,81888,359,113661,"California",223612,0.366205749244227,67598,0.695,27292,0.281
"7974","yuba",7974,"2020-12-16",4,4,4,4,0,0,0,0,4,4,0,0,4,4,"California",79290,0,11230,0.377,17676,0.593
"7975","yuba",7975,"2020-12-17",4,8,4,8,0,0,0,0,4,8,0,0,4,8,"California",79290,0,11230,0.377,17676,0.593
"7976","yuba",7976,"2020-12-18",8,16,8,16,0,0,0,0,8,16,0,0,8,16,"California",79290,0,11230,0.377,17676,0.593
"7977","yuba",7977,"2020-12-19",12,28,12,28,0,0,0,0,12,28,0,0,12,28,"California",79290,0,11230,0.377,17676,0.593
"7978","yuba",7978,"2020-12-20",20,48,20,48,0,0,0,0,20,48,0,0,20,48,"California",79290,0,11230,0.377,17676,0.593
"7979","yuba",7979,"2020-12-21",40,88,40,88,0,0,0,0,40,88,0,0,40,88,"California",79290,0,11230,0.377,17676,0.593
"7980","yuba",7980,"2020-12-22",86,174,86,174,0,0,0,0,86,174,0,0,86,174,"California",79290,0,11230,0.377,17676,0.593
"7981","yuba",7981,"2020-12-23",64,238,62,236,2,2,0,0,64,238,0,0,64,238,"California",79290,0,11230,0.377,17676,0.593
"7982","yuba",7982,"2020-12-24",20,258,10,246,10,12,0,0,20,258,0,0,20,258,"California",79290,0,11230,0.377,17676,0.593
"7983","yuba",7983,"2020-12-26",15,273,13,259,2,14,0,0,15,273,0,0,15,273,"California",79290,0,11230,0.377,17676,0.593
"7984","yuba",7984,"2020-12-27",15,288,15,274,0,14,0,0,15,288,0,0,15,288,"California",79290,0,11230,0.377,17676,0.593
"7985","yuba",7985,"2020-12-28",51,339,35,309,16,30,0,0,51,339,0,0,51,339,"California",79290,0,11230,0.377,17676,0.593
"7986","yuba",7986,"2020-12-29",75,414,10,319,65,95,0,0,75,414,0,0,75,414,"California",79290,0,11230,0.377,17676,0.593
"7987","yuba",7987,"2020-12-30",64,478,20,339,44,139,0,0,64,478,0,0,64,478,"California",79290,0,11230,0.377,17676,0.593
"7988","yuba",7988,"2020-12-31",38,516,7,346,31,170,0,0,38,516,0,0,38,516,"California",79290,0,11230,0.377,17676,0.593
"7989","yuba",7989,"2021-01-02",23,539,22,368,1,171,0,0,23,539,0,0,23,539,"California",79290,0,11230,0.377,17676,0.593
"7990","yuba",7990,"2021-01-03",10,549,6,374,4,175,0,0,10,549,0,0,10,549,"California",79290,0,11230,0.377,17676,0.593
"7991","yuba",7991,"2021-01-04",90,639,21,395,69,244,0,0,90,639,0,0,90,639,"California",79290,0,11230,0.377,17676,0.593
"7992","yuba",7992,"2021-01-05",70,709,38,433,32,276,0,0,69,707,1,1,69,708,"California",79290,1.26119308866187e-05,11230,0.377,17676,0.593
"7993","yuba",7993,"2021-01-06",154,863,76,509,78,354,0,0,148,849,6,7,148,856,"California",79290,8.82835162063312e-05,11230,0.377,17676,0.593
"7994","yuba",7994,"2021-01-07",75,938,19,528,56,410,0,0,72,917,4,11,72,928,"California",79290,0.000138731239752806,11230,0.377,17676,0.593
"7995","yuba",7995,"2021-01-08",73,1011,25,553,48,458,0,0,66,976,7,18,66,994,"California",79290,0.000227014755959137,11230,0.377,17676,0.593
"7996","yuba",7996,"2021-01-09",19,1030,16,569,3,461,0,0,11,979,8,26,11,1005,"California",79290,0.000327910203052087,11230,0.377,17676,0.593
"7997","yuba",7997,"2021-01-10",117,1147,22,591,95,556,0,0,95,1052,22,48,95,1100,"California",79290,0.0006053726825577,11230,0.377,17676,0.593
"7998","yuba",7998,"2021-01-11",72,1219,50,641,22,578,0,0,32,1044,40,88,32,1132,"California",79290,0.00110984991802245,11230,0.377,17676,0.593
"7999","yuba",7999,"2021-01-12",107,1326,77,718,30,608,0,0,42,1021,65,153,42,1174,"California",79290,0.00192962542565267,11230,0.377,17676,0.593
"8000","yuba",8000,"2021-01-13",119,1445,72,790,47,655,0,0,54,1011,64,217,54,1228,"California",79290,0.00273678900239627,11230,0.377,17676,0.593
"8001","yuba",8001,"2021-01-14",109,1554,43,833,66,721,0,0,97,1096,12,229,97,1325,"California",79290,0.00288813217303569,11230,0.377,17676,0.593
"8002","yuba",8002,"2021-01-15",206,1760,88,921,118,839,0,0,195,1280,11,240,195,1520,"California",79290,0.0030268634127885,11230,0.377,17676,0.593
"8003","yuba",8003,"2021-01-16",184,1944,21,942,163,1002,0,0,172,1439,13,253,172,1692,"California",79290,0.00319081851431454,11230,0.377,17676,0.593
"8004","yuba",8004,"2021-01-17",13,1957,9,951,4,1006,0,0,7,1440,6,259,7,1699,"California",79290,0.00326649009963425,11230,0.377,17676,0.593
"8005","yuba",8005,"2021-01-18",60,2017,32,983,28,1034,0,0,35,1450,25,284,35,1734,"California",79290,0.00358178837179972,11230,0.377,17676,0.593
"8006","yuba",8006,"2021-01-19",80,2097,29,1012,51,1085,0,0,65,1500,15,299,65,1799,"California",79290,0.003770967335099,11230,0.377,17676,0.593
"8007","yuba",8007,"2021-01-20",133,2230,87,1099,46,1131,0,0,110,1587,23,322,110,1909,"California",79290,0.00406104174549123,11230,0.377,17676,0.593
"8008","yuba",8008,"2021-01-21",213,2443,97,1196,116,1247,0,0,205,1784,8,330,205,2114,"California",79290,0.00416193719258418,11230,0.377,17676,0.593
"8009","yuba",8009,"2021-01-22",103,2546,6,1202,97,1344,0,0,94,1869,9,339,94,2208,"California",79290,0.00427544457056375,11230,0.377,17676,0.593
"8010","yuba",8010,"2021-01-23",200,2746,7,1209,193,1537,0,0,197,2063,3,342,197,2405,"California",79290,0.00431328036322361,11230,0.377,17676,0.593
"8011","yuba",8011,"2021-01-24",10,2756,7,1216,3,1540,0,0,8,2069,2,344,8,2413,"California",79290,0.00433850422499685,11230,0.377,17676,0.593
"8012","yuba",8012,"2021-01-25",84,2840,28,1244,56,1596,0,0,53,2092,30,374,53,2466,"California",79290,0.00471686215159541,11230,0.377,17676,0.593
"8013","yuba",8013,"2021-01-26",148,2988,39,1283,109,1705,0,0,90,2124,58,432,90,2556,"California",79290,0.0054483541430193,11230,0.377,17676,0.593
"8014","yuba",8014,"2021-01-27",183,3171,128,1411,55,1760,0,0,115,2171,68,500,115,2671,"California",79290,0.00630596544330937,11230,0.377,17676,0.593
"8015","yuba",8015,"2021-01-28",217,3388,79,1490,138,1898,0,0,175,2304,42,542,175,2846,"California",79290,0.00683566654054736,11230,0.377,17676,0.593
"8016","yuba",8016,"2021-01-29",159,3547,56,1546,103,2001,0,0,112,2369,47,589,112,2958,"California",79290,0.00742842729221844,11230,0.377,17676,0.593
"8017","yuba",8017,"2021-01-30",410,3957,23,1569,387,2388,0,0,399,2757,11,600,399,3357,"California",79290,0.00756715853197124,11230,0.377,17676,0.593
"8018","yuba",8018,"2021-01-31",17,3974,12,1581,5,2393,0,0,15,2770,2,602,15,3372,"California",79290,0.00759238239374448,11230,0.377,17676,0.593
"8019","yuba",8019,"2021-02-01",155,4129,75,1656,80,2473,0,0,131,2879,23,625,132,3504,"California",79290,0.00788245680413671,11230,0.377,17676,0.593
"8020","yuba",8020,"2021-02-02",123,4252,23,1679,100,2573,0,0,101,2958,22,647,101,3605,"California",79290,0.00815991928364233,11230,0.377,17676,0.593
"8021","yuba",8021,"2021-02-03",226,4478,29,1708,197,2770,0,0,114,2961,111,758,114,3719,"California",79290,0.00955984361205701,11230,0.377,17676,0.593
"8022","yuba",8022,"2021-02-04",295,4773,120,1828,175,2945,0,0,252,3170,43,801,252,3971,"California",79290,0.0101021566401816,11230,0.377,17676,0.593
"8023","yuba",8023,"2021-02-05",147,4920,32,1860,115,3060,0,0,71,3165,76,877,71,4042,"California",79290,0.0110606633875646,11230,0.377,17676,0.593
"8024","yuba",8024,"2021-02-06",450,5370,26,1886,424,3484,0,0,442,3599,8,885,442,4484,"California",79290,0.0111615588346576,11230,0.377,17676,0.593
"8025","yuba",8025,"2021-02-07",18,5388,11,1897,7,3491,0,0,15,3611,3,888,15,4499,"California",79290,0.0111993946273174,11230,0.377,17676,0.593
"8026","yuba",8026,"2021-02-08",96,5484,35,1932,61,3552,0,0,66,3647,30,918,66,4565,"California",79290,0.011577752553916,11230,0.377,17676,0.593
"8027","yuba",8027,"2021-02-09",154,5638,56,1988,98,3650,0,0,84,3661,70,988,84,4649,"California",79290,0.0124605877159793,11230,0.377,17676,0.593
"8028","yuba",8028,"2021-02-10",352,5990,172,2160,180,3830,0,0,114,3538,237,1225,114,4763,"California",79290,0.015449615336108,11230,0.377,17676,0.593
"8029","yuba",8029,"2021-02-11",396,6386,63,2223,333,4163,0,0,299,3742,95,1320,299,5062,"California",79290,0.0166477487703367,11230,0.377,17676,0.593
"8030","yuba",8030,"2021-02-12",265,6651,27,2250,238,4401,0,0,151,3779,114,1434,151,5213,"California",79290,0.0180855088914113,11230,0.377,17676,0.593
"8031","yuba",8031,"2021-02-13",435,7086,35,2285,400,4801,0,0,387,4118,48,1482,387,5600,"California",79290,0.018690881573969,11230,0.377,17676,0.593
"8032","yuba",8032,"2021-02-14",54,7140,11,2296,43,4844,0,0,49,4162,5,1487,49,5649,"California",79290,0.0187539412284021,11230,0.377,17676,0.593
"8033","yuba",8033,"2021-02-15",87,7227,36,2332,51,4895,0,0,68,4211,19,1506,68,5717,"California",79290,0.0189935679152478,11230,0.377,17676,0.593
"8034","yuba",8034,"2021-02-16",199,7426,53,2385,146,5041,0,0,140,4293,58,1564,140,5857,"California",79290,0.0197250599066717,11230,0.377,17676,0.593
"8035","yuba",8035,"2021-02-17",372,7798,156,2541,216,5257,0,0,99,4120,272,1836,99,5956,"California",79290,0.023155505107832,11230,0.377,17676,0.593
"8036","yuba",8036,"2021-02-18",317,8115,46,2587,271,5528,0,0,194,4191,123,1959,194,6150,"California",79290,0.0247067726068861,11230,0.377,17676,0.593
"8037","yuba",8037,"2021-02-19",225,8340,83,2670,142,5670,0,0,142,4250,83,2042,142,6292,"California",79290,0.0257535628704755,11230,0.377,17676,0.593
"8038","yuba",8038,"2021-02-20",390,8730,31,2701,359,6029,0,0,336,4532,54,2096,336,6628,"California",79290,0.0264346071383529,11230,0.377,17676,0.593
"8039","yuba",8039,"2021-02-21",17,8747,14,2715,3,6032,0,0,7,4529,10,2106,7,6635,"California",79290,0.0265607264472191,11230,0.377,17676,0.593
"8040","yuba",8040,"2021-02-22",128,8875,79,2794,49,6081,0,0,38,4478,89,2195,38,6673,"California",79290,0.0276831882961281,11230,0.377,17676,0.593
"8041","yuba",8041,"2021-02-23",113,8988,25,2819,88,6169,0,0,46,4458,66,2261,46,6719,"California",79290,0.028515575734645,11230,0.377,17676,0.593
"8042","yuba",8042,"2021-02-24",481,9469,135,2954,346,6515,0,0,107,4191,374,2635,107,6826,"California",79290,0.0332324378862404,11230,0.377,17676,0.593
"8043","yuba",8043,"2021-02-25",343,9812,139,3093,204,6719,0,0,214,4276,129,2764,214,7040,"California",79290,0.0348593769706142,11230,0.377,17676,0.593
"8044","yuba",8044,"2021-02-26",256,10068,67,3160,189,6908,0,0,143,4308,111,2875,143,7183,"California",79290,0.0362593012990289,11230,0.377,17676,0.593
"8045","yuba",8045,"2021-02-27",472,10540,47,3207,425,7333,0,0,383,4604,87,2962,383,7566,"California",79290,0.0373565392861647,11230,0.377,17676,0.593
"8046","yuba",8046,"2021-02-28",66,10606,21,3228,45,7378,0,0,45,4628,21,2983,45,7611,"California",79290,0.0376213898347837,11230,0.377,17676,0.593
"8047","yuba",8047,"2021-03-01",156,10762,40,3268,116,7494,0,0,80,4633,75,3058,80,7691,"California",79290,0.0385672846512801,11230,0.377,17676,0.593
"8048","yuba",8048,"2021-03-02",159,10921,36,3304,123,7617,0,0,79,4632,80,3138,79,7770,"California",79290,0.0395762391222096,11230,0.377,17676,0.593
"8049","yuba",8049,"2021-03-03",622,11543,159,3463,463,8080,0,0,200,4411,421,3559,200,7970,"California",79290,0.0448858620254761,11230,0.377,17676,0.593
"8050","yuba",8050,"2021-03-04",466,12009,270,3733,196,8276,0,0,325,4596,140,3699,325,8295,"California",79290,0.0466515323496027,11230,0.377,17676,0.593
"8051","yuba",8051,"2021-03-05",317,12326,60,3793,256,8532,1,1,249,4778,68,3767,250,8545,"California",79290,0.0475091436498928,11230,0.377,17676,0.593
"8052","yuba",8052,"2021-03-06",474,12800,35,3828,435,8967,4,5,368,5044,106,3873,372,8917,"California",79290,0.0488460083238744,11230,0.377,17676,0.593
"8053","yuba",8053,"2021-03-07",49,12849,27,3855,21,8988,1,6,33,5062,16,3889,34,8951,"California",79290,0.0490477992180603,11230,0.377,17676,0.593
"8054","yuba",8054,"2021-03-08",160,13009,49,3904,95,9083,16,22,101,5120,59,3948,117,9068,"California",79290,0.0497919031403708,11230,0.377,17676,0.593
"8055","yuba",8055,"2021-03-09",177,13186,47,3951,110,9193,20,42,84,5131,93,4041,104,9172,"California",79290,0.0509648127128263,11230,0.377,17676,0.593
"8056","yuba",8056,"2021-03-10",737,13923,233,4184,474,9667,30,72,232,4889,504,4545,262,9434,"California",79290,0.0573212258796822,11230,0.377,17676,0.593
"8057","yuba",8057,"2021-03-11",438,14361,197,4381,229,9896,12,84,295,5053,143,4688,307,9741,"California",79290,0.0591247319964687,11230,0.377,17676,0.593
"8058","yuba",8058,"2021-03-12",461,14822,86,4467,321,10217,54,138,150,4946,311,4999,204,9945,"California",79290,0.0630470425022071,11230,0.377,17676,0.593
"8059","yuba",8059,"2021-03-13",455,15277,335,4802,105,10322,15,153,360,5227,94,5093,375,10320,"California",79290,0.0642325640055492,11230,0.377,17676,0.593
"8060","yuba",8060,"2021-03-14",107,15384,21,4823,76,10398,10,163,46,5223,60,5153,56,10376,"California",79290,0.0649892798587464,11230,0.377,17676,0.593
"8061","yuba",8061,"2021-03-15",190,15574,49,4872,124,10522,17,180,96,5242,94,5247,113,10489,"California",79290,0.0661748013620885,11230,0.377,17676,0.593
"8062","yuba",8062,"2021-03-16",290,15864,71,4943,194,10716,25,205,177,5332,112,5359,202,10691,"California",79290,0.0675873376213898,11230,0.377,17676,0.593
"8063","yuba",8063,"2021-03-17",739,16603,162,5105,548,11264,29,234,193,5010,544,5903,222,10913,"California",79290,0.0744482280237104,11230,0.377,17676,0.593
"8064","yuba",8064,"2021-03-18",582,17185,161,5266,309,11573,112,346,353,5245,229,6132,464,11377,"California",79290,0.0773363601967461,11230,0.377,17676,0.593
"8065","yuba",8065,"2021-03-19",325,17510,120,5386,156,11729,49,395,186,5342,138,6270,235,11612,"California",79290,0.0790768066590995,11230,0.377,17676,0.593
"8066","yuba",8066,"2021-03-20",556,18066,81,5467,457,12186,18,413,476,5757,79,6349,494,12106,"California",79290,0.0800731491991424,11230,0.377,17676,0.593
"8067","yuba",8067,"2021-03-21",60,18126,35,5502,25,12211,0,413,48,5793,12,6361,48,12154,"California",79290,0.0802244923697818,11230,0.377,17676,0.593
"8068","yuba",8068,"2021-03-22",190,18316,70,5572,113,12324,7,420,148,5906,42,6403,155,12309,"California",79290,0.0807541934670198,11230,0.377,17676,0.593
"8069","yuba",8069,"2021-03-23",264,18580,80,5652,157,12481,27,447,177,6025,85,6488,204,12513,"California",79290,0.0818262075923824,11230,0.377,17676,0.593
"8070","yuba",8070,"2021-03-24",767,19347,254,5906,432,12913,81,528,188,5716,577,7065,268,12781,"California",79290,0.0891032917139614,11230,0.377,17676,0.593
"8071","yuba",8071,"2021-03-25",502,19849,268,6174,212,13125,22,550,249,5734,253,7318,271,13052,"California",79290,0.092294110228276,11230,0.377,17676,0.593
"8072","yuba",8072,"2021-03-26",390,20239,143,6317,220,13345,27,577,224,5820,165,7483,251,13303,"California",79290,0.094375078824568,11230,0.377,17676,0.593
"8073","yuba",8073,"2021-03-27",460,20699,27,6344,430,13775,3,580,405,6173,54,7537,407,13710,"California",79290,0.0950561230924455,11230,0.377,17676,0.593
"8074","yuba",8074,"2021-03-28",99,20798,40,6384,55,13830,4,584,37,6152,62,7599,41,13751,"California",79290,0.0958380628074158,11230,0.377,17676,0.593
"8075","yuba",8075,"2021-03-29",295,21093,86,6470,177,14007,32,616,179,6247,116,7715,211,13962,"California",79290,0.0973010467902636,11230,0.377,17676,0.593
"8076","yuba",8076,"2021-03-30",274,21367,68,6538,198,14205,8,624,190,6361,84,7799,198,14160,"California",79290,0.0983604489847396,11230,0.377,17676,0.593
"8077","yuba",8077,"2021-03-31",667,22034,113,6651,542,14747,12,636,237,6181,429,8228,249,14409,"California",79290,0.103770967335099,11230,0.377,17676,0.593
"8078","yuba",8078,"2021-04-01",620,22654,287,6938,304,15051,29,665,286,6163,334,8562,316,14725,"California",79290,0.10798335225123,11230,0.377,17676,0.593
"8079","yuba",8079,"2021-04-02",493,23147,94,7032,316,15367,83,748,187,6127,305,8867,269,14994,"California",79290,0.111829991171648,11230,0.377,17676,0.593
"8080","yuba",8080,"2021-04-03",653,23800,55,7087,116,15483,482,1230,87,6131,565,9432,569,15563,"California",79290,0.118955732122588,11230,0.377,17676,0.593
"8081","yuba",8081,"2021-04-04",58,23858,11,7098,41,15524,6,1236,33,6145,25,9457,39,15602,"California",79290,0.119271030394753,11230,0.377,17676,0.593
"8082","yuba",8082,"2021-04-05",245,24103,78,7176,146,15670,21,1257,123,6168,120,9577,143,15745,"California",79290,0.120784462101148,11230,0.377,17676,0.593
"8083","yuba",8083,"2021-04-06",354,24457,114,7290,179,15849,61,1318,170,6216,183,9760,231,15976,"California",79290,0.123092445453399,11230,0.377,17676,0.593
"8084","yuba",8084,"2021-04-07",771,25228,396,7686,322,16171,53,1371,347,6194,421,10181,399,16375,"California",79290,0.128402068356665,11230,0.377,17676,0.593
"8085","yuba",8085,"2021-04-08",721,25949,288,7974,171,16342,262,1633,255,6245,465,10646,516,16891,"California",79290,0.134266616218943,11230,0.377,17676,0.593
"8086","yuba",8086,"2021-04-09",397,26346,173,8147,158,16500,66,1699,163,6241,233,10879,229,17120,"California",79290,0.137205196115525,11230,0.377,17676,0.593
"8087","yuba",8087,"2021-04-10",594,26940,73,8220,74,16574,447,2146,73,6240,519,11398,518,17638,"California",79290,0.14375078824568,11230,0.377,17676,0.593
"8088","yuba",8088,"2021-04-11",102,27042,26,8246,64,16638,12,2158,43,6236,59,11457,55,17693,"California",79290,0.144494892167991,11230,0.377,17676,0.593
"8089","yuba",8089,"2021-04-12",210,27252,46,8292,135,16773,29,2187,80,6216,129,11586,109,17802,"California",79290,0.146121831252365,11230,0.377,17676,0.593
"8090","yuba",8090,"2021-04-13",396,27648,102,8394,294,17067,0,2187,204,6229,191,11777,204,18006,"California",79290,0.148530710051709,11230,0.377,17676,0.593
"8091","yuba",8091,"2021-04-14",693,28341,109,8503,584,17651,0,2187,118,5773,574,12351,118,18124,"California",79290,0.155769958380628,11230,0.377,17676,0.593
"8092","yuba",8092,"2021-04-15",333,28674,126,8629,207,17858,0,2187,144,5728,189,12540,144,18268,"California",79290,0.158153613318199,11230,0.377,17676,0.593
"8093","yuba",8093,"2021-04-16",331,29005,101,8730,230,18088,0,2187,179,5755,152,12692,179,18447,"California",79290,0.160070626812965,11230,0.377,17676,0.593
"8094","yuba",8094,"2021-04-17",403,29408,59,8789,344,18432,0,2187,332,6017,70,12762,332,18779,"California",79290,0.160953461975028,11230,0.377,17676,0.593
"8095","yuba",8095,"2021-04-18",52,29460,9,8798,43,18475,0,2187,24,6013,28,12790,24,18803,"California",79290,0.161306596039854,11230,0.377,17676,0.593
"8096","yuba",8096,"2021-04-19",245,29705,102,8900,143,18618,0,2187,104,5976,141,12931,104,18907,"California",79290,0.163084878294867,11230,0.377,17676,0.593
"8097","yuba",8097,"2021-04-20",301,30006,78,8978,223,18841,0,2187,175,6027,125,13056,176,19083,"California",79290,0.164661369655694,11230,0.377,17676,0.593
"8098","yuba",8098,"2021-04-21",705,30711,287,9265,418,19259,0,2187,304,5930,401,13457,304,19387,"California",79290,0.169718753941228,11230,0.377,17676,0.593
"8099","yuba",8099,"2021-04-22",323,31034,129,9394,194,19453,0,2187,181,5969,142,13599,181,19568,"California",79290,0.171509648127128,11230,0.377,17676,0.593
"8100","yuba",8100,"2021-04-23",340,31374,111,9505,229,19682,0,2187,163,5956,176,13775,163,19731,"California",79290,0.173729347963173,11230,0.377,17676,0.593
"8101","yuba",8101,"2021-04-24",216,31590,68,9573,148,19830,0,2187,123,5986,93,13868,123,19854,"California",79290,0.174902257535629,11230,0.377,17676,0.593
"8102","yuba",8102,"2021-04-25",74,31664,30,9603,44,19874,0,2187,37,5986,37,13905,37,19891,"California",79290,0.175368898978434,11230,0.377,17676,0.593
"8103","yuba",8103,"2021-04-26",217,31881,47,9650,166,20040,4,2191,99,5971,118,14023,103,19994,"California",79290,0.176857106823055,11230,0.377,17676,0.593
"8104","yuba",8104,"2021-04-27",458,32339,149,9799,299,20339,10,2201,225,5975,231,14254,235,20229,"California",79290,0.179770462857864,11230,0.377,17676,0.593
"8105","yuba",8105,"2021-04-28",430,32769,174,9973,251,20590,5,2206,144,5844,280,14534,149,20378,"California",79290,0.183301803506117,11230,0.377,17676,0.593
"8106","yuba",8106,"2021-04-29",426,33195,65,10038,360,20950,1,2207,145,5710,280,14814,146,20524,"California",79290,0.18683314415437,11230,0.377,17676,0.593
"8107","yuba",8107,"2021-04-30",328,33523,93,10131,206,21156,29,2236,140,5693,186,15000,169,20693,"California",79290,0.189178963299281,11230,0.377,17676,0.593
"8108","yuba",8108,"2021-05-01",207,33730,93,10224,96,21252,18,2254,93,5691,113,15113,111,20804,"California",79290,0.190604111489469,11230,0.377,17676,0.593
"8109","yuba",8109,"2021-05-02",64,33794,34,10258,26,21278,4,2258,37,5705,27,15140,41,20845,"California",79290,0.190944633623408,11230,0.377,17676,0.593
"8110","yuba",8110,"2021-05-03",143,33937,66,10324,68,21346,9,2267,46,5666,94,15234,55,20900,"California",79290,0.19213015512675,11230,0.377,17676,0.593
"8111","yuba",8111,"2021-05-04",286,34223,93,10417,172,21518,21,2288,127,5655,159,15393,148,21048,"California",79290,0.194135452137722,11230,0.377,17676,0.593
"8112","yuba",8112,"2021-05-05",311,34534,77,10494,227,21745,7,2295,110,5571,201,15594,117,21165,"California",79290,0.196670450245933,11230,0.377,17676,0.593
"8113","yuba",8113,"2021-05-06",228,34762,98,10592,92,21837,38,2333,77,5538,148,15742,115,21280,"California",79290,0.198537016017152,11230,0.377,17676,0.593
"8114","yuba",8114,"2021-05-07",353,35115,97,10689,231,22068,25,2358,119,5447,234,15976,143,21423,"California",79290,0.201488207844621,11230,0.377,17676,0.593
"8115","yuba",8115,"2021-05-08",102,35217,29,10718,70,22138,3,2361,43,5434,59,16035,46,21469,"California",79290,0.202232311766932,11230,0.377,17676,0.593
